disAcodeNum	disAcode	disAname	disBcodeNum	disBcode	disBname	patTotal	patWdisA	patWdisB	patWdisAB	patWdisAnotB	patWdisBnotA	patWOdisAB	relativeRiskIndex	phiIndex	oddsRatioIndex	oddsRatio95CI_upper	oddsRatio95CI_lower	fisherTest	fisherTestAdjusted	expect	score	femaleWithDisA	femaleWithDisB	femaleWithDisAandB	maleWithDisA	maleWithDisB	maleWithDisAandB	sexRatioBA	sexRatioAB
118	48333001	Burn injury(morphologic abnormality)	55	126906006	Neoplasm of prostate	1095	1	24	0	1	24	1070	0.00000	-0.00453	0.00000	0.00000	0.00000	1.0000000000	1.0000000000	0.02192	-0.03128	0	0	0	1	24	0	0.00000	0.00000
119	275272006	Brain damage - traumatic	55	126906006	Neoplasm of prostate	1095	4	24	2	2	22	1069	22.81250	0.19771	48.59091	360.80905	6.54384	0.0026911050	0.0547074043	0.08767	1.46372	0	0	0	4	24	2	-2.56495	-1.09861
120	162573006	Suspected lung cancer (situation)	55	126906006	Neoplasm of prostate	1095	8	24	1	7	23	1064	5.70312	0.06040	6.60870	55.92480	0.78096	0.1629473009	0.7879650300	0.17534	0.76692	0	0	0	8	24	1	-3.21888	-2.19722
121	254637007	Non-small cell lung cancer (disorder)	55	126906006	Neoplasm of prostate	1095	8	24	1	7	23	1064	5.70312	0.06040	6.60870	55.92480	0.78096	0.1629473009	0.7879650300	0.17534	0.76692	0	0	0	8	24	1	-3.21888	-2.19722
123	195967001	Asthma	55	126906006	Neoplasm of prostate	1095	2	24	0	2	24	1069	0.00000	-0.00640	0.00000	0.00000	0.00000	1.0000000000	1.0000000000	0.04384	-0.06189	1	0	0	1	24	0	0.00000	0.00000
126	698754002	Chronic paralysis due to lesion of spinal cord	55	126906006	Neoplasm of prostate	1095	2	24	0	2	24	1069	0.00000	-0.00640	0.00000	0.00000	0.00000	1.0000000000	1.0000000000	0.04384	-0.06189	2	0	0	0	24	0	0.00000	0.00000
127	431856006	Chronic kidney disease stage 2 (disorder)	55	126906006	Neoplasm of prostate	1095	5	24	1	4	23	1067	9.12500	0.08238	11.59783	107.84749	1.24722	0.1050729530	0.6374086950	0.10959	0.84997	3	0	0	2	24	1	-3.21888	-1.09861
128	86849004	Suicidal deliberate poisoning	55	126906006	Neoplasm of prostate	1095	1	24	1	0	23	1071	45.62500	0.20197	0.00000	0.00000	0.00000	0.0219178082	0.2664744052	0.02192	0.96872	0	0	0	1	24	1	-3.21888	-0.69315
130	314994000	Metastasis from malignant tumor of prostate (disorder)	55	126906006	Neoplasm of prostate	1095	1	24	1	0	23	1071	45.62500	0.20197	0.00000	0.00000	0.00000	0.0219178082	0.2664744052	0.02192	0.96872	0	0	0	1	24	1	-3.21888	-0.69315
131	93761005	Primary malignant neoplasm of colon	55	126906006	Neoplasm of prostate	1095	5	24	0	5	24	1066	0.00000	-0.01014	0.00000	0.00000	0.00000	1.0000000000	1.0000000000	0.10959	-0.15003	3	0	0	2	24	0	0.00000	0.00000
132	69896004	Rheumatoid arthritis	55	126906006	Neoplasm of prostate	1095	3	24	0	3	24	1068	0.00000	-0.00785	0.00000	0.00000	0.00000	1.0000000000	1.0000000000	0.06575	-0.09187	2	0	0	1	24	0	0.00000	0.00000
114	449868002	Smokes tobacco daily	2	43878008	Streptococcal sore throat (disorder)	1095	9	523	6	3	517	569	1.39579	0.03445	2.20116	8.84628	0.54770	0.3238371100	1.0000000000	4.29863	0.40174	2	246	1	7	277	5	1.47692	0.22314
114	449868002	Smokes tobacco daily	3	65363002	Otitis media	1095	9	580	4	5	576	510	0.83908	-0.01555	0.70833	2.65205	0.18919	0.7419231185	1.0000000000	4.76712	-0.20592	2	277	1	7	303	3	1.00265	-0.10536
119	275272006	Brain damage - traumatic	4	195662009	Acute viral pharyngitis (disorder)	1095	4	890	4	0	886	205	1.23034	0.02906	0.00000	0.00000	0.00000	1.0000000000	1.0000000000	3.25114	0.23408	0	430	0	4	460	4	-4.75359	-0.69315
127	431856006	Chronic kidney disease stage 2 (disorder)	9	44465007	Sprain of ankle	1095	5	362	5	0	357	733	3.02486	0.09638	0.00000	0.00000	0.00000	0.0038761159	0.0736462024	1.65297	1.17736	3	185	3	2	177	2	-0.35641	0.00000
128	86849004	Suicidal deliberate poisoning	9	44465007	Sprain of ankle	1095	1	362	0	1	362	732	0.00000	-0.02125	0.00000	0.00000	0.00000	1.0000000000	1.0000000000	0.33059	-0.41207	0	185	0	1	177	0	0.00000	0.00000
118	48333001	Burn injury(morphologic abnormality)	3	65363002	Otitis media	1095	1	580	1	0	579	515	1.88793	0.02849	0.00000	0.00000	0.00000	1.0000000000	1.0000000000	0.52968	0.38677	0	277	0	1	303	1	-5.71703	-0.69315
123	195967001	Asthma	3	65363002	Otitis media	1095	2	580	1	1	579	514	0.94397	-0.00254	0.88774	14.22891	0.05539	1.0000000000	1.0000000000	1.05936	-0.04220	1	277	0	1	303	1	-5.71703	-0.69315
126	698754002	Chronic paralysis due to lesion of spinal cord	3	65363002	Otitis media	1095	2	580	0	2	580	513	0.00000	-0.04540	0.00000	0.00000	0.00000	0.2209728448	0.8794911525	1.05936	-1.04220	2	277	0	0	303	0	0.00000	0.00000
127	431856006	Chronic kidney disease stage 2 (disorder)	3	65363002	Otitis media	1095	5	580	3	2	577	513	1.13276	0.00954	1.33362	8.01283	0.22196	1.0000000000	1.0000000000	2.64840	0.13274	3	277	1	2	303	2	0.60046	0.69315
131	93761005	Primary malignant neoplasm of colon	113	443165006	Pathological fracture due to osteoporosis (disorder)	1095	5	10	0	5	10	1080	0.00000	-0.00650	0.00000	0.00000	0.00000	1.0000000000	1.0000000000	0.04566	-0.06442	3	7	0	2	3	0	0.00000	0.00000
130	314994000	Metastasis from malignant tumor of prostate (disorder)	113	443165006	Pathological fracture due to osteoporosis (disorder)	1095	1	10	0	1	10	1084	0.00000	-0.00290	0.00000	0.00000	0.00000	1.0000000000	1.0000000000	0.00913	-0.01312	0	7	0	1	3	0	0.00000	0.00000
129	47505003	Posttraumatic stress disorder	113	443165006	Pathological fracture due to osteoporosis (disorder)	1095	4	10	0	4	10	1081	0.00000	-0.00581	0.00000	0.00000	0.00000	1.0000000000	1.0000000000	0.03653	-0.05176	1	7	0	3	3	0	0.00000	0.00000
128	86849004	Suicidal deliberate poisoning	113	443165006	Pathological fracture due to osteoporosis (disorder)	1095	1	10	0	1	10	1084	0.00000	-0.00290	0.00000	0.00000	0.00000	1.0000000000	1.0000000000	0.00913	-0.01312	0	7	0	1	3	0	0.00000	0.00000
127	431856006	Chronic kidney disease stage 2 (disorder)	113	443165006	Pathological fracture due to osteoporosis (disorder)	1095	5	10	0	5	10	1080	0.00000	-0.00650	0.00000	0.00000	0.00000	1.0000000000	1.0000000000	0.04566	-0.06442	3	7	0	2	3	0	0.00000	0.00000
126	698754002	Chronic paralysis due to lesion of spinal cord	113	443165006	Pathological fracture due to osteoporosis (disorder)	1095	2	10	0	2	10	1083	0.00000	-0.00411	0.00000	0.00000	0.00000	1.0000000000	1.0000000000	0.01826	-0.02611	2	7	0	0	3	0	0.00000	0.00000
125	1734006	Fracture of the vertebral column with spinal cord injury	113	443165006	Pathological fracture due to osteoporosis (disorder)	1095	5	10	0	5	10	1080	0.00000	-0.00650	0.00000	0.00000	0.00000	1.0000000000	1.0000000000	0.04566	-0.06442	3	7	0	2	3	0	0.00000	0.00000
124	1501000119109	Proliferative diabetic retinopathy due to type II diabetes mellitus (disorder)	113	443165006	Pathological fracture due to osteoporosis (disorder)	1095	1	10	0	1	10	1084	0.00000	-0.00290	0.00000	0.00000	0.00000	1.0000000000	1.0000000000	0.00913	-0.01312	1	7	0	0	3	0	0.00000	0.00000
123	195967001	Asthma	113	443165006	Pathological fracture due to osteoporosis (disorder)	1095	2	10	0	2	10	1083	0.00000	-0.00411	0.00000	0.00000	0.00000	1.0000000000	1.0000000000	0.01826	-0.02611	1	7	0	1	3	0	0.00000	0.00000
121	254637007	Non-small cell lung cancer (disorder)	113	443165006	Pathological fracture due to osteoporosis (disorder)	1095	8	10	0	8	10	1077	0.00000	-0.00824	0.00000	0.00000	0.00000	1.0000000000	1.0000000000	0.07306	-0.10173	0	7	0	8	3	0	0.00000	0.00000
120	162573006	Suspected lung cancer (situation)	113	443165006	Pathological fracture due to osteoporosis (disorder)	1095	8	10	0	8	10	1077	0.00000	-0.00824	0.00000	0.00000	0.00000	1.0000000000	1.0000000000	0.07306	-0.10173	0	7	0	8	3	0	0.00000	0.00000
119	275272006	Brain damage - traumatic	113	443165006	Pathological fracture due to osteoporosis (disorder)	1095	4	10	0	4	10	1081	0.00000	-0.00581	0.00000	0.00000	0.00000	1.0000000000	1.0000000000	0.03653	-0.05176	0	7	0	4	3	0	0.00000	0.00000
118	48333001	Burn injury(morphologic abnormality)	113	443165006	Pathological fracture due to osteoporosis (disorder)	1095	1	10	0	1	10	1084	0.00000	-0.00290	0.00000	0.00000	0.00000	1.0000000000	1.0000000000	0.00913	-0.01312	0	7	0	1	3	0	0.00000	0.00000
117	230265002	Familial Alzheimer's disease of early onset (disorder)	113	443165006	Pathological fracture due to osteoporosis (disorder)	1095	6	10	0	6	10	1079	0.00000	-0.00713	0.00000	0.00000	0.00000	1.0000000000	1.0000000000	0.05479	-0.07696	2	7	0	4	3	0	0.00000	0.00000
115	36923009	Major depression  single episode	113	443165006	Pathological fracture due to osteoporosis (disorder)	1095	6	10	0	6	10	1079	0.00000	-0.00713	0.00000	0.00000	0.00000	1.0000000000	1.0000000000	0.05479	-0.07696	3	7	0	3	3	0	0.00000	0.00000
114	449868002	Smokes tobacco daily	113	443165006	Pathological fracture due to osteoporosis (disorder)	1095	9	10	0	9	10	1076	0.00000	-0.00874	0.00000	0.00000	0.00000	1.0000000000	1.0000000000	0.08219	-0.11396	2	7	0	7	3	0	0.00000	0.00000
112	49436004	Atrial Fibrillation	113	443165006	Pathological fracture due to osteoporosis (disorder)	1095	35	10	3	32	7	1053	9.38571	0.14629	14.10268	57.04554	3.48643	0.0030817172	0.0614802583	0.31963	1.59986	9	7	2	26	3	1	0.11778	-1.59109
111	235919008	Cholelithiasis	113	443165006	Pathological fracture due to osteoporosis (disorder)	1095	9	10	0	9	10	1076	0.00000	-0.00874	0.00000	0.00000	0.00000	1.0000000000	1.0000000000	0.08219	-0.11396	7	7	0	2	3	0	0.00000	0.00000
110	65275009	Acute Cholecystitis	113	443165006	Pathological fracture due to osteoporosis (disorder)	1095	9	10	0	9	10	1076	0.00000	-0.00874	0.00000	0.00000	0.00000	1.0000000000	1.0000000000	0.08219	-0.11396	7	7	0	2	3	0	0.00000	0.00000
109	90560007	Gout	113	443165006	Pathological fracture due to osteoporosis (disorder)	1095	4	10	0	4	10	1081	0.00000	-0.00581	0.00000	0.00000	0.00000	1.0000000000	1.0000000000	0.03653	-0.05176	0	7	0	4	3	0	0.00000	0.00000
108	40930008	Hypothyroidism (disorder)	113	443165006	Pathological fracture due to osteoporosis (disorder)	1095	13	10	1	12	9	1073	8.42308	0.07811	9.93519	84.68833	1.16554	0.1130161273	0.6626957686	0.11872	0.83815	11	7	1	2	3	0	2.07944	2.48491
107	40275004	Contact dermatitis	113	443165006	Pathological fracture due to osteoporosis (disorder)	1095	18	10	0	18	10	1067	0.00000	-0.01241	0.00000	0.00000	0.00000	1.0000000000	1.0000000000	0.16438	-0.21957	9	7	0	9	3	0	0.00000	0.00000
106	24079001	Atopic dermatitis	113	443165006	Pathological fracture due to osteoporosis (disorder)	1095	20	10	0	20	10	1065	0.00000	-0.01309	0.00000	0.00000	0.00000	1.0000000000	1.0000000000	0.18265	-0.24202	13	7	0	7	3	0	0.00000	0.00000
105	363406005	Malignant tumor of colon	113	443165006	Pathological fracture due to osteoporosis (disorder)	1095	6	10	0	6	10	1079	0.00000	-0.00713	0.00000	0.00000	0.00000	1.0000000000	1.0000000000	0.05479	-0.07696	4	7	0	2	3	0	0.00000	0.00000
104	367498001	Seasonal allergic rhinitis	113	443165006	Pathological fracture due to osteoporosis (disorder)	1095	20	10	0	20	10	1065	0.00000	-0.01309	0.00000	0.00000	0.00000	1.0000000000	1.0000000000	0.18265	-0.24202	9	7	0	11	3	0	0.00000	0.00000
102	90781000119102	Microalbuminuria due to type 2 diabetes mellitus (disorder)	113	443165006	Pathological fracture due to osteoporosis (disorder)	1095	6	10	0	6	10	1079	0.00000	-0.00713	0.00000	0.00000	0.00000	1.0000000000	1.0000000000	0.05479	-0.07696	3	7	0	3	3	0	0.00000	0.00000
101	433144002	Chronic kidney disease stage 3 (disorder)	113	443165006	Pathological fracture due to osteoporosis (disorder)	1095	3	10	0	3	10	1082	0.00000	-0.00503	0.00000	0.00000	0.00000	1.0000000000	1.0000000000	0.02740	-0.03899	1	7	0	2	3	0	0.00000	0.00000
100	161622006	History of lower limb amputation (situation)	113	443165006	Pathological fracture due to osteoporosis (disorder)	1095	1	10	0	1	10	1084	0.00000	-0.00290	0.00000	0.00000	0.00000	1.0000000000	1.0000000000	0.00913	-0.01312	0	7	0	1	3	0	0.00000	0.00000
99	30832001	Rupture of patellar tendon	113	443165006	Pathological fracture due to osteoporosis (disorder)	1095	23	10	1	22	9	1063	4.76087	0.05289	5.36869	44.22373	0.65175	0.1919811700	0.8268943621	0.21005	0.72494	14	7	1	9	3	0	2.07944	2.70805
98	1551000119108	Nonproliferative diabetic retinopathy due to type 2 diabetes mellitus (disorder)	113	443165006	Pathological fracture due to osteoporosis (disorder)	1095	12	10	1	11	9	1074	9.12500	0.08211	10.84848	93.10237	1.26409	0.1047497352	0.6367681272	0.10959	0.84997	7	7	1	5	3	0	2.07944	2.07944
97	403192003	Third degree burn	113	443165006	Pathological fracture due to osteoporosis (disorder)	1095	8	10	1	7	9	1078	13.68750	0.10449	17.11111	153.74943	1.90433	0.0709862805	0.5245934178	0.07306	0.89827	3	7	0	5	3	1	-1.38629	-1.79176
96	283371005	Laceration of forearm	113	443165006	Pathological fracture due to osteoporosis (disorder)	1095	75	10	2	73	8	1012	2.92000	0.04998	3.46575	16.61855	0.72277	0.1458218238	0.7463696614	0.68493	0.83227	39	7	2	36	3	0	1.50408	3.02042
95	84757009	Epilepsy	113	443165006	Pathological fracture due to osteoporosis (disorder)	1095	30	10	0	30	10	1055	0.00000	-0.01611	0.00000	0.00000	0.00000	1.0000000000	1.0000000000	0.27397	-0.34933	13	7	0	17	3	0	0.00000	0.00000
94	703151001	History of single seizure (situation)	113	443165006	Pathological fracture due to osteoporosis (disorder)	1095	39	10	0	39	10	1046	0.00000	-0.01845	0.00000	0.00000	0.00000	1.0000000000	1.0000000000	0.35616	-0.43953	14	7	0	25	3	0	0.00000	0.00000
93	128613002	Seizure disorder	113	443165006	Pathological fracture due to osteoporosis (disorder)	1095	39	10	0	39	10	1046	0.00000	-0.01845	0.00000	0.00000	0.00000	1.0000000000	1.0000000000	0.35616	-0.43953	14	7	0	25	3	0	0.00000	0.00000
91	64859006	Osteoporosis (disorder)	113	443165006	Pathological fracture due to osteoporosis (disorder)	1095	37	10	10	27	0	1058	29.59459	0.51337	0.00000	0.00000	0.00000	0.0000000000	0.0000000000	0.33790	3.03946	24	7	7	13	3	3	0.00000	-0.18590
89	47693006	Rupture of appendix	113	443165006	Pathological fracture due to osteoporosis (disorder)	1095	20	10	0	20	10	1065	0.00000	-0.01309	0.00000	0.00000	0.00000	1.0000000000	1.0000000000	0.18265	-0.24202	10	7	0	10	3	0	0.00000	0.00000
86	713197008	Recurrent rectal polyp	113	443165006	Pathological fracture due to osteoporosis (disorder)	1095	22	10	1	21	9	1064	4.97727	0.05467	5.62963	46.46465	0.68208	0.1843798639	0.8181443419	0.20091	0.73587	12	7	0	10	3	1	-1.38629	-2.39790
85	241929008	Acute allergic reaction	113	443165006	Pathological fracture due to osteoporosis (disorder)	1095	47	10	0	47	10	1038	0.00000	-0.02033	0.00000	0.00000	0.00000	1.0000000000	1.0000000000	0.42922	-0.51523	25	7	0	22	3	0	0.00000	0.00000
83	110030002	Concussion injury of brain	113	443165006	Pathological fracture due to osteoporosis (disorder)	1095	7	10	0	7	10	1078	0.00000	-0.00770	0.00000	0.00000	0.00000	1.0000000000	1.0000000000	0.06393	-0.08940	1	7	0	6	3	0	0.00000	0.00000
82	94260004	Secondary malignant neoplasm of colon	113	443165006	Pathological fracture due to osteoporosis (disorder)	1095	4	10	0	4	10	1081	0.00000	-0.00581	0.00000	0.00000	0.00000	1.0000000000	1.0000000000	0.03653	-0.05176	2	7	0	2	3	0	0.00000	0.00000
81	236077008	Protracted diarrhea	113	443165006	Pathological fracture due to osteoporosis (disorder)	1095	4	10	0	4	10	1081	0.00000	-0.00581	0.00000	0.00000	0.00000	1.0000000000	1.0000000000	0.03653	-0.05176	2	7	0	2	3	0	0.00000	0.00000
80	6072007	Bleeding from anus	113	443165006	Pathological fracture due to osteoporosis (disorder)	1095	4	10	0	4	10	1081	0.00000	-0.00581	0.00000	0.00000	0.00000	1.0000000000	1.0000000000	0.03653	-0.05176	2	7	0	2	3	0	0.00000	0.00000
79	45816000	Pyelonephritis	113	443165006	Pathological fracture due to osteoporosis (disorder)	1095	1	10	0	1	10	1084	0.00000	-0.00290	0.00000	0.00000	0.00000	1.0000000000	1.0000000000	0.00913	-0.01312	1	7	0	0	3	0	0.00000	0.00000
78	239872002	Osteoarthritis of hip	113	443165006	Pathological fracture due to osteoporosis (disorder)	1095	21	10	1	20	9	1065	5.21429	0.05657	5.91667	48.93956	0.71531	0.1767142612	0.8029498763	0.19178	0.74688	13	7	1	8	3	0	2.07944	2.63906
76	127013003	Diabetic renal disease (disorder)	113	443165006	Pathological fracture due to osteoporosis (disorder)	1095	28	10	2	26	8	1059	7.82143	0.10609	10.18269	50.31380	2.06081	0.0250051329	0.2905941929	0.25571	1.25646	10	7	2	18	3	0	1.50408	1.79176
75	431855005	Chronic kidney disease stage 1 (disorder)	113	443165006	Pathological fracture due to osteoporosis (disorder)	1095	28	10	2	26	8	1059	7.82143	0.10609	10.18269	50.31380	2.06081	0.0250051329	0.2905941929	0.25571	1.25646	10	7	2	18	3	0	1.50408	1.79176
73	196416002	Impacted molars	113	443165006	Pathological fracture due to osteoporosis (disorder)	1095	49	10	0	49	10	1036	0.00000	-0.02078	0.00000	0.00000	0.00000	1.0000000000	1.0000000000	0.44749	-0.53355	25	7	0	24	3	0	0.00000	0.00000
72	35999006	Blighted ovum	113	443165006	Pathological fracture due to osteoporosis (disorder)	1095	53	10	2	51	8	1034	4.13208	0.06781	5.06863	24.48003	1.04947	0.0806488308	0.5622997909	0.48402	1.01545	53	7	2	0	3	0	1.50408	3.31419
71	201834006	Localized  primary osteoarthritis of the hand	113	443165006	Pathological fracture due to osteoporosis (disorder)	1095	28	10	1	27	9	1058	3.91071	0.04527	4.35391	35.59037	0.53263	0.2290399332	0.8880487574	0.25571	0.67150	19	7	1	9	3	0	2.07944	2.99573
70	87433001	Pulmonary emphysema (disorder)	113	443165006	Pathological fracture due to osteoporosis (disorder)	1095	17	10	0	17	10	1068	0.00000	-0.01206	0.00000	0.00000	0.00000	1.0000000000	1.0000000000	0.15525	-0.20821	9	7	0	8	3	0	0.00000	0.00000
69	233604007	Pneumonia	113	443165006	Pathological fracture due to osteoporosis (disorder)	1095	7	10	0	7	10	1078	0.00000	-0.00770	0.00000	0.00000	0.00000	1.0000000000	1.0000000000	0.06393	-0.08940	3	7	0	4	3	0	0.00000	0.00000
68	26929004	Alzheimer's disease (disorder)	113	443165006	Pathological fracture due to osteoporosis (disorder)	1095	23	10	1	22	9	1063	4.76087	0.05289	5.36869	44.22373	0.65175	0.1919811700	0.8268943621	0.21005	0.72494	15	7	1	8	3	0	2.07944	2.77259
67	403191005	Second degree burn	113	443165006	Pathological fracture due to osteoporosis (disorder)	1095	49	10	0	49	10	1036	0.00000	-0.02078	0.00000	0.00000	0.00000	1.0000000000	1.0000000000	0.44749	-0.53355	23	7	0	26	3	0	0.00000	0.00000
65	239873007	Osteoarthritis of knee	113	443165006	Pathological fracture due to osteoporosis (disorder)	1095	57	10	1	56	9	1029	1.92105	0.02072	2.04167	16.39840	0.25420	0.4154167022	1.0000000000	0.52055	0.39541	30	7	1	27	3	0	2.07944	3.43399
64	444448004	Injury of medial collateral ligament of knee	113	443165006	Pathological fracture due to osteoporosis (disorder)	1095	32	10	1	31	9	1054	3.42187	0.04034	3.77778	30.74621	0.46417	0.2575777144	0.9227055586	0.29224	0.63013	17	7	1	15	3	0	2.07944	2.89037
63	68496003	Polyp of colon	113	443165006	Pathological fracture due to osteoporosis (disorder)	1095	91	10	3	88	7	997	3.60989	0.07543	4.85552	19.10731	1.23388	0.0433953502	0.3987203055	0.83105	1.12733	43	7	1	48	3	2	1.16315	0.56531
62	185086009	Chronic obstructive bronchitis (disorder)	113	443165006	Pathological fracture due to osteoporosis (disorder)	1095	6	10	0	6	10	1079	0.00000	-0.00713	0.00000	0.00000	0.00000	1.0000000000	1.0000000000	0.05479	-0.07696	4	7	0	2	3	0	0.00000	0.00000
59	262574004	Bullet wound	113	443165006	Pathological fracture due to osteoporosis (disorder)	1095	20	10	1	19	9	1066	5.47500	0.05860	6.23392	51.68709	0.75187	0.1689838786	0.7953568293	0.18265	0.75798	9	7	1	11	3	0	2.07944	2.30259
58	239720000	Tear of meniscus of knee	113	443165006	Pathological fracture due to osteoporosis (disorder)	1095	20	10	0	20	10	1065	0.00000	-0.01309	0.00000	0.00000	0.00000	1.0000000000	1.0000000000	0.18265	-0.24202	10	7	0	10	3	0	0.00000	0.00000
57	192127007	Child attention deficit disorder	113	443165006	Pathological fracture due to osteoporosis (disorder)	1095	76	10	0	76	10	1009	0.00000	-0.02622	0.00000	0.00000	0.00000	1.0000000000	1.0000000000	0.69406	-0.76049	24	7	0	52	3	0	0.00000	0.00000
56	92691004	Carcinoma in situ of prostate (disorder)	113	443165006	Pathological fracture due to osteoporosis (disorder)	1095	23	10	1	22	9	1063	4.76087	0.05289	5.36869	44.22373	0.65175	0.1919811700	0.8268943621	0.21005	0.72494	0	7	0	23	3	1	-1.38629	-3.17805
54	5602001	Opioid abuse (disorder)	113	443165006	Pathological fracture due to osteoporosis (disorder)	1095	7	10	0	7	10	1078	0.00000	-0.00770	0.00000	0.00000	0.00000	1.0000000000	1.0000000000	0.06393	-0.08940	0	7	0	7	3	0	0.00000	0.00000
53	7200002	Alcoholism	113	443165006	Pathological fracture due to osteoporosis (disorder)	1095	5	10	0	5	10	1080	0.00000	-0.00650	0.00000	0.00000	0.00000	1.0000000000	1.0000000000	0.04566	-0.06442	0	7	0	5	3	0	0.00000	0.00000
52	124171000119105	Chronic intractable migraine without aura	113	443165006	Pathological fracture due to osteoporosis (disorder)	1095	51	10	0	51	10	1034	0.00000	-0.02122	0.00000	0.00000	0.00000	1.0000000000	1.0000000000	0.46575	-0.55164	21	7	0	30	3	0	0.00000	0.00000
50	446096008	Perennial allergic rhinitis	113	443165006	Pathological fracture due to osteoporosis (disorder)	1095	26	10	0	26	10	1059	0.00000	-0.01497	0.00000	0.00000	0.00000	1.0000000000	1.0000000000	0.23744	-0.30736	14	7	0	12	3	0	0.00000	0.00000
49	88805009	Chronic congestive heart failure (disorder)	113	443165006	Pathological fracture due to osteoporosis (disorder)	1095	10	10	0	10	10	1075	0.00000	-0.00922	0.00000	0.00000	0.00000	1.0000000000	1.0000000000	0.09132	-0.12608	5	7	0	5	3	0	0.00000	0.00000
47	359817006	Closed fracture of hip	113	443165006	Pathological fracture due to osteoporosis (disorder)	1095	29	10	1	28	9	1057	3.77586	0.04395	4.19444	34.24543	0.51374	0.2362654258	0.9019682653	0.26484	0.66104	11	7	1	18	3	0	2.07944	2.48491
46	62564004	Concussion with loss of consciousness	113	443165006	Pathological fracture due to osteoporosis (disorder)	1095	67	10	1	66	9	1019	1.63433	0.01555	1.71549	13.74436	0.21412	0.4695801921	1.0000000000	0.61187	0.31126	36	7	0	31	3	1	-1.38629	-3.46574
45	263102004	Fracture subluxation of wrist	113	443165006	Pathological fracture due to osteoporosis (disorder)	1095	109	10	2	107	8	978	2.00917	0.03221	2.28505	10.89905	0.47907	0.2619450092	0.9281913645	0.99543	0.58826	51	7	2	58	3	0	1.50408	3.27714
44	58150001	Fracture of clavicle	113	443165006	Pathological fracture due to osteoporosis (disorder)	1095	112	10	2	110	8	975	1.95536	0.03096	2.21591	10.56601	0.46472	0.2726127651	0.9473455472	1.02283	0.56859	55	7	1	57	3	1	0.69315	-0.03509
43	307731004	Injury of tendon of the rotator cuff of shoulder	113	443165006	Pathological fracture due to osteoporosis (disorder)	1095	51	10	0	51	10	1034	0.00000	-0.02122	0.00000	0.00000	0.00000	1.0000000000	1.0000000000	0.46575	-0.55164	26	7	0	25	3	0	0.00000	0.00000
42	16114001	Fracture of ankle	113	443165006	Pathological fracture due to osteoporosis (disorder)	1095	108	10	2	106	8	979	2.02778	0.03264	2.30896	11.01430	0.48404	0.2583962572	0.9231592779	0.98630	0.59488	48	7	1	60	3	1	0.69315	-0.21905
41	283385000	Laceration of thigh	113	443165006	Pathological fracture due to osteoporosis (disorder)	1095	105	10	1	104	9	981	1.04286	0.00134	1.04808	8.35455	0.13148	1.0000000000	1.0000000000	0.95890	0.02995	50	7	1	55	3	0	2.07944	3.93183
40	428251008	History of appendectomy	113	443165006	Pathological fracture due to osteoporosis (disorder)	1095	51	10	1	50	9	1035	2.14706	0.02434	2.30000	18.50972	0.28580	0.3805778618	1.0000000000	0.46575	0.44836	27	7	1	24	3	0	2.07944	3.33220
39	74400008	Appendicitis	113	443165006	Pathological fracture due to osteoporosis (disorder)	1095	51	10	1	50	9	1035	2.14706	0.02434	2.30000	18.50972	0.28580	0.3805778618	1.0000000000	0.46575	0.44836	27	7	1	24	3	0	2.07944	3.33220
38	398254007	Preeclampsia	113	443165006	Pathological fracture due to osteoporosis (disorder)	1095	101	10	0	101	10	984	0.00000	-0.03060	0.00000	0.00000	0.00000	0.6120433530	1.0000000000	0.92237	-0.94289	101	7	0	0	3	0	0.00000	0.00000
37	38822007	Cystitis	113	443165006	Pathological fracture due to osteoporosis (disorder)	1095	71	10	1	70	9	1015	1.54225	0.01371	1.61111	12.89783	0.20125	0.4899492029	1.0000000000	0.64840	0.27893	68	7	1	3	3	0	2.07944	4.23411
35	19169002	Miscarriage in first trimester	113	443165006	Pathological fracture due to osteoporosis (disorder)	1095	174	10	5	169	5	916	3.14655	0.08957	5.42012	18.92573	1.55226	0.0122399078	0.1758584161	1.58904	1.21254	174	7	5	0	3	0	0.87547	3.57795
33	429007001	History of cardiac arrest (situation)	113	443165006	Pathological fracture due to osteoporosis (disorder)	1095	42	10	3	39	7	1046	7.82143	0.13079	11.49451	46.13780	2.86367	0.0052235691	0.0931740363	0.38356	1.53161	24	7	2	18	3	1	0.11778	-0.37949
32	410429000	Cardiac Arrest	113	443165006	Pathological fracture due to osteoporosis (disorder)	1095	42	10	3	39	7	1046	7.82143	0.13079	11.49451	46.13780	2.86367	0.0052235691	0.0931740363	0.38356	1.53161	24	7	2	18	3	1	0.11778	-0.37949
30	399211009	History of myocardial infarction (situation)	113	443165006	Pathological fracture due to osteoporosis (disorder)	1095	31	10	0	31	10	1054	0.00000	-0.01639	0.00000	0.00000	0.00000	1.0000000000	1.0000000000	0.28311	-0.35964	2	7	0	29	3	0	0.00000	0.00000
29	22298006	Myocardial Infarction	113	443165006	Pathological fracture due to osteoporosis (disorder)	1095	31	10	0	31	10	1054	0.00000	-0.01639	0.00000	0.00000	0.00000	1.0000000000	1.0000000000	0.28311	-0.35964	2	7	0	29	3	0	0.00000	0.00000
28	53741008	Coronary Heart Disease	113	443165006	Pathological fracture due to osteoporosis (disorder)	1095	80	10	2	78	8	1007	2.73750	0.04683	3.22756	15.45986	0.67382	0.1620390800	0.7871494436	0.73059	0.79370	24	7	2	56	3	0	1.50408	2.56495
27	408512008	Body mass index 40+ - severely obese (finding)	113	443165006	Pathological fracture due to osteoporosis (disorder)	1095	97	10	0	97	10	988	0.00000	-0.02993	0.00000	0.00000	0.00000	1.0000000000	1.0000000000	0.88584	-0.91521	67	7	0	30	3	0	0.00000	0.00000
26	33737001	Fracture of rib	113	443165006	Pathological fracture due to osteoporosis (disorder)	1095	54	10	1	53	9	1032	2.02778	0.02247	2.16352	17.39328	0.26912	0.3982241506	1.0000000000	0.49315	0.42164	32	7	1	22	3	0	2.07944	3.49651
24	162864005	Body mass index 30+ - obesity (finding)	113	443165006	Pathological fracture due to osteoporosis (disorder)	1095	439	10	7	432	3	653	1.74601	0.05859	3.52701	13.71384	0.90710	0.0997183687	0.6255159994	4.00913	0.67544	226	7	5	213	3	2	-0.04082	-0.84451
23	36971009	Sinusitis (disorder)	113	443165006	Pathological fracture due to osteoporosis (disorder)	1095	190	10	3	187	7	898	1.72895	0.03207	2.05806	8.03184	0.52735	0.3909628602	1.0000000000	1.73516	0.54837	84	7	3	106	3	0	1.20397	3.36730
21	15777000	Prediabetes	113	443165006	Pathological fracture due to osteoporosis (disorder)	1095	333	10	3	330	7	755	0.98649	-0.00086	0.98052	3.81524	0.25199	1.0000000000	1.0000000000	3.04110	-0.01475	159	7	2	174	3	1	0.11778	-0.77653
20	80394007	Hyperglycemia (disorder)	113	443165006	Pathological fracture due to osteoporosis (disorder)	1095	55	10	1	54	9	1031	1.99091	0.02188	2.12140	17.04917	0.26396	0.4040048984	1.0000000000	0.50228	0.41284	23	7	1	32	3	0	2.07944	3.17805
19	237602007	Metabolic syndrome X (disorder)	113	443165006	Pathological fracture due to osteoporosis (disorder)	1095	64	10	2	62	8	1023	3.42187	0.05793	4.12500	19.83836	0.85771	0.1117994771	0.6583985495	0.58447	0.92096	28	7	2	36	3	0	1.50408	2.70805
18	302870006	Hypertriglyceridemia (disorder)	113	443165006	Pathological fracture due to osteoporosis (disorder)	1095	64	10	2	62	8	1023	3.42187	0.05793	4.12500	19.83836	0.85771	0.1117994771	0.6583985495	0.58447	0.92096	28	7	2	36	3	0	1.50408	2.70805
17	368581000119106	Neuropathy due to type 2 diabetes mellitus (disorder)	113	443165006	Pathological fracture due to osteoporosis (disorder)	1095	28	10	1	27	9	1058	3.91071	0.04527	4.35391	35.59037	0.53263	0.2290399332	0.8880487574	0.25571	0.67150	7	7	1	21	3	0	2.07944	2.07944
129	47505003	Posttraumatic stress disorder	87	109838007	Overlapping malignant neoplasm of colon	1095	4	8	0	4	8	1083	0.00000	-0.00519	0.00000	0.00000	0.00000	1.0000000000	1.0000000000	0.02922	-0.04156	1	5	0	3	3	0	0.00000	0.00000
15	40055000	Chronic sinusitis (disorder)	113	443165006	Pathological fracture due to osteoporosis (disorder)	1095	216	10	5	211	5	874	2.53472	0.07304	4.14218	14.43848	1.18833	0.0303710085	0.3209857386	1.97260	1.01324	104	7	4	112	3	1	-0.37469	-1.43155
14	10509002	Acute bronchitis (disorder)	113	443165006	Pathological fracture due to osteoporosis (disorder)	1095	863	10	10	853	0	232	1.26883	0.04978	0.00000	0.00000	0.00000	0.1319917848	0.7140816678	7.88128	0.30866	418	7	7	445	3	3	0.00000	-0.90000
13	370247008	Facial laceration	113	443165006	Pathological fracture due to osteoporosis (disorder)	1095	109	10	2	107	8	978	2.00917	0.03221	2.28505	10.89905	0.47907	0.2619450092	0.9281913645	0.99543	0.58826	55	7	0	54	3	2	-0.91629	-3.33220
125	1734006	Fracture of the vertebral column with spinal cord injury	87	109838007	Overlapping malignant neoplasm of colon	1095	5	8	0	5	8	1082	0.00000	-0.00581	0.00000	0.00000	0.00000	1.0000000000	1.0000000000	0.03653	-0.05176	3	5	0	2	3	0	0.00000	0.00000
124	1501000119109	Proliferative diabetic retinopathy due to type II diabetes mellitus (disorder)	87	109838007	Overlapping malignant neoplasm of colon	1095	1	8	0	1	8	1086	0.00000	-0.00259	0.00000	0.00000	0.00000	1.0000000000	1.0000000000	0.00731	-0.01050	1	5	0	0	3	0	0.00000	0.00000
10	62106007	Concussion with no loss of consciousness	113	443165006	Pathological fracture due to osteoporosis (disorder)	1095	206	10	0	206	10	879	0.00000	-0.04621	0.00000	0.00000	0.00000	0.2231718333	0.8794911525	1.88128	-1.52671	96	7	0	110	3	0	0.00000	0.00000
9	44465007	Sprain of ankle	113	443165006	Pathological fracture due to osteoporosis (disorder)	1095	362	10	5	357	5	728	1.51243	0.03457	2.03922	7.08946	0.58656	0.3128096708	1.0000000000	3.30594	0.47864	185	7	3	177	3	2	0.28768	-0.35641
8	233678006	Childhood asthma	113	443165006	Pathological fracture due to osteoporosis (disorder)	1095	45	10	0	45	10	1040	0.00000	-0.01987	0.00000	0.00000	0.00000	1.0000000000	1.0000000000	0.41096	-0.49668	25	7	0	20	3	0	0.00000	0.00000
7	75498004	Acute bacterial sinusitis (disorder)	113	443165006	Pathological fracture due to osteoporosis (disorder)	1095	187	10	1	186	9	899	0.58556	-0.01806	0.53704	4.26449	0.06763	1.0000000000	1.0000000000	1.70776	-0.43710	89	7	1	98	3	0	2.07944	4.49981
6	39848009	Whiplash injury to neck	113	443165006	Pathological fracture due to osteoporosis (disorder)	1095	182	10	1	181	9	904	0.60165	-0.01707	0.55494	4.40724	0.06988	1.0000000000	1.0000000000	1.66210	-0.41257	92	7	0	90	3	1	-1.38629	-4.51086
5	284549007	Laceration of hand	113	443165006	Pathological fracture due to osteoporosis (disorder)	1095	104	10	0	104	10	981	0.00000	-0.03110	0.00000	0.00000	0.00000	0.6112837428	1.0000000000	0.94977	-0.96331	54	7	0	50	3	0	0.00000	0.00000
4	195662009	Acute viral pharyngitis (disorder)	113	443165006	Pathological fracture due to osteoporosis (disorder)	1095	890	10	10	880	0	205	1.23034	0.04608	0.00000	0.00000	0.00000	0.2231167559	0.8794911525	8.12785	0.26916	430	7	7	460	3	3	0.00000	-0.90509
3	65363002	Otitis media	113	443165006	Pathological fracture due to osteoporosis (disorder)	1095	580	10	2	578	8	507	0.37759	-0.06341	0.21929	1.03740	0.04635	0.0528584566	0.4440110358	5.29680	-1.06966	277	7	1	303	3	1	0.69315	-0.08941
115	36923009	Major depression  single episode	87	109838007	Overlapping malignant neoplasm of colon	1095	6	8	0	6	8	1081	0.00000	-0.00637	0.00000	0.00000	0.00000	1.0000000000	1.0000000000	0.04384	-0.06189	3	5	0	3	3	0	0.00000	0.00000
1	444814009	Viral sinusitis (disorder)	113	443165006	Pathological fracture due to osteoporosis (disorder)	1095	993	10	10	983	0	102	1.10272	0.03077	0.00000	0.00000	0.00000	0.6117496631	1.0000000000	9.06849	0.12766	478	7	7	515	3	3	0.00000	-0.91312
113	443165006	Pathological fracture due to osteoporosis (disorder)	87	109838007	Overlapping malignant neoplasm of colon	1095	10	8	0	10	8	1077	0.00000	-0.00824	0.00000	0.00000	0.00000	1.0000000000	1.0000000000	0.07306	-0.10173	7	5	0	3	3	0	0.00000	0.00000
112	49436004	Atrial Fibrillation	87	109838007	Overlapping malignant neoplasm of colon	1095	35	8	0	35	8	1052	0.00000	-0.01559	0.00000	0.00000	0.00000	1.0000000000	1.0000000000	0.25571	-0.32850	9	5	0	26	3	0	0.00000	0.00000
111	235919008	Cholelithiasis	87	109838007	Overlapping malignant neoplasm of colon	1095	9	8	0	9	8	1078	0.00000	-0.00781	0.00000	0.00000	0.00000	1.0000000000	1.0000000000	0.06575	-0.09187	7	5	0	2	3	0	0.00000	0.00000
110	65275009	Acute Cholecystitis	87	109838007	Overlapping malignant neoplasm of colon	1095	9	8	0	9	8	1078	0.00000	-0.00781	0.00000	0.00000	0.00000	1.0000000000	1.0000000000	0.06575	-0.09187	7	5	0	2	3	0	0.00000	0.00000
109	90560007	Gout	87	109838007	Overlapping malignant neoplasm of colon	1095	4	8	0	4	8	1083	0.00000	-0.00519	0.00000	0.00000	0.00000	1.0000000000	1.0000000000	0.02922	-0.04156	0	5	0	4	3	0	0.00000	0.00000
108	40930008	Hypothyroidism (disorder)	87	109838007	Overlapping malignant neoplasm of colon	1095	13	8	1	12	7	1075	10.52885	0.08960	12.79762	112.21552	1.45950	0.0914034373	0.5996557347	0.09498	0.86910	11	5	1	2	3	0	1.79176	2.48491
107	40275004	Contact dermatitis	87	109838007	Overlapping malignant neoplasm of colon	1095	18	8	0	18	8	1069	0.00000	-0.01109	0.00000	0.00000	0.00000	1.0000000000	1.0000000000	0.13151	-0.17825	9	5	0	9	3	0	0.00000	0.00000
106	24079001	Atopic dermatitis	87	109838007	Overlapping malignant neoplasm of colon	1095	20	8	0	20	8	1067	0.00000	-0.01170	0.00000	0.00000	0.00000	1.0000000000	1.0000000000	0.14612	-0.19676	13	5	0	7	3	0	0.00000	0.00000
105	363406005	Malignant tumor of colon	87	109838007	Overlapping malignant neoplasm of colon	1095	6	8	0	6	8	1081	0.00000	-0.00637	0.00000	0.00000	0.00000	1.0000000000	1.0000000000	0.04384	-0.06189	4	5	0	2	3	0	0.00000	0.00000
104	367498001	Seasonal allergic rhinitis	87	109838007	Overlapping malignant neoplasm of colon	1095	20	8	0	20	8	1067	0.00000	-0.01170	0.00000	0.00000	0.00000	1.0000000000	1.0000000000	0.14612	-0.19676	9	5	0	11	3	0	0.00000	0.00000
103	157141000119108	Proteinuria due to type 2 diabetes mellitus (disorder)	87	109838007	Overlapping malignant neoplasm of colon	1095	3	8	0	3	8	1084	0.00000	-0.00450	0.00000	0.00000	0.00000	1.0000000000	1.0000000000	0.02192	-0.03128	1	5	0	2	3	0	0.00000	0.00000
102	90781000119102	Microalbuminuria due to type 2 diabetes mellitus (disorder)	87	109838007	Overlapping malignant neoplasm of colon	1095	6	8	0	6	8	1081	0.00000	-0.00637	0.00000	0.00000	0.00000	1.0000000000	1.0000000000	0.04384	-0.06189	3	5	0	3	3	0	0.00000	0.00000
101	433144002	Chronic kidney disease stage 3 (disorder)	87	109838007	Overlapping malignant neoplasm of colon	1095	3	8	0	3	8	1084	0.00000	-0.00450	0.00000	0.00000	0.00000	1.0000000000	1.0000000000	0.02192	-0.03128	1	5	0	2	3	0	0.00000	0.00000
100	161622006	History of lower limb amputation (situation)	87	109838007	Overlapping malignant neoplasm of colon	1095	1	8	0	1	8	1086	0.00000	-0.00259	0.00000	0.00000	0.00000	1.0000000000	1.0000000000	0.00731	-0.01050	0	5	0	1	3	0	0.00000	0.00000
99	30832001	Rupture of patellar tendon	87	109838007	Overlapping malignant neoplasm of colon	1095	23	8	0	23	8	1064	0.00000	-0.01257	0.00000	0.00000	0.00000	1.0000000000	1.0000000000	0.16804	-0.22409	14	5	0	9	3	0	0.00000	0.00000
98	1551000119108	Nonproliferative diabetic retinopathy due to type 2 diabetes mellitus (disorder)	87	109838007	Overlapping malignant neoplasm of colon	1095	12	8	0	12	8	1075	0.00000	-0.00903	0.00000	0.00000	0.00000	1.0000000000	1.0000000000	0.08767	-0.12124	7	5	0	5	3	0	0.00000	0.00000
97	403192003	Third degree burn	87	109838007	Overlapping malignant neoplasm of colon	1095	8	8	0	8	8	1079	0.00000	-0.00736	0.00000	0.00000	0.00000	1.0000000000	1.0000000000	0.05845	-0.08195	3	5	0	5	3	0	0.00000	0.00000
96	283371005	Laceration of forearm	87	109838007	Overlapping malignant neoplasm of colon	1095	75	8	0	75	8	1012	0.00000	-0.02326	0.00000	0.00000	0.00000	1.0000000000	1.0000000000	0.54795	-0.63035	39	5	0	36	3	0	0.00000	0.00000
95	84757009	Epilepsy	87	109838007	Overlapping malignant neoplasm of colon	1095	30	8	0	30	8	1057	0.00000	-0.01440	0.00000	0.00000	0.00000	1.0000000000	1.0000000000	0.21918	-0.28591	13	5	0	17	3	0	0.00000	0.00000
94	703151001	History of single seizure (situation)	87	109838007	Overlapping malignant neoplasm of colon	1095	39	8	0	39	8	1048	0.00000	-0.01649	0.00000	0.00000	0.00000	1.0000000000	1.0000000000	0.28493	-0.36169	14	5	0	25	3	0	0.00000	0.00000
93	128613002	Seizure disorder	87	109838007	Overlapping malignant neoplasm of colon	1095	39	8	0	39	8	1048	0.00000	-0.01649	0.00000	0.00000	0.00000	1.0000000000	1.0000000000	0.28493	-0.36169	14	5	0	25	3	0	0.00000	0.00000
92	82423001	Chronic pain	87	109838007	Overlapping malignant neoplasm of colon	1095	52	8	0	52	8	1035	0.00000	-0.01916	0.00000	0.00000	0.00000	1.0000000000	1.0000000000	0.37991	-0.46457	24	5	0	28	3	0	0.00000	0.00000
91	64859006	Osteoporosis (disorder)	87	109838007	Overlapping malignant neoplasm of colon	1095	37	8	1	36	7	1051	3.69932	0.04331	4.17063	34.79706	0.49988	0.2411041016	0.9095097439	0.27032	0.65481	24	5	1	13	3	0	1.79176	3.21888
89	47693006	Rupture of appendix	87	109838007	Overlapping malignant neoplasm of colon	1095	20	8	1	19	7	1068	6.84375	0.06838	8.03008	68.51337	0.94116	0.1375236518	0.7296699408	0.14612	0.80324	10	5	0	10	3	1	-1.38629	-2.39790
88	197927001	Recurrent urinary tract infection	87	109838007	Overlapping malignant neoplasm of colon	1095	8	8	0	8	8	1079	0.00000	-0.00736	0.00000	0.00000	0.00000	1.0000000000	1.0000000000	0.05845	-0.08195	8	5	0	0	3	0	0.00000	0.00000
86	713197008	Recurrent rectal polyp	87	109838007	Overlapping malignant neoplasm of colon	1095	22	8	7	15	1	1072	43.55114	0.52270	500.26667	4322.16220	57.90313	0.0000000000	0.0000000003	0.16073	2.78497	12	5	4	10	3	3	0.11778	-0.08004
85	241929008	Acute allergic reaction	87	109838007	Overlapping malignant neoplasm of colon	1095	47	8	0	47	8	1040	0.00000	-0.01817	0.00000	0.00000	0.00000	1.0000000000	1.0000000000	0.34338	-0.42587	25	5	0	22	3	0	0.00000	0.00000
84	232353008	Perennial allergic rhinitis with seasonal variation	87	109838007	Overlapping malignant neoplasm of colon	1095	29	8	0	29	8	1058	0.00000	-0.01415	0.00000	0.00000	0.00000	1.0000000000	1.0000000000	0.21187	-0.27724	14	5	0	15	3	0	0.00000	0.00000
83	110030002	Concussion injury of brain	87	109838007	Overlapping malignant neoplasm of colon	1095	7	8	0	7	8	1080	0.00000	-0.00688	0.00000	0.00000	0.00000	1.0000000000	1.0000000000	0.05114	-0.07196	1	5	0	6	3	0	0.00000	0.00000
82	94260004	Secondary malignant neoplasm of colon	87	109838007	Overlapping malignant neoplasm of colon	1095	4	8	0	4	8	1083	0.00000	-0.00519	0.00000	0.00000	0.00000	1.0000000000	1.0000000000	0.02922	-0.04156	2	5	0	2	3	0	0.00000	0.00000
81	236077008	Protracted diarrhea	87	109838007	Overlapping malignant neoplasm of colon	1095	4	8	0	4	8	1083	0.00000	-0.00519	0.00000	0.00000	0.00000	1.0000000000	1.0000000000	0.02922	-0.04156	2	5	0	2	3	0	0.00000	0.00000
80	6072007	Bleeding from anus	87	109838007	Overlapping malignant neoplasm of colon	1095	4	8	0	4	8	1083	0.00000	-0.00519	0.00000	0.00000	0.00000	1.0000000000	1.0000000000	0.02922	-0.04156	2	5	0	2	3	0	0.00000	0.00000
79	45816000	Pyelonephritis	87	109838007	Overlapping malignant neoplasm of colon	1095	1	8	0	1	8	1086	0.00000	-0.00259	0.00000	0.00000	0.00000	1.0000000000	1.0000000000	0.00731	-0.01050	1	5	0	0	3	0	0.00000	0.00000
78	239872002	Osteoarthritis of hip	87	109838007	Overlapping malignant neoplasm of colon	1095	21	8	0	21	8	1066	0.00000	-0.01200	0.00000	0.00000	0.00000	1.0000000000	1.0000000000	0.15342	-0.20592	13	5	0	8	3	0	0.00000	0.00000
77	422034002	Diabetic retinopathy associated with type II diabetes mellitus (disorder)	87	109838007	Overlapping malignant neoplasm of colon	1095	20	8	0	20	8	1067	0.00000	-0.01170	0.00000	0.00000	0.00000	1.0000000000	1.0000000000	0.14612	-0.19676	8	5	0	12	3	0	0.00000	0.00000
76	127013003	Diabetic renal disease (disorder)	87	109838007	Overlapping malignant neoplasm of colon	1095	28	8	0	28	8	1059	0.00000	-0.01390	0.00000	0.00000	0.00000	1.0000000000	1.0000000000	0.20457	-0.26851	10	5	0	18	3	0	0.00000	0.00000
75	431855005	Chronic kidney disease stage 1 (disorder)	87	109838007	Overlapping malignant neoplasm of colon	1095	28	8	0	28	8	1059	0.00000	-0.01390	0.00000	0.00000	0.00000	1.0000000000	1.0000000000	0.20457	-0.26851	10	5	0	18	3	0	0.00000	0.00000
73	196416002	Impacted molars	87	109838007	Overlapping malignant neoplasm of colon	1095	49	8	0	49	8	1038	0.00000	-0.01857	0.00000	0.00000	0.00000	1.0000000000	1.0000000000	0.35799	-0.44147	25	5	0	24	3	0	0.00000	0.00000
72	35999006	Blighted ovum	87	109838007	Overlapping malignant neoplasm of colon	1095	53	8	0	53	8	1034	0.00000	-0.01935	0.00000	0.00000	0.00000	1.0000000000	1.0000000000	0.38721	-0.47219	53	5	0	0	3	0	0.00000	0.00000
71	201834006	Localized  primary osteoarthritis of the hand	87	109838007	Overlapping malignant neoplasm of colon	1095	28	8	1	27	7	1060	4.88839	0.05404	5.60847	47.18618	0.66661	0.1877127711	0.8181443419	0.20457	0.73149	19	5	0	9	3	1	-1.38629	-2.30259
70	87433001	Pulmonary emphysema (disorder)	87	109838007	Overlapping malignant neoplasm of colon	1095	17	8	1	16	7	1071	8.05147	0.07597	9.56250	82.31104	1.11093	0.1180150102	0.6815366836	0.12420	0.83110	9	5	1	8	3	0	1.79176	2.30259
69	233604007	Pneumonia	87	109838007	Overlapping malignant neoplasm of colon	1095	7	8	0	7	8	1080	0.00000	-0.00688	0.00000	0.00000	0.00000	1.0000000000	1.0000000000	0.05114	-0.07196	3	5	0	4	3	0	0.00000	0.00000
68	26929004	Alzheimer's disease (disorder)	87	109838007	Overlapping malignant neoplasm of colon	1095	23	8	2	21	6	1066	11.90217	0.13700	16.92063	88.77412	3.22513	0.0109487660	0.1636007828	0.16804	1.36088	15	5	2	8	3	0	1.25276	2.14007
67	403191005	Second degree burn	87	109838007	Overlapping malignant neoplasm of colon	1095	49	8	0	49	8	1038	0.00000	-0.01857	0.00000	0.00000	0.00000	1.0000000000	1.0000000000	0.35799	-0.44147	23	5	0	26	3	0	0.00000	0.00000
66	55822004	Hyperlipidemia	87	109838007	Overlapping malignant neoplasm of colon	1095	119	8	3	116	5	971	3.45063	0.07341	5.02241	21.28834	1.18490	0.0466032848	0.4136336033	0.86941	1.09742	64	5	2	55	3	1	-0.13353	-0.52884
65	239873007	Osteoarthritis of knee	87	109838007	Overlapping malignant neoplasm of colon	1095	57	8	1	56	7	1031	2.40132	0.02817	2.63010	21.74759	0.31808	0.3488917881	1.0000000000	0.41644	0.49773	30	5	1	27	3	0	1.79176	3.43399
64	444448004	Injury of medial collateral ligament of knee	87	109838007	Overlapping malignant neoplasm of colon	1095	32	8	1	31	7	1056	4.27734	0.04878	4.86636	40.76644	0.58091	0.2118347217	0.8671354646	0.23379	0.69690	17	5	1	15	3	0	1.79176	2.89037
63	68496003	Polyp of colon	87	109838007	Overlapping malignant neoplasm of colon	1095	91	8	8	83	0	1004	12.03297	0.28496	0.00000	0.00000	0.00000	0.0000000017	0.0000001276	0.66484	2.43454	43	5	5	48	3	3	0.00000	-0.57145
62	185086009	Chronic obstructive bronchitis (disorder)	87	109838007	Overlapping malignant neoplasm of colon	1095	6	8	1	5	7	1082	22.81250	0.13890	30.91429	299.83803	3.18736	0.0431395216	0.3985498161	0.04384	0.93811	4	5	1	2	3	0	1.79176	1.60944
61	198992004	Antepartum eclampsia	87	109838007	Overlapping malignant neoplasm of colon	1095	96	8	1	95	7	992	1.42578	0.01132	1.49173	12.25305	0.18161	0.5212170824	1.0000000000	0.70137	0.23330	96	5	1	0	3	0	1.79176	4.57471
60	301011002	Escherichia coli urinary tract infection	87	109838007	Overlapping malignant neoplasm of colon	1095	92	8	1	91	7	996	1.48777	0.01267	1.56358	12.84860	0.19028	0.5056085026	1.0000000000	0.67215	0.25830	85	5	1	7	3	0	1.79176	4.45435
59	262574004	Bullet wound	87	109838007	Overlapping malignant neoplasm of colon	1095	20	8	0	20	8	1067	0.00000	-0.01170	0.00000	0.00000	0.00000	1.0000000000	1.0000000000	0.14612	-0.19676	9	5	0	11	3	0	0.00000	0.00000
58	239720000	Tear of meniscus of knee	87	109838007	Overlapping malignant neoplasm of colon	1095	20	8	1	19	7	1068	6.84375	0.06838	8.03008	68.51337	0.94116	0.1375236518	0.7296699408	0.14612	0.80324	10	5	1	10	3	0	1.79176	2.39790
57	192127007	Child attention deficit disorder	87	109838007	Overlapping malignant neoplasm of colon	1095	76	8	0	76	8	1011	0.00000	-0.02343	0.00000	0.00000	0.00000	1.0000000000	1.0000000000	0.55525	-0.63715	24	5	0	52	3	0	0.00000	0.00000
56	92691004	Carcinoma in situ of prostate (disorder)	87	109838007	Overlapping malignant neoplasm of colon	1095	23	8	0	23	8	1064	0.00000	-0.01257	0.00000	0.00000	0.00000	1.0000000000	1.0000000000	0.16804	-0.22409	0	5	0	23	3	0	0.00000	0.00000
55	126906006	Neoplasm of prostate	87	109838007	Overlapping malignant neoplasm of colon	1095	24	8	0	24	8	1063	0.00000	-0.01284	0.00000	0.00000	0.00000	1.0000000000	1.0000000000	0.17534	-0.23308	0	5	0	24	3	0	0.00000	0.00000
54	5602001	Opioid abuse (disorder)	87	109838007	Overlapping malignant neoplasm of colon	1095	7	8	0	7	8	1080	0.00000	-0.00688	0.00000	0.00000	0.00000	1.0000000000	1.0000000000	0.05114	-0.07196	0	5	0	7	3	0	0.00000	0.00000
53	7200002	Alcoholism	87	109838007	Overlapping malignant neoplasm of colon	1095	5	8	0	5	8	1082	0.00000	-0.00581	0.00000	0.00000	0.00000	1.0000000000	1.0000000000	0.03653	-0.05176	0	5	0	5	3	0	0.00000	0.00000
52	124171000119105	Chronic intractable migraine without aura	87	109838007	Overlapping malignant neoplasm of colon	1095	51	8	0	51	8	1036	0.00000	-0.01896	0.00000	0.00000	0.00000	1.0000000000	1.0000000000	0.37260	-0.45691	21	5	0	30	3	0	0.00000	0.00000
51	403190006	First degree burn	87	109838007	Overlapping malignant neoplasm of colon	1095	79	8	1	78	7	1009	1.73259	0.01753	1.84799	15.21088	0.22451	0.4517620517	1.0000000000	0.57717	0.34266	43	5	0	36	3	1	-1.38629	-3.61092
50	446096008	Perennial allergic rhinitis	87	109838007	Overlapping malignant neoplasm of colon	1095	26	8	0	26	8	1061	0.00000	-0.01338	0.00000	0.00000	0.00000	1.0000000000	1.0000000000	0.18995	-0.25091	14	5	0	12	3	0	0.00000	0.00000
49	88805009	Chronic congestive heart failure (disorder)	87	109838007	Overlapping malignant neoplasm of colon	1095	10	8	1	9	7	1078	13.68750	0.10449	17.11111	153.74943	1.90433	0.0709862805	0.5245934178	0.07306	0.89827	5	5	0	5	3	1	-1.38629	-1.79176
48	55680006	Drug overdose	87	109838007	Overlapping malignant neoplasm of colon	1095	50	8	1	49	7	1038	2.73750	0.03260	3.02624	25.08106	0.36514	0.3127994139	1.0000000000	0.36530	0.55079	24	5	1	26	3	0	1.79176	3.21888
47	359817006	Closed fracture of hip	87	109838007	Overlapping malignant neoplasm of colon	1095	29	8	1	28	7	1059	4.71983	0.05263	5.40306	45.40386	0.64296	0.1938030221	0.8321439142	0.21187	0.72276	11	5	1	18	3	0	1.79176	2.48491
46	62564004	Concussion with loss of consciousness	87	109838007	Overlapping malignant neoplasm of colon	1095	67	8	0	67	8	1020	0.00000	-0.02190	0.00000	0.00000	0.00000	1.0000000000	1.0000000000	0.48950	-0.57483	36	5	0	31	3	0	0.00000	0.00000
45	263102004	Fracture subluxation of wrist	87	109838007	Overlapping malignant neoplasm of colon	1095	109	8	2	107	6	980	2.51147	0.04311	3.05296	15.31467	0.60860	0.1851222003	0.8181443419	0.79635	0.73990	51	5	2	58	3	0	1.25276	3.27714
44	58150001	Fracture of clavicle	87	109838007	Overlapping malignant neoplasm of colon	1095	112	8	0	112	8	975	0.00000	-0.02896	0.00000	0.00000	0.00000	1.0000000000	1.0000000000	0.81826	-0.86256	55	5	0	57	3	0	0.00000	0.00000
43	307731004	Injury of tendon of the rotator cuff of shoulder	87	109838007	Overlapping malignant neoplasm of colon	1095	51	8	0	51	8	1036	0.00000	-0.01896	0.00000	0.00000	0.00000	1.0000000000	1.0000000000	0.37260	-0.45691	26	5	0	25	3	0	0.00000	0.00000
42	16114001	Fracture of ankle	87	109838007	Overlapping malignant neoplasm of colon	1095	108	8	0	108	8	979	0.00000	-0.02838	0.00000	0.00000	0.00000	1.0000000000	1.0000000000	0.78904	-0.83919	48	5	0	60	3	0	0.00000	0.00000
41	283385000	Laceration of thigh	87	109838007	Overlapping malignant neoplasm of colon	1095	105	8	1	104	7	983	1.30357	0.00848	1.35027	11.08203	0.16452	0.5547693232	1.0000000000	0.76712	0.17860	50	5	0	55	3	1	-1.38629	-4.02535
40	428251008	History of appendectomy	87	109838007	Overlapping malignant neoplasm of colon	1095	51	8	1	50	7	1037	2.68382	0.03193	2.96286	24.54668	0.35763	0.3180602796	1.0000000000	0.37260	0.54309	27	5	0	24	3	1	-1.38629	-3.21888
39	74400008	Appendicitis	87	109838007	Overlapping malignant neoplasm of colon	1095	51	8	1	50	7	1037	2.68382	0.03193	2.96286	24.54668	0.35763	0.3180602796	1.0000000000	0.37260	0.54309	27	5	0	24	3	1	-1.38629	-3.21888
38	398254007	Preeclampsia	87	109838007	Overlapping malignant neoplasm of colon	1095	101	8	2	99	6	988	2.71040	0.04677	3.32660	16.70219	0.66256	0.1636432273	0.7879650300	0.73790	0.78762	101	5	2	0	3	0	1.25276	3.94158
37	38822007	Cystitis	87	109838007	Overlapping malignant neoplasm of colon	1095	71	8	1	70	7	1017	1.92782	0.02096	2.07551	17.10635	0.25182	0.4161341830	1.0000000000	0.51872	0.39714	68	5	0	3	3	1	-1.38629	-1.38629
36	156073000	Fetus with unknown complication	87	109838007	Overlapping malignant neoplasm of colon	1095	125	8	2	123	6	964	2.19000	0.03665	2.61247	13.08630	0.52154	0.2295989770	0.8880487574	0.91324	0.64894	125	5	2	0	3	0	1.25276	4.15104
35	19169002	Miscarriage in first trimester	87	109838007	Overlapping malignant neoplasm of colon	1095	174	8	3	171	5	916	2.35991	0.05071	3.21404	13.57414	0.76101	0.1199061381	0.6843537581	1.27123	0.81652	174	5	3	0	3	0	0.98083	4.07754
33	429007001	History of cardiac arrest (situation)	87	109838007	Overlapping malignant neoplasm of colon	1095	42	8	1	41	7	1046	3.25893	0.03870	3.64460	30.31510	0.43817	0.2694179494	0.9388450812	0.30685	0.61391	24	5	1	18	3	0	1.79176	3.21888
32	410429000	Cardiac Arrest	87	109838007	Overlapping malignant neoplasm of colon	1095	42	8	1	41	7	1046	3.25893	0.03870	3.64460	30.31510	0.43817	0.2694179494	0.9388450812	0.30685	0.61391	24	5	1	18	3	0	1.79176	3.21888
31	230690007	Stroke	87	109838007	Overlapping malignant neoplasm of colon	1095	62	8	2	60	6	1027	4.41532	0.07178	5.70556	28.86935	1.12761	0.0708470093	0.5245934178	0.45297	1.04596	32	5	1	30	3	1	0.40547	0.06252
30	399211009	History of myocardial infarction (situation)	87	109838007	Overlapping malignant neoplasm of colon	1095	31	8	0	31	8	1056	0.00000	-0.01464	0.00000	0.00000	0.00000	1.0000000000	1.0000000000	0.22648	-0.29453	2	5	0	29	3	0	0.00000	0.00000
29	22298006	Myocardial Infarction	87	109838007	Overlapping malignant neoplasm of colon	1095	31	8	0	31	8	1056	0.00000	-0.01464	0.00000	0.00000	0.00000	1.0000000000	1.0000000000	0.22648	-0.29453	2	5	0	29	3	0	0.00000	0.00000
28	53741008	Coronary Heart Disease	87	109838007	Overlapping malignant neoplasm of colon	1095	80	8	3	77	5	1010	5.13281	0.09954	7.87013	33.55098	1.84611	0.0160955033	0.2163649737	0.58447	1.33600	24	5	2	56	3	1	-0.13353	-1.47810
27	408512008	Body mass index 40+ - severely obese (finding)	87	109838007	Overlapping malignant neoplasm of colon	1095	97	8	0	97	8	990	0.00000	-0.02675	0.00000	0.00000	0.00000	1.0000000000	1.0000000000	0.70868	-0.77288	67	5	0	30	3	0	0.00000	0.00000
26	33737001	Fracture of rib	87	109838007	Overlapping malignant neoplasm of colon	1095	54	8	0	54	8	1033	0.00000	-0.01954	0.00000	0.00000	0.00000	1.0000000000	1.0000000000	0.39452	-0.47977	32	5	0	22	3	0	0.00000	0.00000
25	284551006	Laceration of foot	87	109838007	Overlapping malignant neoplasm of colon	1095	118	8	3	115	5	972	3.47987	0.07394	5.07130	21.49769	1.19632	0.0455940612	0.4094197322	0.86210	1.10307	53	5	2	65	3	1	-0.13353	-0.87547
24	162864005	Body mass index 30+ - obesity (finding)	87	109838007	Overlapping malignant neoplasm of colon	1095	439	8	3	436	5	651	0.93536	-0.00454	0.89587	3.76794	0.21300	1.0000000000	1.0000000000	3.20731	-0.07290	226	5	3	213	3	0	0.98083	4.33511
23	36971009	Sinusitis (disorder)	87	109838007	Overlapping malignant neoplasm of colon	1095	190	8	0	190	8	897	0.00000	-0.03931	0.00000	0.00000	0.00000	0.3637853083	1.0000000000	1.38813	-1.25588	84	5	0	106	3	0	0.00000	0.00000
22	70704007	Sprain of wrist	87	109838007	Overlapping malignant neoplasm of colon	1095	195	8	1	194	7	893	0.70192	-0.01190	0.65758	5.37551	0.08044	1.0000000000	1.0000000000	1.42466	-0.27778	90	5	0	105	3	1	-1.38629	-4.66344
21	15777000	Prediabetes	87	109838007	Overlapping malignant neoplasm of colon	1095	333	8	7	326	1	761	2.87725	0.10646	16.34049	133.34650	2.00239	0.0013584066	0.0315452198	2.43288	1.22058	159	5	4	174	3	3	0.11778	-0.37008
20	80394007	Hyperglycemia (disorder)	87	109838007	Overlapping malignant neoplasm of colon	1095	55	8	0	55	8	1032	0.00000	-0.01973	0.00000	0.00000	0.00000	1.0000000000	1.0000000000	0.40183	-0.48731	23	5	0	32	3	0	0.00000	0.00000
19	237602007	Metabolic syndrome X (disorder)	87	109838007	Overlapping malignant neoplasm of colon	1095	64	8	0	64	8	1023	0.00000	-0.02137	0.00000	0.00000	0.00000	1.0000000000	1.0000000000	0.46758	-0.55344	28	5	0	36	3	0	0.00000	0.00000
18	302870006	Hypertriglyceridemia (disorder)	87	109838007	Overlapping malignant neoplasm of colon	1095	64	8	0	64	8	1023	0.00000	-0.02137	0.00000	0.00000	0.00000	1.0000000000	1.0000000000	0.46758	-0.55344	28	5	0	36	3	0	0.00000	0.00000
17	368581000119106	Neuropathy due to type 2 diabetes mellitus (disorder)	87	109838007	Overlapping malignant neoplasm of colon	1095	28	8	0	28	8	1059	0.00000	-0.01390	0.00000	0.00000	0.00000	1.0000000000	1.0000000000	0.20457	-0.26851	7	5	0	21	3	0	0.00000	0.00000
16	44054006	Diabetes	87	109838007	Overlapping malignant neoplasm of colon	1095	68	8	0	68	8	1019	0.00000	-0.02207	0.00000	0.00000	0.00000	1.0000000000	1.0000000000	0.49680	-0.58188	29	5	0	39	3	0	0.00000	0.00000
15	40055000	Chronic sinusitis (disorder)	87	109838007	Overlapping malignant neoplasm of colon	1095	216	8	5	211	3	876	3.16840	0.09222	6.91943	29.18225	1.64067	0.0095304276	0.1493894528	1.57808	1.21866	104	5	2	112	3	3	0.55962	0.32397
14	10509002	Acute bronchitis (disorder)	87	109838007	Overlapping malignant neoplasm of colon	1095	863	8	7	856	1	231	1.11023	0.01824	1.88902	15.43107	0.23125	1.0000000000	1.0000000000	6.30502	0.13111	418	5	5	445	3	2	-0.22314	-0.97148
13	370247008	Facial laceration	87	109838007	Overlapping malignant neoplasm of colon	1095	109	8	3	106	5	981	3.76720	0.07893	5.55283	23.56174	1.30864	0.0370517911	0.3610026234	0.79635	1.15493	55	5	1	54	3	2	0.87547	0.69315
12	65966004	Fracture of forearm	87	109838007	Overlapping malignant neoplasm of colon	1095	123	8	1	122	7	965	1.11280	0.00344	1.12998	9.26215	0.13786	1.0000000000	1.0000000000	0.89863	0.07504	55	5	1	68	3	0	1.79176	4.02535
11	38341003	Hypertension	87	109838007	Overlapping malignant neoplasm of colon	1095	278	8	2	276	6	811	0.98471	-0.00077	0.97947	4.88114	0.19654	1.0000000000	1.0000000000	2.03105	-0.01486	131	5	2	147	3	0	1.25276	4.19720
10	62106007	Concussion with no loss of consciousness	87	109838007	Overlapping malignant neoplasm of colon	1095	206	8	1	205	7	882	0.66444	-0.01386	0.61463	5.02320	0.07521	1.0000000000	1.0000000000	1.50502	-0.32482	96	5	1	110	3	0	1.79176	4.57471
9	44465007	Sprain of ankle	87	109838007	Overlapping malignant neoplasm of colon	1095	362	8	4	358	4	729	1.51243	0.03089	2.03631	8.18912	0.50635	0.4510371927	1.0000000000	2.64475	0.45611	185	5	2	177	3	2	0.33647	0.04372
8	233678006	Childhood asthma	87	109838007	Overlapping malignant neoplasm of colon	1095	45	8	0	45	8	1042	0.00000	-0.01776	0.00000	0.00000	0.00000	1.0000000000	1.0000000000	0.32877	-0.41009	25	5	0	20	3	0	0.00000	0.00000
7	75498004	Acute bacterial sinusitis (disorder)	87	109838007	Overlapping malignant neoplasm of colon	1095	187	8	2	185	6	902	1.46390	0.01806	1.62523	8.11530	0.32548	0.6307827705	1.0000000000	1.36621	0.34238	89	5	0	98	3	2	-0.91629	-3.91202
6	39848009	Whiplash injury to neck	87	109838007	Overlapping malignant neoplasm of colon	1095	182	8	2	180	6	907	1.50412	0.01931	1.67963	8.38841	0.33632	0.6265250190	1.0000000000	1.32968	0.36483	92	5	2	90	3	0	1.25276	3.85015
5	284549007	Laceration of hand	87	109838007	Overlapping malignant neoplasm of colon	1095	104	8	1	103	7	984	1.31611	0.00879	1.36477	11.20195	0.16627	0.5511458792	1.0000000000	0.75982	0.18457	54	5	1	50	3	0	1.79176	4.00733
4	195662009	Acute viral pharyngitis (disorder)	87	109838007	Overlapping malignant neoplasm of colon	1095	890	8	8	882	0	205	1.23034	0.04117	0.00000	0.00000	0.00000	0.3643124531	1.0000000000	6.50228	0.26260	430	5	5	460	3	3	0.00000	-0.57321
3	65363002	Otitis media	87	109838007	Overlapping malignant neoplasm of colon	1095	580	8	0	580	8	507	0.00000	-0.09104	0.00000	0.00000	0.00000	0.0023256694	0.0489561776	4.23744	-2.38886	277	5	0	303	3	0	0.00000	0.00000
2	43878008	Streptococcal sore throat (disorder)	87	109838007	Overlapping malignant neoplasm of colon	1095	523	8	2	521	6	566	0.52342	-0.03909	0.36212	1.80211	0.07277	0.2912162062	0.9768039197	3.82100	-0.68437	246	5	2	277	3	0	1.25276	4.82028
1	444814009	Viral sinusitis (disorder)	87	109838007	Overlapping malignant neoplasm of colon	1095	993	8	8	985	0	102	1.10272	0.02750	0.00000	0.00000	0.00000	1.0000000000	1.0000000000	7.25479	0.12469	478	5	5	515	3	3	0.00000	-0.58078
113	443165006	Pathological fracture due to osteoporosis (disorder)	61	198992004	Antepartum eclampsia	1095	10	96	1	9	95	990	1.14062	0.00419	1.15789	9.23765	0.14514	0.6020870012	1.0000000000	0.87671	0.09179	7	96	1	3	0	0	4.57471	2.07944
112	49436004	Atrial Fibrillation	61	198992004	Antepartum eclampsia	1095	35	96	0	35	96	964	0.00000	-0.05633	0.00000	0.00000	0.00000	0.0659640009	0.5030686361	3.06849	-2.02449	9	96	0	26	0	0	0.00000	0.00000
111	235919008	Cholelithiasis	61	198992004	Antepartum eclampsia	1095	9	96	2	7	94	992	2.53472	0.04331	3.01520	14.72145	0.61756	0.1829417552	0.8164019963	0.78904	0.74578	7	96	2	2	0	0	3.89182	1.50408
110	65275009	Acute Cholecystitis	61	198992004	Antepartum eclampsia	1095	9	96	2	7	94	992	2.53472	0.04331	3.01520	14.72145	0.61756	0.1829417552	0.8164019963	0.78904	0.74578	7	96	2	2	0	0	3.89182	1.50408
109	90560007	Gout	61	198992004	Antepartum eclampsia	1095	4	96	0	4	96	995	0.00000	-0.01877	0.00000	0.00000	0.00000	1.0000000000	1.0000000000	0.35068	-0.43369	0	96	0	4	0	0	0.00000	0.00000
108	40930008	Hypothyroidism (disorder)	61	198992004	Antepartum eclampsia	1095	13	96	1	12	95	987	0.87740	-0.00417	0.86579	6.73098	0.11136	1.0000000000	1.0000000000	1.13973	-0.09743	11	96	1	2	0	0	4.57471	2.48491
107	40275004	Contact dermatitis	61	198992004	Antepartum eclampsia	1095	18	96	3	15	93	984	1.90104	0.03611	2.11613	7.44307	0.60163	0.2045508071	0.8533859271	1.57808	0.63370	9	96	3	9	0	0	3.49651	1.38629
106	24079001	Atopic dermatitis	61	198992004	Antepartum eclampsia	1095	20	96	1	19	95	980	0.57031	-0.01817	0.54294	4.10054	0.07189	1.0000000000	1.0000000000	1.75342	-0.46123	13	96	1	7	0	0	4.57471	2.63906
105	363406005	Malignant tumor of colon	61	198992004	Antepartum eclampsia	1095	6	96	0	6	96	993	0.00000	-0.02301	0.00000	0.00000	0.00000	1.0000000000	1.0000000000	0.52603	-0.60978	4	96	0	2	0	0	0.00000	0.00000
104	367498001	Seasonal allergic rhinitis	61	198992004	Antepartum eclampsia	1095	20	96	2	18	94	981	1.14062	0.00595	1.15957	5.07422	0.26499	0.6925534431	1.0000000000	1.75342	0.12374	9	96	2	11	0	0	3.89182	1.70475
103	157141000119108	Proteinuria due to type 2 diabetes mellitus (disorder)	61	198992004	Antepartum eclampsia	1095	3	96	0	3	96	996	0.00000	-0.01625	0.00000	0.00000	0.00000	1.0000000000	1.0000000000	0.26301	-0.33687	1	96	0	2	0	0	0.00000	0.00000
102	90781000119102	Microalbuminuria due to type 2 diabetes mellitus (disorder)	61	198992004	Antepartum eclampsia	1095	6	96	0	6	96	993	0.00000	-0.02301	0.00000	0.00000	0.00000	1.0000000000	1.0000000000	0.52603	-0.60978	3	96	0	3	0	0	0.00000	0.00000
101	433144002	Chronic kidney disease stage 3 (disorder)	61	198992004	Antepartum eclampsia	1095	3	96	0	3	96	996	0.00000	-0.01625	0.00000	0.00000	0.00000	1.0000000000	1.0000000000	0.26301	-0.33687	1	96	0	2	0	0	0.00000	0.00000
100	161622006	History of lower limb amputation (situation)	61	198992004	Antepartum eclampsia	1095	1	96	0	1	96	998	0.00000	-0.00937	0.00000	0.00000	0.00000	1.0000000000	1.0000000000	0.08767	-0.12124	0	96	0	1	0	0	0.00000	0.00000
99	30832001	Rupture of patellar tendon	61	198992004	Antepartum eclampsia	1095	23	96	2	21	94	978	0.99185	-0.00037	0.99088	4.29135	0.22880	1.0000000000	1.0000000000	2.01644	-0.00788	14	96	2	9	0	0	3.89182	2.07944
98	1551000119108	Nonproliferative diabetic retinopathy due to type 2 diabetes mellitus (disorder)	61	198992004	Antepartum eclampsia	1095	12	96	2	10	94	989	1.90104	0.02940	2.10426	9.74557	0.45435	0.2839568883	0.9659403678	1.05205	0.54789	7	96	2	5	0	0	3.89182	1.50408
97	403192003	Third degree burn	61	198992004	Antepartum eclampsia	1095	8	96	0	8	96	991	0.00000	-0.02659	0.00000	0.00000	0.00000	1.0000000000	1.0000000000	0.70137	-0.76670	3	96	0	5	0	0	0.00000	0.00000
96	283371005	Laceration of forearm	61	198992004	Antepartum eclampsia	1095	75	96	8	67	88	932	1.21667	0.01821	1.26459	2.71771	0.58843	0.5253026075	1.0000000000	6.57534	0.24861	39	96	8	36	0	0	2.56495	1.77071
95	84757009	Epilepsy	61	198992004	Antepartum eclampsia	1095	30	96	2	28	94	971	0.76042	-0.01247	0.73784	3.14578	0.17306	1.0000000000	1.0000000000	2.63014	-0.27506	13	96	2	17	0	0	3.89182	2.01490
94	703151001	History of single seizure (situation)	61	198992004	Antepartum eclampsia	1095	39	96	2	37	94	962	0.58494	-0.02473	0.55319	2.33146	0.13126	0.5705810397	1.0000000000	3.41918	-0.55882	14	96	2	25	0	0	3.89182	2.07944
93	128613002	Seizure disorder	61	198992004	Antepartum eclampsia	1095	39	96	2	37	94	962	0.58494	-0.02473	0.55319	2.33146	0.13126	0.5705810397	1.0000000000	3.41918	-0.55882	14	96	2	25	0	0	3.89182	2.07944
92	82423001	Chronic pain	61	198992004	Antepartum eclampsia	1095	52	96	7	45	89	954	1.53546	0.03706	1.66742	3.80648	0.73041	0.2097860491	0.8625301822	4.55890	0.52520	24	96	7	28	0	0	2.68882	1.48808
91	64859006	Osteoporosis (disorder)	61	198992004	Antepartum eclampsia	1095	37	96	1	36	95	963	0.30828	-0.04010	0.28158	2.07676	0.03818	0.2454068118	0.9133257124	3.24384	-1.08537	24	96	1	13	0	0	4.57471	3.21888
89	47693006	Rupture of appendix	61	198992004	Antepartum eclampsia	1095	20	96	2	18	94	981	1.14062	0.00595	1.15957	5.07422	0.26499	0.6925534431	1.0000000000	1.75342	0.12374	10	96	2	10	0	0	3.89182	1.79176
88	197927001	Recurrent urinary tract infection	61	198992004	Antepartum eclampsia	1095	8	96	4	4	92	995	5.70312	0.12507	10.81522	43.95736	2.66096	0.0029548205	0.0592178404	0.70137	1.55523	8	96	4	0	0	0	3.21888	1.09861
86	713197008	Recurrent rectal polyp	61	198992004	Antepartum eclampsia	1095	22	96	3	19	93	980	1.55540	0.02465	1.66384	5.72709	0.48338	0.4326220320	1.0000000000	1.92877	0.44971	12	96	3	10	0	0	3.49651	1.60944
85	241929008	Acute allergic reaction	61	198992004	Antepartum eclampsia	1095	47	96	6	41	90	958	1.45612	0.02994	1.55772	3.76881	0.64384	0.2933577265	0.9796285312	4.12055	0.45106	25	96	6	22	0	0	2.83321	1.64223
84	232353008	Perennial allergic rhinitis with seasonal variation	61	198992004	Antepartum eclampsia	1095	29	96	5	24	91	975	1.96659	0.04942	2.23214	5.99026	0.83176	0.1024024996	0.6291042150	2.54247	0.76021	14	96	5	15	0	0	3.00568	1.33500
83	110030002	Concussion injury of brain	61	198992004	Antepartum eclampsia	1095	7	96	0	7	96	992	0.00000	-0.02486	0.00000	0.00000	0.00000	1.0000000000	1.0000000000	0.61370	-0.69037	1	96	0	6	0	0	0.00000	0.00000
82	94260004	Secondary malignant neoplasm of colon	61	198992004	Antepartum eclampsia	1095	4	96	1	3	95	996	2.85156	0.03475	3.49474	33.92652	0.35999	0.3075693478	0.9977249576	0.35068	0.56631	2	96	1	2	0	0	4.57471	1.09861
81	236077008	Protracted diarrhea	61	198992004	Antepartum eclampsia	1095	4	96	1	3	95	996	2.85156	0.03475	3.49474	33.92652	0.35999	0.3075693478	0.9977249576	0.35068	0.56631	2	96	1	2	0	0	4.57471	1.09861
80	6072007	Bleeding from anus	61	198992004	Antepartum eclampsia	1095	4	96	1	3	95	996	2.85156	0.03475	3.49474	33.92652	0.35999	0.3075693478	0.9977249576	0.35068	0.56631	2	96	1	2	0	0	4.57471	1.09861
79	45816000	Pyelonephritis	61	198992004	Antepartum eclampsia	1095	1	96	0	1	96	998	0.00000	-0.00937	0.00000	0.00000	0.00000	1.0000000000	1.0000000000	0.08767	-0.12124	1	96	0	0	0	0	0.00000	0.00000
78	239872002	Osteoarthritis of hip	61	198992004	Antepartum eclampsia	1095	21	96	4	17	92	982	2.17262	0.05083	2.51151	7.62048	0.82773	0.1043883026	0.6350107553	1.84110	0.81548	13	96	4	8	0	0	3.21888	1.44692
77	422034002	Diabetic retinopathy associated with type II diabetes mellitus (disorder)	61	198992004	Antepartum eclampsia	1095	20	96	2	18	94	981	1.14062	0.00595	1.15957	5.07422	0.26499	0.6925534431	1.0000000000	1.75342	0.12374	8	96	2	12	0	0	3.89182	1.60944
76	127013003	Diabetic renal disease (disorder)	61	198992004	Antepartum eclampsia	1095	28	96	1	27	95	972	0.40737	-0.02976	0.37895	2.81979	0.05093	0.5042626775	1.0000000000	2.45479	-0.78860	10	96	1	18	0	0	4.57471	2.39790
75	431855005	Chronic kidney disease stage 1 (disorder)	61	198992004	Antepartum eclampsia	1095	28	96	1	27	95	972	0.40737	-0.02976	0.37895	2.81979	0.05093	0.5042626775	1.0000000000	2.45479	-0.78860	10	96	1	18	0	0	4.57471	2.39790
73	196416002	Impacted molars	61	198992004	Antepartum eclampsia	1095	49	96	8	41	88	958	1.86224	0.05785	2.12417	4.67280	0.96561	0.0674113042	0.5101371685	4.29589	0.76505	25	96	8	24	0	0	2.56495	1.41707
72	35999006	Blighted ovum	61	198992004	Antepartum eclampsia	1095	53	96	15	38	81	961	3.22818	0.15578	4.68324	8.87481	2.47134	0.0000183685	0.0007241512	4.64658	1.50262	53	96	15	0	0	0	2.00148	1.51146
71	201834006	Localized  primary osteoarthritis of the hand	61	198992004	Antepartum eclampsia	1095	28	96	6	22	90	977	2.44420	0.07252	2.96061	7.48985	1.17028	0.0298933149	0.3180139089	2.45479	1.01876	19	96	6	9	0	0	2.83321	1.42712
70	87433001	Pulmonary emphysema (disorder)	61	198992004	Antepartum eclampsia	1095	17	96	3	14	93	985	2.01287	0.03943	2.26959	8.04091	0.64060	0.1813325900	0.8137869183	1.49041	0.68362	9	96	3	8	0	0	3.49651	1.38629
69	233604007	Pneumonia	61	198992004	Antepartum eclampsia	1095	7	96	0	7	96	992	0.00000	-0.02486	0.00000	0.00000	0.00000	1.0000000000	1.0000000000	0.61370	-0.69037	3	96	0	4	0	0	0.00000	0.00000
68	26929004	Alzheimer's disease (disorder)	61	198992004	Antepartum eclampsia	1095	23	96	2	21	94	978	0.99185	-0.00037	0.99088	4.29135	0.22880	1.0000000000	1.0000000000	2.01644	-0.00788	15	96	2	8	0	0	3.89182	2.14007
67	403191005	Second degree burn	61	198992004	Antepartum eclampsia	1095	49	96	5	44	91	955	1.16390	0.01100	1.19256	3.08253	0.46137	0.6106773023	1.0000000000	4.29589	0.18009	23	96	5	26	0	0	3.00568	1.72277
65	239873007	Osteoarthritis of knee	61	198992004	Antepartum eclampsia	1095	57	96	6	51	90	948	1.20066	0.01458	1.23922	2.96708	0.51756	0.6281489772	1.0000000000	4.99726	0.22305	30	96	6	27	0	0	2.83321	1.79176
64	444448004	Injury of medial collateral ligament of knee	61	198992004	Antepartum eclampsia	1095	32	96	2	30	94	969	0.71289	-0.01544	0.68723	2.92078	0.16170	1.0000000000	1.0000000000	2.80548	-0.34312	17	96	2	15	0	0	3.89182	2.25129
63	68496003	Polyp of colon	61	198992004	Antepartum eclampsia	1095	91	96	7	84	89	915	0.87740	-0.01144	0.85674	1.90895	0.38451	0.8473749772	1.0000000000	7.97808	-0.16641	43	96	7	48	0	0	2.68882	1.96611
62	185086009	Chronic obstructive bronchitis (disorder)	61	198992004	Antepartum eclampsia	1095	6	96	1	5	95	994	1.90104	0.02073	2.09263	18.09707	0.24198	0.4241166778	1.0000000000	0.52603	0.39022	4	96	1	2	0	0	4.57471	1.60944
60	301011002	Escherichia coli urinary tract infection	61	198992004	Antepartum eclampsia	1095	92	96	24	68	72	931	2.97554	0.18547	4.56373	7.70309	2.70380	0.0000001807	0.0000102334	8.06575	1.46343	85	96	24	7	0	0	1.60944	1.51329
59	262574004	Bullet wound	61	198992004	Antepartum eclampsia	1095	20	96	0	20	96	979	0.00000	-0.04228	0.00000	0.00000	0.00000	0.2472604733	0.9133257124	1.75342	-1.46123	9	96	0	11	0	0	0.00000	0.00000
58	239720000	Tear of meniscus of knee	61	198992004	Antepartum eclampsia	1095	20	96	4	16	92	983	2.28125	0.05417	2.67120	8.15658	0.87479	0.0903346265	0.5966770779	1.75342	0.86070	10	96	4	10	0	0	3.21888	1.25276
57	192127007	Child attention deficit disorder	61	198992004	Antepartum eclampsia	1095	76	96	5	71	91	928	0.75041	-0.02113	0.71816	1.82394	0.28277	0.6731339806	1.0000000000	6.66301	-0.35295	24	96	5	52	0	0	3.00568	1.75786
56	92691004	Carcinoma in situ of prostate (disorder)	61	198992004	Antepartum eclampsia	1095	23	96	0	23	96	976	0.00000	-0.04541	0.00000	0.00000	0.00000	0.2537444401	0.9133257124	2.01644	-1.59285	0	96	0	23	0	0	0.00000	0.00000
55	126906006	Neoplasm of prostate	61	198992004	Antepartum eclampsia	1095	24	96	0	24	96	975	0.00000	-0.04640	0.00000	0.00000	0.00000	0.2598174261	0.9255995805	2.10411	-1.63418	0	96	0	24	0	0	0.00000	0.00000
54	5602001	Opioid abuse (disorder)	61	198992004	Antepartum eclampsia	1095	7	96	0	7	96	992	0.00000	-0.02486	0.00000	0.00000	0.00000	1.0000000000	1.0000000000	0.61370	-0.69037	0	96	0	7	0	0	0.00000	0.00000
53	7200002	Alcoholism	61	198992004	Antepartum eclampsia	1095	5	96	0	5	96	994	0.00000	-0.02100	0.00000	0.00000	0.00000	1.0000000000	1.0000000000	0.43836	-0.52442	0	96	0	5	0	0	0.00000	0.00000
52	124171000119105	Chronic intractable migraine without aura	61	198992004	Antepartum eclampsia	1095	51	96	7	44	89	955	1.56556	0.03875	1.70710	3.90165	0.74691	0.2021198319	0.8497164196	4.47123	0.54813	21	96	7	30	0	0	2.68882	1.38629
50	446096008	Perennial allergic rhinitis	61	198992004	Antepartum eclampsia	1095	26	96	3	23	93	976	1.31611	0.01528	1.36886	4.64487	0.40341	0.4918632514	1.0000000000	2.27945	0.28655	14	96	3	12	0	0	3.49651	1.73460
49	88805009	Chronic congestive heart failure (disorder)	61	198992004	Antepartum eclampsia	1095	10	96	0	10	96	989	0.00000	-0.02976	0.00000	0.00000	0.00000	1.0000000000	1.0000000000	0.87671	-0.90821	5	96	0	5	0	0	0.00000	0.00000
47	359817006	Closed fracture of hip	61	198992004	Antepartum eclampsia	1095	29	96	1	28	95	971	0.39332	-0.03102	0.36504	2.71285	0.04912	0.5057078955	1.0000000000	2.54247	-0.82475	11	96	1	18	0	0	4.57471	2.48491
46	62564004	Concussion with loss of consciousness	61	198992004	Antepartum eclampsia	1095	67	96	8	59	88	940	1.36194	0.02864	1.44838	3.12844	0.67056	0.3684676720	1.0000000000	5.87397	0.38878	36	96	8	31	0	0	2.56495	1.70475
45	263102004	Fracture subluxation of wrist	61	198992004	Antepartum eclampsia	1095	109	96	11	98	85	901	1.15109	0.01557	1.18980	2.30598	0.61389	0.5924609594	1.0000000000	9.55616	0.18495	51	96	11	58	0	0	2.27493	1.72924
44	58150001	Fracture of clavicle	61	198992004	Antepartum eclampsia	1095	112	96	15	97	81	902	1.52762	0.05521	1.72203	3.10464	0.95515	0.0770557539	0.5494682436	9.81918	0.56448	55	96	15	57	0	0	2.00148	1.54045
43	307731004	Injury of tendon of the rotator cuff of shoulder	61	198992004	Antepartum eclampsia	1095	51	96	8	43	88	956	1.78922	0.05407	2.02114	4.43389	0.92132	0.0782946239	0.5538035522	4.47123	0.71806	26	96	8	25	0	0	2.56495	1.44692
42	16114001	Fracture of ankle	61	198992004	Antepartum eclampsia	1095	108	96	13	95	83	904	1.37297	0.03825	1.49042	2.77521	0.80043	0.2094432247	0.8621655136	9.46849	0.41937	48	96	13	60	0	0	2.12640	1.54592
41	283385000	Laceration of thigh	61	198992004	Antepartum eclampsia	1095	105	96	8	97	88	902	0.86905	-0.01322	0.84536	1.79583	0.39794	0.8556664861	1.0000000000	9.20548	-0.18135	50	96	8	55	0	0	2.56495	1.98100
40	428251008	History of appendectomy	61	198992004	Antepartum eclampsia	1095	51	96	7	44	89	955	1.56556	0.03875	1.70710	3.90165	0.74691	0.2021198319	0.8497164196	4.47123	0.54813	27	96	7	24	0	0	2.68882	1.58045
39	74400008	Appendicitis	61	198992004	Antepartum eclampsia	1095	51	96	7	44	89	955	1.56556	0.03875	1.70710	3.90165	0.74691	0.2021198319	0.8497164196	4.47123	0.54813	27	96	7	24	0	0	2.68882	1.58045
38	398254007	Preeclampsia	61	198992004	Antepartum eclampsia	1095	101	96	32	69	64	930	3.61386	0.25829	6.73913	10.99784	4.12953	0.0000000000	0.0000000002	8.85479	1.74357	101	96	32	0	0	0	1.38629	1.42461
37	38822007	Cystitis	61	198992004	Antepartum eclampsia	1095	71	96	23	48	73	951	3.69498	0.21998	6.24229	10.83140	3.59752	0.0000000034	0.0000002481	6.22466	1.73203	68	96	23	3	0	0	1.64363	1.37537
35	19169002	Miscarriage in first trimester	61	198992004	Antepartum eclampsia	1095	174	96	49	125	47	874	3.21210	0.29806	7.28953	11.33980	4.68591	0.0000000000	0.0000000000	15.25479	1.62106	174	96	49	0	0	0	1.08491	1.51535
33	429007001	History of cardiac arrest (situation)	61	198992004	Antepartum eclampsia	1095	42	96	7	35	89	964	1.90104	0.05578	2.16629	5.01818	0.93516	0.0867067017	0.5823623432	3.68219	0.77282	24	96	7	18	0	0	2.68882	1.48808
32	410429000	Cardiac Arrest	61	198992004	Antepartum eclampsia	1095	42	96	7	35	89	964	1.90104	0.05578	2.16629	5.01818	0.93516	0.0867067017	0.5823623432	3.68219	0.77282	24	96	7	18	0	0	2.68882	1.48808
31	230690007	Stroke	61	198992004	Antepartum eclampsia	1095	62	96	7	55	89	944	1.28780	0.02186	1.34995	3.05283	0.59694	0.4845904076	1.0000000000	5.43562	0.31392	32	96	7	30	0	0	2.68882	1.71765
30	399211009	History of myocardial infarction (situation)	61	198992004	Antepartum eclampsia	1095	31	96	1	30	95	969	0.36794	-0.03344	0.34000	2.52103	0.04585	0.5126611588	1.0000000000	2.71781	-0.89445	2	96	1	29	0	0	4.57471	1.09861
29	22298006	Myocardial Infarction	61	198992004	Antepartum eclampsia	1095	31	96	1	30	95	969	0.36794	-0.03344	0.34000	2.52103	0.04585	0.5126611588	1.0000000000	2.71781	-0.89445	2	96	1	29	0	0	4.57471	1.09861
28	53741008	Coronary Heart Disease	61	198992004	Antepartum eclampsia	1095	80	96	5	75	91	924	0.71289	-0.02499	0.67692	1.71658	0.26694	0.5384829903	1.0000000000	7.01370	-0.41751	24	96	5	56	0	0	3.00568	1.75786
27	408512008	Body mass index 40+ - severely obese (finding)	61	198992004	Antepartum eclampsia	1095	97	96	19	78	77	921	2.23421	0.11928	2.91359	5.06370	1.67644	0.0004421088	0.0126411445	8.50411	1.07338	67	96	19	30	0	0	1.80049	1.50991
26	33737001	Fracture of rib	61	198992004	Antepartum eclampsia	1095	54	96	7	47	89	952	1.47859	0.03379	1.59311	3.62888	0.69939	0.3172765818	1.0000000000	4.73425	0.48040	32	96	7	22	0	0	2.68882	1.71765
25	284551006	Laceration of foot	61	198992004	Antepartum eclampsia	1095	118	96	13	105	83	894	1.25662	0.02765	1.33356	2.47552	0.71839	0.3871697650	1.0000000000	10.34521	0.30334	53	96	13	65	0	0	2.12640	1.62471
24	162864005	Body mass index 30+ - obesity (finding)	61	198992004	Antepartum eclampsia	1095	439	96	65	374	31	625	1.68885	0.17469	3.50397	5.47656	2.24188	0.0000000130	0.0000008633	38.48767	0.74106	226	96	65	213	0	0	0.90702	1.49894
23	36971009	Sinusitis (disorder)	61	198992004	Antepartum eclampsia	1095	190	96	19	171	77	828	1.14062	0.01997	1.19481	2.02659	0.70441	0.4830928947	1.0000000000	16.65753	0.17972	84	96	19	106	0	0	1.80049	1.69029
22	70704007	Sprain of wrist	61	198992004	Antepartum eclampsia	1095	195	96	20	175	76	824	1.16987	0.02451	1.23910	2.08186	0.73750	0.4040631460	1.0000000000	17.09589	0.21473	90	96	20	105	0	0	1.75786	1.70475
21	15777000	Prediabetes	61	198992004	Antepartum eclampsia	1095	333	96	36	297	60	702	1.23311	0.04777	1.41818	2.19082	0.91803	0.1307119475	0.7119259731	29.19452	0.29324	159	96	36	174	0	0	1.29928	1.68948
20	80394007	Hyperglycemia (disorder)	61	198992004	Antepartum eclampsia	1095	55	96	7	48	89	951	1.45170	0.03220	1.55829	3.54588	0.68481	0.3218040199	1.0000000000	4.82192	0.45851	23	96	7	32	0	0	2.68882	1.45529
19	237602007	Metabolic syndrome X (disorder)	61	198992004	Antepartum eclampsia	1095	64	96	7	57	89	942	1.24756	0.01912	1.29982	2.93507	0.57564	0.4945120294	1.0000000000	5.61096	0.27514	28	96	7	36	0	0	2.68882	1.60944
18	302870006	Hypertriglyceridemia (disorder)	61	198992004	Antepartum eclampsia	1095	64	96	7	57	89	942	1.24756	0.01912	1.29982	2.93507	0.57564	0.4945120294	1.0000000000	5.61096	0.27514	28	96	7	36	0	0	2.68882	1.60944
17	368581000119106	Neuropathy due to type 2 diabetes mellitus (disorder)	61	198992004	Antepartum eclampsia	1095	28	96	2	26	94	973	0.81473	-0.00930	0.79624	3.40709	0.18608	1.0000000000	1.0000000000	2.45479	-0.20364	7	96	2	21	0	0	3.89182	1.50408
15	40055000	Chronic sinusitis (disorder)	61	198992004	Antepartum eclampsia	1095	216	96	25	191	71	808	1.32017	0.04920	1.48957	2.41284	0.91958	0.1079394540	0.6467525781	18.93699	0.38306	104	96	25	112	0	0	1.57691	1.64094
14	10509002	Acute bronchitis (disorder)	61	198992004	Antepartum eclampsia	1095	863	96	84	779	12	220	1.11023	0.06590	1.97689	3.68629	1.06017	0.0354711106	0.3555648164	75.66027	0.14898	418	96	84	445	0	0	0.76214	1.78778
13	370247008	Facial laceration	61	198992004	Antepartum eclampsia	1095	109	96	11	98	85	901	1.15109	0.01557	1.18980	2.30598	0.61389	0.5924609594	1.0000000000	9.55616	0.18495	55	96	11	54	0	0	2.27493	1.79176
12	65966004	Fracture of forearm	61	198992004	Antepartum eclampsia	1095	123	96	9	114	87	885	0.83460	-0.01824	0.80309	1.63913	0.39347	0.7343529529	1.0000000000	10.78356	-0.23678	55	96	9	68	0	0	2.45674	1.96166
11	38341003	Hypertension	61	198992004	Antepartum eclampsia	1095	278	96	34	244	62	755	1.39501	0.07143	1.69685	2.64122	1.09014	0.0264011086	0.2963541316	24.37260	0.46408	131	96	34	147	0	0	1.34117	1.57958
10	62106007	Concussion with no loss of consciousness	61	198992004	Antepartum eclampsia	1095	206	96	17	189	79	810	0.94129	-0.00876	0.92224	1.59435	0.53347	0.8913426871	1.0000000000	18.06027	-0.08257	96	96	17	110	0	0	1.89417	1.89417
9	44465007	Sprain of ankle	61	198992004	Antepartum eclampsia	1095	362	96	42	320	54	679	1.32338	0.07045	1.65035	2.52328	1.07941	0.0230032830	0.2747249224	31.73699	0.39342	185	96	42	177	0	0	1.18958	1.68728
8	233678006	Childhood asthma	61	198992004	Antepartum eclampsia	1095	45	96	7	38	89	961	1.77431	0.04969	1.98906	4.58388	0.86310	0.1056729006	0.6392809933	3.94521	0.69397	25	96	7	20	0	0	2.68882	1.51983
7	75498004	Acute bacterial sinusitis (disorder)	61	198992004	Antepartum eclampsia	1095	187	96	22	165	74	834	1.34191	0.04810	1.50270	2.48844	0.90744	0.1185550783	0.6833069448	16.39452	0.40300	89	96	22	98	0	0	1.67964	1.61849
6	39848009	Whiplash injury to neck	61	198992004	Antepartum eclampsia	1095	182	96	19	163	77	836	1.19076	0.02640	1.26556	2.14874	0.74538	0.3893847771	1.0000000000	15.95616	0.23819	92	96	19	90	0	0	1.80049	1.76509
5	284549007	Laceration of hand	61	198992004	Antepartum eclampsia	1095	104	96	11	93	85	906	1.20643	0.02073	1.26072	2.44729	0.64946	0.4673238856	1.0000000000	9.11781	0.24614	54	96	11	50	0	0	2.27493	1.77649
4	195662009	Acute viral pharyngitis (disorder)	61	198992004	Antepartum eclampsia	1095	890	96	90	800	6	199	1.15344	0.09911	3.73125	8.65032	1.60945	0.0005152950	0.0143595528	78.02740	0.20351	430	96	90	460	0	0	0.72594	1.75402
3	65363002	Otitis media	61	198992004	Antepartum eclampsia	1095	580	96	46	534	50	465	0.90463	-0.03137	0.80112	1.21840	0.52676	0.3355798291	1.0000000000	50.84932	-0.14166	277	96	46	303	0	0	1.12719	1.94901
1	444814009	Viral sinusitis (disorder)	61	198992004	Antepartum eclampsia	1095	993	96	96	897	0	102	1.10272	0.09935	0.00000	0.00000	0.00000	0.0001271278	0.0042920310	87.05753	0.13954	478	96	96	515	0	0	0.69315	1.78828
96	283371005	Laceration of forearm	35	19169002	Miscarriage in first trimester	1095	75	174	20	55	154	866	1.67816	0.07993	2.04486	3.50802	1.19197	0.0131440895	0.1849019516	11.91781	0.70103	39	174	20	36	0	0	2.27213	1.08181
94	703151001	History of single seizure (situation)	35	19169002	Miscarriage in first trimester	1095	39	174	3	36	171	885	0.48408	-0.04309	0.43129	1.41642	0.13132	0.1847241719	0.8181443419	6.19726	-0.84745	14	174	3	25	0	0	4.07754	1.73460
86	713197008	Recurrent rectal polyp	35	19169002	Miscarriage in first trimester	1095	22	174	6	16	168	905	1.71630	0.04458	2.02009	5.23696	0.77922	0.1430038887	0.7404942507	3.49589	0.63875	12	174	6	10	0	0	3.40120	1.09861
75	431855005	Chronic kidney disease stage 1 (disorder)	35	19169002	Miscarriage in first trimester	1095	28	174	6	22	168	899	1.34852	0.02454	1.45942	3.65333	0.58300	0.4299439374	1.0000000000	4.44932	0.36128	10	174	6	18	0	0	3.40120	0.98083
64	444448004	Injury of medial collateral ligament of knee	35	19169002	Miscarriage in first trimester	1095	32	174	9	23	165	898	1.76994	0.05806	2.12964	4.68446	0.96818	0.0801223606	0.5604096269	5.08493	0.71669	17	174	9	15	0	0	3.01226	1.06087
117	230265002	Familial Alzheimer's disease of early onset (disorder)	10	62106007	Concussion with no loss of consciousness	1095	6	206	1	5	205	884	0.88592	-0.00408	0.86244	7.42174	0.10022	1.0000000000	1.0000000000	1.12877	-0.09002	2	96	1	4	110	0	4.57471	1.09861
44	58150001	Fracture of clavicle	35	19169002	Miscarriage in first trimester	1095	112	174	25	87	149	834	1.40471	0.05938	1.60842	2.59337	0.99755	0.0560556448	0.4598658412	17.79726	0.46799	55	174	25	57	0	0	2.07443	1.16315
43	307731004	Injury of tendon of the rotator cuff of shoulder	35	19169002	Miscarriage in first trimester	1095	51	174	8	43	166	878	0.98715	-0.00123	0.98403	2.13098	0.45440	1.0000000000	1.0000000000	8.10411	-0.01659	26	174	8	25	0	0	3.12457	1.44692
42	16114001	Fracture of ankle	35	19169002	Miscarriage in first trimester	1095	108	174	20	88	154	833	1.16539	0.02378	1.22934	2.05758	0.73449	0.4083386868	1.0000000000	17.16164	0.20949	48	174	20	60	0	0	2.27213	1.22378
41	283385000	Laceration of thigh	35	19169002	Miscarriage in first trimester	1095	105	174	27	78	147	843	1.61823	0.08751	1.98509	3.18057	1.23895	0.0070439523	0.1189073325	16.68493	0.66291	50	174	27	55	0	0	2.00747	1.04797
33	429007001	History of cardiac arrest (situation)	35	19169002	Miscarriage in first trimester	1095	42	174	9	33	165	888	1.34852	0.03025	1.46777	3.12454	0.68949	0.2883297015	0.9712041902	6.67397	0.38195	24	174	9	18	0	0	3.01226	1.29928
32	410429000	Cardiac Arrest	35	19169002	Miscarriage in first trimester	1095	42	174	9	33	165	888	1.34852	0.03025	1.46777	3.12454	0.68949	0.2883297015	0.9712041902	6.67397	0.38195	24	174	9	18	0	0	3.01226	1.29928
27	408512008	Body mass index 40+ - severely obese (finding)	35	19169002	Miscarriage in first trimester	1095	97	174	33	64	141	857	2.14095	0.15461	3.13398	4.94584	1.98587	0.0000032640	0.0001523989	15.41370	1.05063	67	174	33	30	0	0	1.83621	1.10866
21	15777000	Prediabetes	35	19169002	Miscarriage in first trimester	1095	333	174	88	245	86	676	1.66304	0.19052	2.82335	3.93185	2.02737	0.0000000017	0.0000001270	52.91507	0.72312	159	174	88	174	0	0	1.09101	1.03205
130	314994000	Metastasis from malignant tumor of prostate (disorder)	9	44465007	Sprain of ankle	1095	1	362	0	1	362	732	0.00000	-0.02125	0.00000	0.00000	0.00000	1.0000000000	1.0000000000	0.33059	-0.41207	0	185	0	1	177	0	0.00000	0.00000
129	47505003	Posttraumatic stress disorder	9	44465007	Sprain of ankle	1095	4	362	2	2	360	731	1.51243	0.02180	2.03056	14.47372	0.28487	0.6027839823	1.0000000000	1.32237	0.36936	1	185	1	3	177	1	0.04396	-0.69315
15	40055000	Chronic sinusitis (disorder)	35	19169002	Miscarriage in first trimester	1095	216	174	48	168	126	753	1.39847	0.08586	1.70748	2.47727	1.17690	0.0066802696	0.1138629249	34.32329	0.47216	104	174	48	112	0	0	1.53148	1.15268
14	10509002	Acute bronchitis (disorder)	35	19169002	Miscarriage in first trimester	1095	863	174	163	700	11	221	1.18862	0.15812	4.67831	8.77541	2.49408	0.0000000140	0.0000009223	137.13425	0.24762	418	174	163	445	0	0	0.72633	1.27100
125	1734006	Fracture of the vertebral column with spinal cord injury	9	44465007	Sprain of ankle	1095	5	362	0	5	362	728	0.00000	-0.04760	0.00000	0.00000	0.00000	0.1773661210	0.8029498763	1.65297	-1.40761	3	185	0	2	177	0	0.00000	0.00000
124	1501000119109	Proliferative diabetic retinopathy due to type II diabetes mellitus (disorder)	9	44465007	Sprain of ankle	1095	1	362	1	0	361	733	3.02486	0.04302	0.00000	0.00000	0.00000	0.3305936073	1.0000000000	0.33059	0.58793	1	185	1	0	177	0	5.22575	0.69315
121	254637007	Non-small cell lung cancer (disorder)	9	44465007	Sprain of ankle	1095	8	362	5	3	357	730	1.89054	0.05369	3.40803	14.34035	0.80993	0.1242031006	0.6913144812	2.64475	0.71914	0	185	0	8	177	5	-3.59457	-0.95551
120	162573006	Suspected lung cancer (situation)	9	44465007	Sprain of ankle	1095	8	362	5	3	357	730	1.89054	0.05369	3.40803	14.34035	0.80993	0.1242031006	0.6913144812	2.64475	0.71914	0	185	0	8	177	5	-3.59457	-0.95551
118	48333001	Burn injury(morphologic abnormality)	9	44465007	Sprain of ankle	1095	1	362	0	1	362	732	0.00000	-0.02125	0.00000	0.00000	0.00000	1.0000000000	1.0000000000	0.33059	-0.41207	0	185	0	1	177	0	0.00000	0.00000
117	230265002	Familial Alzheimer's disease of early onset (disorder)	9	44465007	Sprain of ankle	1095	6	362	2	4	360	729	1.00829	0.00043	1.01250	5.55385	0.18458	1.0000000000	1.0000000000	1.98356	0.00793	2	185	1	4	177	1	0.04396	-0.51083
115	36923009	Major depression  single episode	9	44465007	Sprain of ankle	1095	6	362	2	4	360	729	1.00829	0.00043	1.01250	5.55385	0.18458	1.0000000000	1.0000000000	1.98356	0.00793	3	185	1	3	177	1	0.04396	0.00000
114	449868002	Smokes tobacco daily	9	44465007	Sprain of ankle	1095	9	362	3	6	359	727	1.00829	0.00053	1.01253	4.07193	0.25178	1.0000000000	1.0000000000	2.97534	0.00892	2	185	1	7	177	2	0.73151	-0.40547
112	49436004	Atrial Fibrillation	9	44465007	Sprain of ankle	1095	35	362	10	25	352	708	0.86425	-0.01734	0.80455	1.69373	0.38217	0.7153485711	1.0000000000	11.57078	-0.19257	9	185	3	26	177	7	0.86880	-0.16430
111	235919008	Cholelithiasis	9	44465007	Sprain of ankle	1095	9	362	2	7	360	726	0.67219	-0.02097	0.57619	2.78772	0.11909	0.7257794797	1.0000000000	2.97534	-0.40612	7	185	1	2	177	1	0.04396	0.98083
109	90560007	Gout	9	44465007	Sprain of ankle	1095	4	362	1	3	361	730	0.75622	-0.01037	0.67405	6.50284	0.06987	1.0000000000	1.0000000000	1.32237	-0.21560	0	185	0	4	177	1	-5.18178	-1.60944
108	40930008	Hypothyroidism (disorder)	9	44465007	Sprain of ankle	1095	13	362	5	8	357	725	1.16341	0.01259	1.26926	3.90770	0.41227	0.7682002887	1.0000000000	4.29772	0.17959	11	185	5	2	177	0	3.63759	1.16315
107	40275004	Contact dermatitis	9	44465007	Sprain of ankle	1095	18	362	4	14	358	719	0.67219	-0.02978	0.57382	1.75588	0.18753	0.4505035652	1.0000000000	5.95068	-0.47523	9	185	3	9	177	1	-1.04395	-0.91629
106	24079001	Atopic dermatitis	9	44465007	Sprain of ankle	1095	20	362	3	17	359	716	0.45373	-0.05236	0.35196	1.20884	0.10247	0.0959304159	0.6155535021	6.61187	-0.92825	13	185	1	7	177	2	0.73151	1.13498
105	363406005	Malignant tumor of colon	9	44465007	Sprain of ankle	1095	6	362	2	4	360	729	1.00829	0.00043	1.01250	5.55385	0.18458	1.0000000000	1.0000000000	1.98356	0.00793	4	185	2	2	177	0	4.53796	1.09861
104	367498001	Seasonal allergic rhinitis	9	44465007	Sprain of ankle	1095	20	362	5	15	357	718	0.75622	-0.02337	0.67040	1.85925	0.24173	0.6319648378	1.0000000000	6.61187	-0.34329	9	185	1	11	177	4	1.41354	0.98083
102	90781000119102	Microalbuminuria due to type 2 diabetes mellitus (disorder)	9	44465007	Sprain of ankle	1095	6	362	6	0	356	733	3.02486	0.10562	0.00000	0.00000	0.00000	0.0012695169	0.0297168508	1.98356	1.23032	3	185	3	3	177	3	0.04349	0.00000
101	433144002	Chronic kidney disease stage 3 (disorder)	9	44465007	Sprain of ankle	1095	3	362	3	0	359	733	3.02486	0.07458	0.00000	0.00000	0.00000	0.0359307821	0.3569070239	0.99178	1.00594	1	185	1	2	177	2	0.73151	0.00000
100	161622006	History of lower limb amputation (situation)	9	44465007	Sprain of ankle	1095	1	362	0	1	362	732	0.00000	-0.02125	0.00000	0.00000	0.00000	1.0000000000	1.0000000000	0.33059	-0.41207	0	185	0	1	177	0	0.00000	0.00000
98	1551000119108	Nonproliferative diabetic retinopathy due to type 2 diabetes mellitus (disorder)	9	44465007	Sprain of ankle	1095	12	362	5	7	357	726	1.26036	0.01926	1.45258	4.60873	0.45782	0.5451199858	1.0000000000	3.96712	0.27255	7	185	3	5	177	2	-0.35641	-0.04879
97	403192003	Third degree burn	9	44465007	Sprain of ankle	1095	8	362	5	3	357	730	1.89054	0.05369	3.40803	14.34035	0.80993	0.1242031006	0.6913144812	2.64475	0.71914	3	185	2	5	177	3	0.44362	-0.06454
96	283371005	Laceration of forearm	9	44465007	Sprain of ankle	1095	75	362	33	42	329	691	1.33094	0.06306	1.65024	2.65216	1.02682	0.0418980882	0.3920910642	24.79452	0.39847	39	185	17	36	177	16	-0.01505	0.01348
95	84757009	Epilepsy	9	44465007	Sprain of ankle	1095	30	362	7	23	355	710	0.70580	-0.03470	0.60870	1.43212	0.25872	0.3259669823	1.0000000000	9.91781	-0.44861	13	185	3	17	177	4	0.32563	0.01575
94	703151001	History of single seizure (situation)	9	44465007	Sprain of ankle	1095	39	362	11	28	351	705	0.85317	-0.01983	0.78907	1.60351	0.38829	0.6046805658	1.0000000000	12.89315	-0.21134	14	185	4	25	177	7	0.58643	-0.01575
93	128613002	Seizure disorder	9	44465007	Sprain of ankle	1095	39	362	11	28	351	705	0.85317	-0.01983	0.78907	1.60351	0.38829	0.6046805658	1.0000000000	12.89315	-0.21134	14	185	4	25	177	7	0.58643	-0.01575
89	47693006	Rupture of appendix	9	44465007	Sprain of ankle	1095	20	362	9	11	353	722	1.36119	0.03462	1.67345	4.07542	0.68715	0.3364810029	1.0000000000	6.61187	0.39368	10	185	3	10	177	6	0.72010	0.48551
86	713197008	Recurrent rectal polyp	9	44465007	Sprain of ankle	1095	22	362	11	11	351	722	1.51243	0.05156	2.05698	4.79056	0.88323	0.1083279078	0.6486373635	7.27306	0.53654	12	185	7	10	177	4	-0.50062	-0.25423
82	94260004	Secondary malignant neoplasm of colon	9	44465007	Sprain of ankle	1095	4	362	2	2	360	731	1.51243	0.02180	2.03056	14.47372	0.28487	0.6027839823	1.0000000000	1.32237	0.36936	2	185	1	2	177	1	0.04396	0.00000
80	6072007	Bleeding from anus	9	44465007	Sprain of ankle	1095	4	362	2	2	360	731	1.51243	0.02180	2.03056	14.47372	0.28487	0.6027839823	1.0000000000	1.32237	0.36936	2	185	1	2	177	1	0.04396	0.00000
78	239872002	Osteoarthritis of hip	9	44465007	Sprain of ankle	1095	21	362	7	14	355	719	1.00829	0.00081	1.01268	2.53134	0.40513	1.0000000000	1.0000000000	6.94247	0.01041	13	185	4	8	177	3	-0.23889	0.14764
76	127013003	Diabetic renal disease (disorder)	9	44465007	Sprain of ankle	1095	28	362	14	14	348	719	1.51243	0.05834	2.06609	4.38168	0.97422	0.0662757265	0.5041319996	9.25662	0.54841	10	185	8	18	177	6	-0.23448	-0.57536
75	431855005	Chronic kidney disease stage 1 (disorder)	9	44465007	Sprain of ankle	1095	28	362	14	14	348	719	1.51243	0.05834	2.06609	4.38168	0.97422	0.0662757265	0.5041319996	9.25662	0.54841	10	185	8	18	177	6	-0.23448	-0.57536
73	196416002	Impacted molars	9	44465007	Sprain of ankle	1095	49	362	19	30	343	703	1.17291	0.02630	1.29806	2.33929	0.72028	0.4373434090	1.0000000000	16.19909	0.21767	25	185	10	24	177	9	-0.05811	-0.04652
72	35999006	Blighted ovum	9	44465007	Sprain of ankle	1095	53	362	25	28	337	705	1.42682	0.06765	1.86785	3.25273	1.07259	0.0350478573	0.3524056030	17.52146	0.48931	53	185	25	0	177	0	2.12823	1.13783
71	201834006	Localized  primary osteoarthritis of the hand	9	44465007	Sprain of ankle	1095	28	362	7	21	355	712	0.75622	-0.02775	0.66854	1.58752	0.28154	0.4207580749	1.0000000000	9.25662	-0.35848	19	185	7	9	177	0	3.31159	1.31219
70	87433001	Pulmonary emphysema (disorder)	9	44465007	Sprain of ankle	1095	17	362	4	13	358	720	0.71173	-0.02544	0.61882	1.91145	0.20034	0.6039287409	1.0000000000	5.62009	-0.40492	9	185	2	8	177	2	0.04372	0.09531
69	233604007	Pneumonia	9	44465007	Sprain of ankle	1095	7	362	3	4	359	729	1.29637	0.01671	1.52298	6.84106	0.33905	0.6906397440	1.0000000000	2.31416	0.27136	3	185	2	4	177	1	-0.64382	-0.69315
68	26929004	Alzheimer's disease (disorder)	9	44465007	Sprain of ankle	1095	23	362	9	14	353	719	1.18364	0.01890	1.30939	3.05440	0.56132	0.5106749369	1.0000000000	7.60365	0.21698	15	185	6	8	177	3	-0.63383	-0.04652
67	403191005	Second degree burn	9	44465007	Sprain of ankle	1095	49	362	15	34	347	699	0.92598	-0.01126	0.88871	1.65371	0.47760	0.7584804387	1.0000000000	16.19909	-0.10426	23	185	8	26	177	7	-0.08578	-0.19605
65	239873007	Osteoarthritis of knee	9	44465007	Sprain of ankle	1095	57	362	19	38	343	695	1.00829	0.00136	1.01312	1.78375	0.57542	1.0000000000	1.0000000000	18.84384	0.01131	30	185	7	27	177	12	0.55474	0.48635
64	444448004	Injury of medial collateral ligament of knee	9	44465007	Sprain of ankle	1095	32	362	12	20	350	713	1.13432	0.01638	1.22229	2.52880	0.59079	0.5726758974	1.0000000000	10.57900	0.16700	17	185	7	15	177	5	-0.28298	-0.15415
63	68496003	Polyp of colon	9	44465007	Sprain of ankle	1095	91	362	34	57	328	676	1.13017	0.02754	1.22935	1.91785	0.78802	0.3548112162	1.0000000000	30.08402	0.17118	43	185	17	48	177	17	0.04041	-0.08004
62	185086009	Chronic obstructive bronchitis (disorder)	9	44465007	Sprain of ankle	1095	6	362	4	2	358	731	2.01657	0.05303	4.08380	22.40111	0.74449	0.0968545235	0.6178699178	1.98356	0.74489	4	185	3	2	177	1	-1.04395	-0.25131
59	262574004	Bullet wound	9	44465007	Sprain of ankle	1095	20	362	4	16	358	717	0.60497	-0.03787	0.50070	1.50866	0.16617	0.2407665450	0.9095097439	6.61187	-0.60632	9	185	1	11	177	3	1.13140	0.76214
58	239720000	Tear of meniscus of knee	9	44465007	Sprain of ankle	1095	20	362	8	12	354	721	1.20994	0.02012	1.35782	3.35172	0.55007	0.4828916778	1.0000000000	6.61187	0.24167	10	185	3	10	177	5	0.54326	0.36772
57	192127007	Child attention deficit disorder	9	44465007	Sprain of ankle	1095	76	362	28	48	334	685	1.11442	0.02196	1.19636	1.94131	0.73727	0.5274963971	1.0000000000	25.12511	0.15062	24	185	12	52	177	16	0.30820	-0.34831
56	92691004	Carcinoma in situ of prostate (disorder)	9	44465007	Sprain of ankle	1095	23	362	8	15	354	718	1.05213	0.00537	1.08173	2.57544	0.45435	0.8263678325	1.0000000000	7.60365	0.06498	0	185	0	23	177	8	-3.14091	-1.35455
54	5602001	Opioid abuse (disorder)	9	44465007	Sprain of ankle	1095	7	362	3	4	359	729	1.29637	0.01671	1.52298	6.84106	0.33905	0.6906397440	1.0000000000	2.31416	0.27136	0	185	0	7	177	3	-4.09434	-1.20397
52	124171000119105	Chronic intractable migraine without aura	9	44465007	Sprain of ankle	1095	51	362	18	33	344	700	1.06760	0.01050	1.10994	1.99956	0.61612	0.7611141851	1.0000000000	16.86027	0.08925	21	185	7	30	177	11	0.47304	0.07062
50	446096008	Perennial allergic rhinitis	9	44465007	Sprain of ankle	1095	26	362	13	13	349	720	1.51243	0.05616	2.06304	4.49739	0.94635	0.0890201446	0.5906415940	8.59543	0.54501	14	185	5	12	177	8	0.49667	0.41871
49	88805009	Chronic congestive heart failure (disorder)	9	44465007	Sprain of ankle	1095	10	362	6	4	356	729	1.81492	0.05498	3.07163	10.95386	0.86133	0.0905674545	0.5972961049	3.30594	0.70103	5	185	3	5	177	3	0.04349	0.00000
47	359817006	Closed fracture of hip	9	44465007	Sprain of ankle	1095	29	362	9	20	353	713	0.93875	-0.00710	0.90892	2.01674	0.40964	1.0000000000	1.0000000000	9.58721	-0.08232	11	185	3	18	177	6	0.72010	0.15415
46	62564004	Concussion with loss of consciousness	9	44465007	Sprain of ankle	1095	67	362	23	44	339	689	1.03839	0.00689	1.06242	1.78845	0.63112	0.8934569553	1.0000000000	22.14977	0.05204	36	185	15	31	177	8	-0.55065	-0.36034
45	263102004	Fracture subluxation of wrist	9	44465007	Sprain of ankle	1095	109	362	34	75	328	658	0.94353	-0.01319	0.90943	1.39290	0.59377	0.7476958696	1.0000000000	36.03470	-0.08152	51	185	16	58	177	18	0.14809	-0.00826
44	58150001	Fracture of clavicle	9	44465007	Sprain of ankle	1095	112	362	35	77	327	656	0.94527	-0.01298	0.91187	1.38923	0.59854	0.7506225973	1.0000000000	37.02648	-0.07901	55	185	15	57	177	20	0.30280	0.19237
43	307731004	Injury of tendon of the rotator cuff of shoulder	9	44465007	Sprain of ankle	1095	51	362	20	31	342	702	1.18622	0.02892	1.32428	2.35765	0.74384	0.3615376240	1.0000000000	16.86027	0.23364	26	185	11	25	177	9	-0.14830	-0.11611
42	16114001	Fracture of ankle	9	44465007	Sprain of ankle	1095	108	362	33	75	329	658	0.92426	-0.01761	0.88000	1.35317	0.57229	0.5917247961	1.0000000000	35.70411	-0.11041	48	185	15	60	177	18	0.20764	-0.03125
41	283385000	Laceration of thigh	9	44465007	Sprain of ankle	1095	105	362	27	78	335	655	0.77782	-0.05085	0.67681	1.06891	0.42854	0.1019828432	0.6291042150	34.71233	-0.35100	50	185	12	55	177	15	0.24885	0.10178
39	74400008	Appendicitis	9	44465007	Sprain of ankle	1095	51	362	19	32	343	701	1.12691	0.01971	1.21347	2.17198	0.67795	0.5430933688	1.0000000000	16.86027	0.16325	27	185	7	24	177	12	0.55474	0.48184
38	398254007	Preeclampsia	9	44465007	Sprain of ankle	1095	101	362	37	64	325	669	1.10812	0.02422	1.19005	1.82196	0.77730	0.4380039121	1.0000000000	33.38995	0.14401	101	185	37	0	177	0	1.79176	1.31634
35	19169002	Miscarriage in first trimester	9	44465007	Sprain of ankle	1095	174	362	73	101	289	632	1.26905	0.08218	1.58060	2.20231	1.13439	0.0082590967	0.1342392906	57.52329	0.33851	174	185	73	0	177	0	1.26250	1.21893
33	429007001	History of cardiac arrest (situation)	9	44465007	Sprain of ankle	1095	42	362	10	32	352	701	0.72021	-0.03927	0.62234	1.28049	0.30246	0.2419685127	0.9105752038	13.88493	-0.43635	24	185	4	18	177	6	0.43773	0.55962
32	410429000	Cardiac Arrest	9	44465007	Sprain of ankle	1095	42	362	10	32	352	701	0.72021	-0.03927	0.62234	1.28049	0.30246	0.2419685127	0.9105752038	13.88493	-0.43635	24	185	4	18	177	6	0.43773	0.55962
128	86849004	Suicidal deliberate poisoning	73	196416002	Impacted molars	1095	1	49	1	0	48	1046	22.34694	0.13969	0.00000	0.00000	0.00000	0.0447488584	0.4078976941	0.04475	0.93684	0	25	0	1	24	1	-3.21888	-0.69315
30	399211009	History of myocardial infarction (situation)	9	44465007	Sprain of ankle	1095	31	362	13	18	349	715	1.26849	0.03221	1.47962	3.05433	0.71678	0.3329763256	1.0000000000	10.24840	0.31571	2	185	2	29	177	11	1.69941	-0.59784
29	22298006	Myocardial Infarction	9	44465007	Sprain of ankle	1095	31	362	13	18	349	715	1.26849	0.03221	1.47962	3.05433	0.71678	0.3329763256	1.0000000000	10.24840	0.31571	2	185	2	29	177	11	1.69941	-0.59784
28	53741008	Coronary Heart Disease	9	44465007	Sprain of ankle	1095	80	362	28	52	334	681	1.05870	0.01158	1.09788	1.77021	0.68090	0.7120779221	1.0000000000	26.44749	0.07938	24	185	8	56	177	20	0.89578	0.05129
27	408512008	Body mass index 40+ - severely obese (finding)	9	44465007	Sprain of ankle	1095	97	362	33	64	329	669	1.02908	0.00637	1.04849	1.62846	0.67507	0.8220328410	1.0000000000	32.06758	0.04012	67	185	24	30	177	9	-0.86424	-0.13353
24	162864005	Body mass index 30+ - obesity (finding)	9	44465007	Sprain of ankle	1095	439	362	164	275	198	458	1.13002	0.07474	1.37947	1.78070	1.06864	0.0152686255	0.2090920355	145.13059	0.17521	226	185	90	213	177	74	-0.10443	-0.09948
23	36971009	Sinusitis (disorder)	9	44465007	Sprain of ankle	1095	190	362	80	110	282	623	1.27363	0.08811	1.60671	2.21378	1.16611	0.0050101456	0.0914325530	62.81279	0.34408	84	185	38	106	177	42	0.11818	-0.09311
21	15777000	Prediabetes	9	44465007	Sprain of ankle	1095	333	362	139	194	223	539	1.26263	0.12201	1.73180	2.26392	1.32475	0.0000675043	0.0024087514	110.08767	0.33373	159	185	65	174	177	74	0.12569	0.02790
20	80394007	Hyperglycemia (disorder)	9	44465007	Sprain of ankle	1095	55	362	21	34	341	699	1.15495	0.02504	1.26609	2.21467	0.72380	0.4622070818	1.0000000000	18.18265	0.19770	23	185	11	32	177	10	-0.04830	-0.30662
19	237602007	Metabolic syndrome X (disorder)	9	44465007	Sprain of ankle	1095	64	362	26	38	336	695	1.22885	0.04007	1.41526	2.36995	0.84514	0.2173626437	0.8716351241	21.15799	0.28513	28	185	13	36	177	13	0.04124	-0.17825
18	302870006	Hypertriglyceridemia (disorder)	9	44465007	Sprain of ankle	1095	64	362	26	38	336	695	1.22885	0.04007	1.41526	2.36995	0.84514	0.2173626437	0.8716351241	21.15799	0.28513	28	185	13	36	177	13	0.04124	-0.17825
17	368581000119106	Neuropathy due to type 2 diabetes mellitus (disorder)	9	44465007	Sprain of ankle	1095	28	362	10	18	352	715	1.08031	0.00914	1.12847	2.47032	0.51550	0.8391126495	1.0000000000	9.25662	0.10095	7	185	3	21	177	7	0.86880	-0.18232
15	40055000	Chronic sinusitis (disorder)	9	44465007	Sprain of ankle	1095	216	362	92	124	270	609	1.28837	0.10046	1.67348	2.27119	1.23306	0.0012064384	0.0286219356	71.40822	0.36108	104	185	48	112	177	44	-0.03414	-0.11299
14	10509002	Acute bronchitis (disorder)	9	44465007	Sprain of ankle	1095	863	362	315	548	47	185	1.10409	0.14109	2.26258	3.20709	1.59623	0.0000020929	0.0001014992	285.30228	0.14239	418	185	157	445	177	158	0.02703	-0.04120
13	370247008	Facial laceration	9	44465007	Sprain of ankle	1095	109	362	46	63	316	670	1.27655	0.06462	1.54812	2.31637	1.03467	0.0410207423	0.3867669992	36.03470	0.34378	55	185	22	54	177	24	0.11643	0.07411
10	62106007	Concussion with no loss of consciousness	9	44465007	Sprain of ankle	1095	206	362	72	134	290	599	1.05723	0.01936	1.10983	1.52666	0.80681	0.5651257608	1.0000000000	68.10228	0.07916	96	185	36	110	177	36	0.03687	-0.10080
8	233678006	Childhood asthma	9	44465007	Sprain of ankle	1095	45	362	16	29	346	704	1.07551	0.01098	1.12258	2.09473	0.60160	0.7470656284	1.0000000000	14.87671	0.09862	25	185	8	20	177	8	0.04233	0.16430
7	75498004	Acute bacterial sinusitis (disorder)	9	44465007	Sprain of ankle	1095	187	362	81	106	281	627	1.31023	0.09894	1.70506	2.35198	1.23608	0.0015303457	0.0343564566	61.82100	0.38438	89	185	43	98	177	38	-0.06491	-0.15347
6	39848009	Whiplash injury to neck	9	44465007	Sprain of ankle	1095	182	362	70	112	292	621	1.16341	0.05127	1.32920	1.84780	0.95614	0.1009970923	0.6283150080	60.16804	0.21504	92	185	33	90	177	37	0.13293	0.09854
5	284549007	Laceration of hand	9	44465007	Sprain of ankle	1095	104	362	33	71	329	662	0.95981	-0.00915	0.93523	1.44284	0.60620	0.8268911804	1.0000000000	34.38174	-0.05747	54	185	22	50	177	11	-0.59687	-0.47329
1	444814009	Viral sinusitis (disorder)	9	44465007	Sprain of ankle	1095	993	362	344	649	18	84	1.04789	0.10500	2.47355	4.18385	1.46239	0.0003696704	0.0109627251	328.27945	0.06728	478	185	172	515	177	172	0.02266	-0.05536
118	48333001	Burn injury(morphologic abnormality)	14	10509002	Acute bronchitis (disorder)	1095	1	863	0	1	863	231	0.00000	-0.05831	0.00000	0.00000	0.00000	0.2118721461	0.8671354646	0.78813	-0.83845	0	418	0	1	445	0	0.00000	0.00000
118	48333001	Burn injury(morphologic abnormality)	45	263102004	Fracture subluxation of wrist	1095	1	109	0	1	109	985	0.00000	-0.01005	0.00000	0.00000	0.00000	1.0000000000	1.0000000000	0.09954	-0.13690	0	51	0	1	58	0	0.00000	0.00000
123	195967001	Asthma	16	44054006	Diabetes	1095	2	68	0	2	68	1025	0.00000	-0.01101	0.00000	0.00000	0.00000	1.0000000000	1.0000000000	0.12420	-0.16890	1	29	0	1	39	0	0.00000	0.00000
129	47505003	Posttraumatic stress disorder	45	263102004	Fracture subluxation of wrist	1095	4	109	0	4	109	982	0.00000	-0.02013	0.00000	0.00000	0.00000	1.0000000000	1.0000000000	0.39817	-0.48354	1	51	0	3	58	0	0.00000	0.00000
130	314994000	Metastasis from malignant tumor of prostate (disorder)	45	263102004	Fracture subluxation of wrist	1095	1	109	0	1	109	985	0.00000	-0.01005	0.00000	0.00000	0.00000	1.0000000000	1.0000000000	0.09954	-0.13690	0	51	0	1	58	0	0.00000	0.00000
133	97331000119101	Macular edema and retinopathy due to type 2 diabetes mellitus (disorder)	122	424132000	Non-small cell carcinoma of lung  TNM stage 1 (disorder)	1095	4	8	0	4	8	1083	0.00000	-0.00519	0.00000	0.00000	0.00000	1.0000000000	1.0000000000	0.02922	-0.04156	2	0	0	2	8	0	0.00000	0.00000
132	69896004	Rheumatoid arthritis	122	424132000	Non-small cell carcinoma of lung  TNM stage 1 (disorder)	1095	3	8	0	3	8	1084	0.00000	-0.00450	0.00000	0.00000	0.00000	1.0000000000	1.0000000000	0.02192	-0.03128	2	0	0	1	8	0	0.00000	0.00000
131	93761005	Primary malignant neoplasm of colon	122	424132000	Non-small cell carcinoma of lung  TNM stage 1 (disorder)	1095	5	8	0	5	8	1082	0.00000	-0.00581	0.00000	0.00000	0.00000	1.0000000000	1.0000000000	0.03653	-0.05176	3	0	0	2	8	0	0.00000	0.00000
130	314994000	Metastasis from malignant tumor of prostate (disorder)	122	424132000	Non-small cell carcinoma of lung  TNM stage 1 (disorder)	1095	1	8	0	1	8	1086	0.00000	-0.00259	0.00000	0.00000	0.00000	1.0000000000	1.0000000000	0.00731	-0.01050	0	0	0	1	8	0	0.00000	0.00000
129	47505003	Posttraumatic stress disorder	122	424132000	Non-small cell carcinoma of lung  TNM stage 1 (disorder)	1095	4	8	0	4	8	1083	0.00000	-0.00519	0.00000	0.00000	0.00000	1.0000000000	1.0000000000	0.02922	-0.04156	1	0	0	3	8	0	0.00000	0.00000
128	86849004	Suicidal deliberate poisoning	122	424132000	Non-small cell carcinoma of lung  TNM stage 1 (disorder)	1095	1	8	0	1	8	1086	0.00000	-0.00259	0.00000	0.00000	0.00000	1.0000000000	1.0000000000	0.00731	-0.01050	0	0	0	1	8	0	0.00000	0.00000
127	431856006	Chronic kidney disease stage 2 (disorder)	122	424132000	Non-small cell carcinoma of lung  TNM stage 1 (disorder)	1095	5	8	1	4	7	1083	27.37500	0.15325	38.67857	391.18956	3.82431	0.0360647676	0.3569070239	0.03653	0.94824	3	0	0	2	8	1	-2.19722	-1.09861
126	698754002	Chronic paralysis due to lesion of spinal cord	122	424132000	Non-small cell carcinoma of lung  TNM stage 1 (disorder)	1095	2	8	0	2	8	1085	0.00000	-0.00367	0.00000	0.00000	0.00000	1.0000000000	1.0000000000	0.01461	-0.02093	2	0	0	0	8	0	0.00000	0.00000
125	1734006	Fracture of the vertebral column with spinal cord injury	122	424132000	Non-small cell carcinoma of lung  TNM stage 1 (disorder)	1095	5	8	0	5	8	1082	0.00000	-0.00581	0.00000	0.00000	0.00000	1.0000000000	1.0000000000	0.03653	-0.05176	3	0	0	2	8	0	0.00000	0.00000
124	1501000119109	Proliferative diabetic retinopathy due to type II diabetes mellitus (disorder)	122	424132000	Non-small cell carcinoma of lung  TNM stage 1 (disorder)	1095	1	8	0	1	8	1086	0.00000	-0.00259	0.00000	0.00000	0.00000	1.0000000000	1.0000000000	0.00731	-0.01050	1	0	0	0	8	0	0.00000	0.00000
123	195967001	Asthma	122	424132000	Non-small cell carcinoma of lung  TNM stage 1 (disorder)	1095	2	8	0	2	8	1085	0.00000	-0.00367	0.00000	0.00000	0.00000	1.0000000000	1.0000000000	0.01461	-0.02093	1	0	0	1	8	0	0.00000	0.00000
121	254637007	Non-small cell lung cancer (disorder)	122	424132000	Non-small cell carcinoma of lung  TNM stage 1 (disorder)	1095	8	8	8	0	0	1087	136.87500	1.00000	0.00000	0.00000	0.00000	0.0000000000	0.0000000000	0.05845	3.08798	0	0	0	8	8	8	-0.69315	-0.69315
120	162573006	Suspected lung cancer (situation)	122	424132000	Non-small cell carcinoma of lung  TNM stage 1 (disorder)	1095	8	8	8	0	0	1087	136.87500	1.00000	0.00000	0.00000	0.00000	0.0000000000	0.0000000000	0.05845	3.08798	0	0	0	8	8	8	-0.69315	-0.69315
119	275272006	Brain damage - traumatic	122	424132000	Non-small cell carcinoma of lung  TNM stage 1 (disorder)	1095	4	8	1	3	7	1084	34.21875	0.17256	51.61905	558.89744	4.76747	0.0289442858	0.3121289194	0.02922	0.95844	0	0	0	4	8	1	-2.19722	-1.60944
118	48333001	Burn injury(morphologic abnormality)	122	424132000	Non-small cell carcinoma of lung  TNM stage 1 (disorder)	1095	1	8	0	1	8	1086	0.00000	-0.00259	0.00000	0.00000	0.00000	1.0000000000	1.0000000000	0.00731	-0.01050	0	0	0	1	8	0	0.00000	0.00000
117	230265002	Familial Alzheimer's disease of early onset (disorder)	122	424132000	Non-small cell carcinoma of lung  TNM stage 1 (disorder)	1095	6	8	0	6	8	1081	0.00000	-0.00637	0.00000	0.00000	0.00000	1.0000000000	1.0000000000	0.04384	-0.06189	2	0	0	4	8	0	0.00000	0.00000
116	370143000	Major depression disorder	122	424132000	Non-small cell carcinoma of lung  TNM stage 1 (disorder)	1095	8	8	0	8	8	1079	0.00000	-0.00736	0.00000	0.00000	0.00000	1.0000000000	1.0000000000	0.05845	-0.08195	3	0	0	5	8	0	0.00000	0.00000
115	36923009	Major depression  single episode	122	424132000	Non-small cell carcinoma of lung  TNM stage 1 (disorder)	1095	6	8	0	6	8	1081	0.00000	-0.00637	0.00000	0.00000	0.00000	1.0000000000	1.0000000000	0.04384	-0.06189	3	0	0	3	8	0	0.00000	0.00000
114	449868002	Smokes tobacco daily	122	424132000	Non-small cell carcinoma of lung  TNM stage 1 (disorder)	1095	9	8	1	8	7	1079	15.20833	0.11096	19.26786	175.23894	2.11854	0.0640919301	0.4928640393	0.06575	0.90813	2	0	0	7	8	1	-2.19722	-2.07944
113	443165006	Pathological fracture due to osteoporosis (disorder)	122	424132000	Non-small cell carcinoma of lung  TNM stage 1 (disorder)	1095	10	8	0	10	8	1077	0.00000	-0.00824	0.00000	0.00000	0.00000	1.0000000000	1.0000000000	0.07306	-0.10173	7	0	0	3	8	0	0.00000	0.00000
112	49436004	Atrial Fibrillation	122	424132000	Non-small cell carcinoma of lung  TNM stage 1 (disorder)	1095	35	8	1	34	7	1053	3.91071	0.04537	4.42437	36.96863	0.52950	0.2295125394	0.8880487574	0.25571	0.67150	9	0	0	26	8	1	-2.19722	-3.29584
111	235919008	Cholelithiasis	122	424132000	Non-small cell carcinoma of lung  TNM stage 1 (disorder)	1095	9	8	0	9	8	1078	0.00000	-0.00781	0.00000	0.00000	0.00000	1.0000000000	1.0000000000	0.06575	-0.09187	7	0	0	2	8	0	0.00000	0.00000
110	65275009	Acute Cholecystitis	122	424132000	Non-small cell carcinoma of lung  TNM stage 1 (disorder)	1095	9	8	0	9	8	1078	0.00000	-0.00781	0.00000	0.00000	0.00000	1.0000000000	1.0000000000	0.06575	-0.09187	7	0	0	2	8	0	0.00000	0.00000
109	90560007	Gout	122	424132000	Non-small cell carcinoma of lung  TNM stage 1 (disorder)	1095	4	8	0	4	8	1083	0.00000	-0.00519	0.00000	0.00000	0.00000	1.0000000000	1.0000000000	0.02922	-0.04156	0	0	0	4	8	0	0.00000	0.00000
108	40930008	Hypothyroidism (disorder)	122	424132000	Non-small cell carcinoma of lung  TNM stage 1 (disorder)	1095	13	8	0	13	8	1074	0.00000	-0.00940	0.00000	0.00000	0.00000	1.0000000000	1.0000000000	0.09498	-0.13090	11	0	0	2	8	0	0.00000	0.00000
107	40275004	Contact dermatitis	122	424132000	Non-small cell carcinoma of lung  TNM stage 1 (disorder)	1095	18	8	0	18	8	1069	0.00000	-0.01109	0.00000	0.00000	0.00000	1.0000000000	1.0000000000	0.13151	-0.17825	9	0	0	9	8	0	0.00000	0.00000
106	24079001	Atopic dermatitis	122	424132000	Non-small cell carcinoma of lung  TNM stage 1 (disorder)	1095	20	8	0	20	8	1067	0.00000	-0.01170	0.00000	0.00000	0.00000	1.0000000000	1.0000000000	0.14612	-0.19676	13	0	0	7	8	0	0.00000	0.00000
105	363406005	Malignant tumor of colon	122	424132000	Non-small cell carcinoma of lung  TNM stage 1 (disorder)	1095	6	8	0	6	8	1081	0.00000	-0.00637	0.00000	0.00000	0.00000	1.0000000000	1.0000000000	0.04384	-0.06189	4	0	0	2	8	0	0.00000	0.00000
104	367498001	Seasonal allergic rhinitis	122	424132000	Non-small cell carcinoma of lung  TNM stage 1 (disorder)	1095	20	8	0	20	8	1067	0.00000	-0.01170	0.00000	0.00000	0.00000	1.0000000000	1.0000000000	0.14612	-0.19676	9	0	0	11	8	0	0.00000	0.00000
103	157141000119108	Proteinuria due to type 2 diabetes mellitus (disorder)	122	424132000	Non-small cell carcinoma of lung  TNM stage 1 (disorder)	1095	3	8	0	3	8	1084	0.00000	-0.00450	0.00000	0.00000	0.00000	1.0000000000	1.0000000000	0.02192	-0.03128	1	0	0	2	8	0	0.00000	0.00000
102	90781000119102	Microalbuminuria due to type 2 diabetes mellitus (disorder)	122	424132000	Non-small cell carcinoma of lung  TNM stage 1 (disorder)	1095	6	8	1	5	7	1082	22.81250	0.13890	30.91429	299.83803	3.18736	0.0431395216	0.3985498161	0.04384	0.93811	3	0	0	3	8	1	-2.19722	-1.38629
101	433144002	Chronic kidney disease stage 3 (disorder)	122	424132000	Non-small cell carcinoma of lung  TNM stage 1 (disorder)	1095	3	8	0	3	8	1084	0.00000	-0.00450	0.00000	0.00000	0.00000	1.0000000000	1.0000000000	0.02192	-0.03128	1	0	0	2	8	0	0.00000	0.00000
100	161622006	History of lower limb amputation (situation)	122	424132000	Non-small cell carcinoma of lung  TNM stage 1 (disorder)	1095	1	8	0	1	8	1086	0.00000	-0.00259	0.00000	0.00000	0.00000	1.0000000000	1.0000000000	0.00731	-0.01050	0	0	0	1	8	0	0.00000	0.00000
99	30832001	Rupture of patellar tendon	122	424132000	Non-small cell carcinoma of lung  TNM stage 1 (disorder)	1095	23	8	1	22	7	1065	5.95109	0.06222	6.91558	58.62581	0.81577	0.1566536716	0.7747075658	0.16804	0.77591	14	0	0	9	8	1	-2.19722	-2.30259
98	1551000119108	Nonproliferative diabetic retinopathy due to type 2 diabetes mellitus (disorder)	122	424132000	Non-small cell carcinoma of lung  TNM stage 1 (disorder)	1095	12	8	0	12	8	1075	0.00000	-0.00903	0.00000	0.00000	0.00000	1.0000000000	1.0000000000	0.08767	-0.12124	7	0	0	5	8	0	0.00000	0.00000
97	403192003	Third degree burn	122	424132000	Non-small cell carcinoma of lung  TNM stage 1 (disorder)	1095	8	8	0	8	8	1079	0.00000	-0.00736	0.00000	0.00000	0.00000	1.0000000000	1.0000000000	0.05845	-0.08195	3	0	0	5	8	0	0.00000	0.00000
96	283371005	Laceration of forearm	122	424132000	Non-small cell carcinoma of lung  TNM stage 1 (disorder)	1095	75	8	1	74	7	1013	1.82500	0.01919	1.95560	16.10676	0.23744	0.4341934482	1.0000000000	0.54795	0.36965	39	0	0	36	8	1	-2.19722	-3.61092
95	84757009	Epilepsy	122	424132000	Non-small cell carcinoma of lung  TNM stage 1 (disorder)	1095	30	8	1	29	7	1058	4.56250	0.05129	5.21182	43.74820	0.62090	0.1998532808	0.8434192785	0.21918	0.71409	13	0	0	17	8	1	-2.19722	-2.89037
94	703151001	History of single seizure (situation)	122	424132000	Non-small cell carcinoma of lung  TNM stage 1 (disorder)	1095	39	8	1	38	7	1049	3.50962	0.04137	3.94361	32.85942	0.47329	0.2525427859	0.9133257124	0.28493	0.63831	14	0	0	25	8	1	-2.19722	-3.25810
93	128613002	Seizure disorder	122	424132000	Non-small cell carcinoma of lung  TNM stage 1 (disorder)	1095	39	8	1	38	7	1049	3.50962	0.04137	3.94361	32.85942	0.47329	0.2525427859	0.9133257124	0.28493	0.63831	14	0	0	25	8	1	-2.19722	-3.25810
92	82423001	Chronic pain	122	424132000	Non-small cell carcinoma of lung  TNM stage 1 (disorder)	1095	52	8	0	52	8	1035	0.00000	-0.01916	0.00000	0.00000	0.00000	1.0000000000	1.0000000000	0.37991	-0.46457	24	0	0	28	8	0	0.00000	0.00000
91	64859006	Osteoporosis (disorder)	122	424132000	Non-small cell carcinoma of lung  TNM stage 1 (disorder)	1095	37	8	0	37	8	1050	0.00000	-0.01604	0.00000	0.00000	0.00000	1.0000000000	1.0000000000	0.27032	-0.34519	24	0	0	13	8	0	0.00000	0.00000
90	444470001	Injury of anterior cruciate ligament	122	424132000	Non-small cell carcinoma of lung  TNM stage 1 (disorder)	1095	19	8	1	18	7	1069	7.20395	0.07072	8.48413	72.57709	0.99178	0.1310631548	0.7119259731	0.13881	0.81247	10	0	0	9	8	1	-2.19722	-2.30259
89	47693006	Rupture of appendix	122	424132000	Non-small cell carcinoma of lung  TNM stage 1 (disorder)	1095	20	8	0	20	8	1067	0.00000	-0.01170	0.00000	0.00000	0.00000	1.0000000000	1.0000000000	0.14612	-0.19676	10	0	0	10	8	0	0.00000	0.00000
88	197927001	Recurrent urinary tract infection	122	424132000	Non-small cell carcinoma of lung  TNM stage 1 (disorder)	1095	8	8	0	8	8	1079	0.00000	-0.00736	0.00000	0.00000	0.00000	1.0000000000	1.0000000000	0.05845	-0.08195	8	0	0	0	8	0	0.00000	0.00000
87	109838007	Overlapping malignant neoplasm of colon	122	424132000	Non-small cell carcinoma of lung  TNM stage 1 (disorder)	1095	8	8	0	8	8	1079	0.00000	-0.00736	0.00000	0.00000	0.00000	1.0000000000	1.0000000000	0.05845	-0.08195	5	0	0	3	8	0	0.00000	0.00000
86	713197008	Recurrent rectal polyp	122	424132000	Non-small cell carcinoma of lung  TNM stage 1 (disorder)	1095	22	8	0	22	8	1065	0.00000	-0.01228	0.00000	0.00000	0.00000	1.0000000000	1.0000000000	0.16073	-0.21503	12	0	0	10	8	0	0.00000	0.00000
85	241929008	Acute allergic reaction	122	424132000	Non-small cell carcinoma of lung  TNM stage 1 (disorder)	1095	47	8	0	47	8	1040	0.00000	-0.01817	0.00000	0.00000	0.00000	1.0000000000	1.0000000000	0.34338	-0.42587	25	0	0	22	8	0	0.00000	0.00000
84	232353008	Perennial allergic rhinitis with seasonal variation	122	424132000	Non-small cell carcinoma of lung  TNM stage 1 (disorder)	1095	29	8	0	29	8	1058	0.00000	-0.01415	0.00000	0.00000	0.00000	1.0000000000	1.0000000000	0.21187	-0.27724	14	0	0	15	8	0	0.00000	0.00000
83	110030002	Concussion injury of brain	122	424132000	Non-small cell carcinoma of lung  TNM stage 1 (disorder)	1095	7	8	0	7	8	1080	0.00000	-0.00688	0.00000	0.00000	0.00000	1.0000000000	1.0000000000	0.05114	-0.07196	1	0	0	6	8	0	0.00000	0.00000
82	94260004	Secondary malignant neoplasm of colon	122	424132000	Non-small cell carcinoma of lung  TNM stage 1 (disorder)	1095	4	8	0	4	8	1083	0.00000	-0.00519	0.00000	0.00000	0.00000	1.0000000000	1.0000000000	0.02922	-0.04156	2	0	0	2	8	0	0.00000	0.00000
81	236077008	Protracted diarrhea	122	424132000	Non-small cell carcinoma of lung  TNM stage 1 (disorder)	1095	4	8	0	4	8	1083	0.00000	-0.00519	0.00000	0.00000	0.00000	1.0000000000	1.0000000000	0.02922	-0.04156	2	0	0	2	8	0	0.00000	0.00000
80	6072007	Bleeding from anus	122	424132000	Non-small cell carcinoma of lung  TNM stage 1 (disorder)	1095	4	8	0	4	8	1083	0.00000	-0.00519	0.00000	0.00000	0.00000	1.0000000000	1.0000000000	0.02922	-0.04156	2	0	0	2	8	0	0.00000	0.00000
79	45816000	Pyelonephritis	122	424132000	Non-small cell carcinoma of lung  TNM stage 1 (disorder)	1095	1	8	0	1	8	1086	0.00000	-0.00259	0.00000	0.00000	0.00000	1.0000000000	1.0000000000	0.00731	-0.01050	1	0	0	0	8	0	0.00000	0.00000
78	239872002	Osteoarthritis of hip	122	424132000	Non-small cell carcinoma of lung  TNM stage 1 (disorder)	1095	21	8	1	20	7	1067	6.51786	0.06619	7.62143	64.87359	0.89537	0.1439420804	0.7404942507	0.15342	0.79408	13	0	0	8	8	1	-2.19722	-2.19722
77	422034002	Diabetic retinopathy associated with type II diabetes mellitus (disorder)	122	424132000	Non-small cell carcinoma of lung  TNM stage 1 (disorder)	1095	20	8	0	20	8	1067	0.00000	-0.01170	0.00000	0.00000	0.00000	1.0000000000	1.0000000000	0.14612	-0.19676	8	0	0	12	8	0	0.00000	0.00000
76	127013003	Diabetic renal disease (disorder)	122	424132000	Non-small cell carcinoma of lung  TNM stage 1 (disorder)	1095	28	8	1	27	7	1060	4.88839	0.05404	5.60847	47.18618	0.66661	0.1877127711	0.8181443419	0.20457	0.73149	10	0	0	18	8	1	-2.19722	-2.94444
75	431855005	Chronic kidney disease stage 1 (disorder)	122	424132000	Non-small cell carcinoma of lung  TNM stage 1 (disorder)	1095	28	8	1	27	7	1060	4.88839	0.05404	5.60847	47.18618	0.66661	0.1877127711	0.8181443419	0.20457	0.73149	10	0	0	18	8	1	-2.19722	-2.94444
74	79586000	Tubal pregnancy	122	424132000	Non-small cell carcinoma of lung  TNM stage 1 (disorder)	1095	23	8	0	23	8	1064	0.00000	-0.01257	0.00000	0.00000	0.00000	1.0000000000	1.0000000000	0.16804	-0.22409	23	0	0	0	8	0	0.00000	0.00000
73	196416002	Impacted molars	122	424132000	Non-small cell carcinoma of lung  TNM stage 1 (disorder)	1095	49	8	0	49	8	1038	0.00000	-0.01857	0.00000	0.00000	0.00000	1.0000000000	1.0000000000	0.35799	-0.44147	25	0	0	24	8	0	0.00000	0.00000
72	35999006	Blighted ovum	122	424132000	Non-small cell carcinoma of lung  TNM stage 1 (disorder)	1095	53	8	0	53	8	1034	0.00000	-0.01935	0.00000	0.00000	0.00000	1.0000000000	1.0000000000	0.38721	-0.47219	53	0	0	0	8	0	0.00000	0.00000
71	201834006	Localized  primary osteoarthritis of the hand	122	424132000	Non-small cell carcinoma of lung  TNM stage 1 (disorder)	1095	28	8	0	28	8	1059	0.00000	-0.01390	0.00000	0.00000	0.00000	1.0000000000	1.0000000000	0.20457	-0.26851	19	0	0	9	8	0	0.00000	0.00000
70	87433001	Pulmonary emphysema (disorder)	122	424132000	Non-small cell carcinoma of lung  TNM stage 1 (disorder)	1095	17	8	0	17	8	1070	0.00000	-0.01077	0.00000	0.00000	0.00000	1.0000000000	1.0000000000	0.12420	-0.16890	9	0	0	8	8	0	0.00000	0.00000
69	233604007	Pneumonia	122	424132000	Non-small cell carcinoma of lung  TNM stage 1 (disorder)	1095	7	8	0	7	8	1080	0.00000	-0.00688	0.00000	0.00000	0.00000	1.0000000000	1.0000000000	0.05114	-0.07196	3	0	0	4	8	0	0.00000	0.00000
68	26929004	Alzheimer's disease (disorder)	122	424132000	Non-small cell carcinoma of lung  TNM stage 1 (disorder)	1095	23	8	0	23	8	1064	0.00000	-0.01257	0.00000	0.00000	0.00000	1.0000000000	1.0000000000	0.16804	-0.22409	15	0	0	8	8	0	0.00000	0.00000
67	403191005	Second degree burn	122	424132000	Non-small cell carcinoma of lung  TNM stage 1 (disorder)	1095	49	8	0	49	8	1038	0.00000	-0.01857	0.00000	0.00000	0.00000	1.0000000000	1.0000000000	0.35799	-0.44147	23	0	0	26	8	0	0.00000	0.00000
66	55822004	Hyperlipidemia	122	424132000	Non-small cell carcinoma of lung  TNM stage 1 (disorder)	1095	119	8	0	119	8	968	0.00000	-0.02996	0.00000	0.00000	0.00000	1.0000000000	1.0000000000	0.86941	-0.90258	64	0	0	55	8	0	0.00000	0.00000
65	239873007	Osteoarthritis of knee	122	424132000	Non-small cell carcinoma of lung  TNM stage 1 (disorder)	1095	57	8	0	57	8	1030	0.00000	-0.02010	0.00000	0.00000	0.00000	1.0000000000	1.0000000000	0.41644	-0.50227	30	0	0	27	8	0	0.00000	0.00000
64	444448004	Injury of medial collateral ligament of knee	122	424132000	Non-small cell carcinoma of lung  TNM stage 1 (disorder)	1095	32	8	0	32	8	1055	0.00000	-0.01488	0.00000	0.00000	0.00000	1.0000000000	1.0000000000	0.23379	-0.30310	17	0	0	15	8	0	0.00000	0.00000
63	68496003	Polyp of colon	122	424132000	Non-small cell carcinoma of lung  TNM stage 1 (disorder)	1095	91	8	0	91	8	996	0.00000	-0.02583	0.00000	0.00000	0.00000	1.0000000000	1.0000000000	0.66484	-0.73538	43	0	0	48	8	0	0.00000	0.00000
62	185086009	Chronic obstructive bronchitis (disorder)	122	424132000	Non-small cell carcinoma of lung  TNM stage 1 (disorder)	1095	6	8	0	6	8	1081	0.00000	-0.00637	0.00000	0.00000	0.00000	1.0000000000	1.0000000000	0.04384	-0.06189	4	0	0	2	8	0	0.00000	0.00000
61	198992004	Antepartum eclampsia	122	424132000	Non-small cell carcinoma of lung  TNM stage 1 (disorder)	1095	96	8	0	96	8	991	0.00000	-0.02659	0.00000	0.00000	0.00000	1.0000000000	1.0000000000	0.70137	-0.76670	96	0	0	0	8	0	0.00000	0.00000
60	301011002	Escherichia coli urinary tract infection	122	424132000	Non-small cell carcinoma of lung  TNM stage 1 (disorder)	1095	92	8	0	92	8	995	0.00000	-0.02598	0.00000	0.00000	0.00000	1.0000000000	1.0000000000	0.67215	-0.74170	85	0	0	7	8	0	0.00000	0.00000
59	262574004	Bullet wound	122	424132000	Non-small cell carcinoma of lung  TNM stage 1 (disorder)	1095	20	8	0	20	8	1067	0.00000	-0.01170	0.00000	0.00000	0.00000	1.0000000000	1.0000000000	0.14612	-0.19676	9	0	0	11	8	0	0.00000	0.00000
58	239720000	Tear of meniscus of knee	122	424132000	Non-small cell carcinoma of lung  TNM stage 1 (disorder)	1095	20	8	0	20	8	1067	0.00000	-0.01170	0.00000	0.00000	0.00000	1.0000000000	1.0000000000	0.14612	-0.19676	10	0	0	10	8	0	0.00000	0.00000
57	192127007	Child attention deficit disorder	122	424132000	Non-small cell carcinoma of lung  TNM stage 1 (disorder)	1095	76	8	0	76	8	1011	0.00000	-0.02343	0.00000	0.00000	0.00000	1.0000000000	1.0000000000	0.55525	-0.63715	24	0	0	52	8	0	0.00000	0.00000
56	92691004	Carcinoma in situ of prostate (disorder)	122	424132000	Non-small cell carcinoma of lung  TNM stage 1 (disorder)	1095	23	8	1	22	7	1065	5.95109	0.06222	6.91558	58.62581	0.81577	0.1566536716	0.7747075658	0.16804	0.77591	0	0	0	23	8	1	-2.19722	-3.17805
55	126906006	Neoplasm of prostate	122	424132000	Non-small cell carcinoma of lung  TNM stage 1 (disorder)	1095	24	8	1	23	7	1064	5.70312	0.06040	6.60870	55.92480	0.78096	0.1629473009	0.7879650300	0.17534	0.76692	0	0	0	24	8	1	-2.19722	-3.21888
54	5602001	Opioid abuse (disorder)	122	424132000	Non-small cell carcinoma of lung  TNM stage 1 (disorder)	1095	7	8	1	6	7	1081	19.55357	0.12767	25.73810	242.65496	2.73001	0.0501687997	0.4320205543	0.05114	0.92804	0	0	0	7	8	1	-2.19722	-2.07944
53	7200002	Alcoholism	122	424132000	Non-small cell carcinoma of lung  TNM stage 1 (disorder)	1095	5	8	1	4	7	1083	27.37500	0.15325	38.67857	391.18956	3.82431	0.0360647676	0.3569070239	0.03653	0.94824	0	0	0	5	8	1	-2.19722	-1.79176
52	124171000119105	Chronic intractable migraine without aura	122	424132000	Non-small cell carcinoma of lung  TNM stage 1 (disorder)	1095	51	8	0	51	8	1036	0.00000	-0.01896	0.00000	0.00000	0.00000	1.0000000000	1.0000000000	0.37260	-0.45691	21	0	0	30	8	0	0.00000	0.00000
51	403190006	First degree burn	122	424132000	Non-small cell carcinoma of lung  TNM stage 1 (disorder)	1095	79	8	0	79	8	1008	0.00000	-0.02392	0.00000	0.00000	0.00000	1.0000000000	1.0000000000	0.57717	-0.65734	43	0	0	36	8	0	0.00000	0.00000
50	446096008	Perennial allergic rhinitis	122	424132000	Non-small cell carcinoma of lung  TNM stage 1 (disorder)	1095	26	8	0	26	8	1061	0.00000	-0.01338	0.00000	0.00000	0.00000	1.0000000000	1.0000000000	0.18995	-0.25091	14	0	0	12	8	0	0.00000	0.00000
49	88805009	Chronic congestive heart failure (disorder)	122	424132000	Non-small cell carcinoma of lung  TNM stage 1 (disorder)	1095	10	8	0	10	8	1077	0.00000	-0.00824	0.00000	0.00000	0.00000	1.0000000000	1.0000000000	0.07306	-0.10173	5	0	0	5	8	0	0.00000	0.00000
48	55680006	Drug overdose	122	424132000	Non-small cell carcinoma of lung  TNM stage 1 (disorder)	1095	50	8	0	50	8	1037	0.00000	-0.01877	0.00000	0.00000	0.00000	1.0000000000	1.0000000000	0.36530	-0.44921	24	0	0	26	8	0	0.00000	0.00000
47	359817006	Closed fracture of hip	122	424132000	Non-small cell carcinoma of lung  TNM stage 1 (disorder)	1095	29	8	0	29	8	1058	0.00000	-0.01415	0.00000	0.00000	0.00000	1.0000000000	1.0000000000	0.21187	-0.27724	11	0	0	18	8	0	0.00000	0.00000
46	62564004	Concussion with loss of consciousness	122	424132000	Non-small cell carcinoma of lung  TNM stage 1 (disorder)	1095	67	8	0	67	8	1020	0.00000	-0.02190	0.00000	0.00000	0.00000	1.0000000000	1.0000000000	0.48950	-0.57483	36	0	0	31	8	0	0.00000	0.00000
45	263102004	Fracture subluxation of wrist	122	424132000	Non-small cell carcinoma of lung  TNM stage 1 (disorder)	1095	109	8	1	108	7	979	1.25573	0.00729	1.29497	10.62474	0.15784	0.5690084463	1.0000000000	0.79635	0.15493	51	0	0	58	8	1	-2.19722	-4.07754
44	58150001	Fracture of clavicle	122	424132000	Non-small cell carcinoma of lung  TNM stage 1 (disorder)	1095	112	8	4	108	4	979	4.88839	0.11260	9.06481	36.76262	2.23517	0.0052541750	0.0931740363	0.81826	1.45937	55	0	0	57	8	4	-1.09861	-2.72458
43	307731004	Injury of tendon of the rotator cuff of shoulder	122	424132000	Non-small cell carcinoma of lung  TNM stage 1 (disorder)	1095	51	8	0	51	8	1036	0.00000	-0.01896	0.00000	0.00000	0.00000	1.0000000000	1.0000000000	0.37260	-0.45691	26	0	0	25	8	0	0.00000	0.00000
42	16114001	Fracture of ankle	122	424132000	Non-small cell carcinoma of lung  TNM stage 1 (disorder)	1095	108	8	0	108	8	979	0.00000	-0.02838	0.00000	0.00000	0.00000	1.0000000000	1.0000000000	0.78904	-0.83919	48	0	0	60	8	0	0.00000	0.00000
41	283385000	Laceration of thigh	122	424132000	Non-small cell carcinoma of lung  TNM stage 1 (disorder)	1095	105	8	1	104	7	983	1.30357	0.00848	1.35027	11.08203	0.16452	0.5547693232	1.0000000000	0.76712	0.17860	50	0	0	55	8	1	-2.19722	-4.02535
40	428251008	History of appendectomy	122	424132000	Non-small cell carcinoma of lung  TNM stage 1 (disorder)	1095	51	8	1	50	7	1037	2.68382	0.03193	2.96286	24.54668	0.35763	0.3180602796	1.0000000000	0.37260	0.54309	27	0	0	24	8	1	-2.19722	-3.21888
39	74400008	Appendicitis	122	424132000	Non-small cell carcinoma of lung  TNM stage 1 (disorder)	1095	51	8	1	50	7	1037	2.68382	0.03193	2.96286	24.54668	0.35763	0.3180602796	1.0000000000	0.37260	0.54309	27	0	0	24	8	1	-2.19722	-3.21888
38	398254007	Preeclampsia	122	424132000	Non-small cell carcinoma of lung  TNM stage 1 (disorder)	1095	101	8	0	101	8	986	0.00000	-0.02735	0.00000	0.00000	0.00000	1.0000000000	1.0000000000	0.73790	-0.79734	101	0	0	0	8	0	0.00000	0.00000
37	38822007	Cystitis	122	424132000	Non-small cell carcinoma of lung  TNM stage 1 (disorder)	1095	71	8	0	71	8	1016	0.00000	-0.02259	0.00000	0.00000	0.00000	1.0000000000	1.0000000000	0.51872	-0.60286	68	0	0	3	8	0	0.00000	0.00000
36	156073000	Fetus with unknown complication	122	424132000	Non-small cell carcinoma of lung  TNM stage 1 (disorder)	1095	125	8	0	125	8	962	0.00000	-0.03080	0.00000	0.00000	0.00000	0.6075389592	1.0000000000	0.91324	-0.93602	125	0	0	0	8	0	0.00000	0.00000
35	19169002	Miscarriage in first trimester	122	424132000	Non-small cell carcinoma of lung  TNM stage 1 (disorder)	1095	174	8	0	174	8	913	0.00000	-0.03729	0.00000	0.00000	0.00000	0.3691677987	1.0000000000	1.27123	-1.18348	174	0	0	0	8	0	0.00000	0.00000
34	72892002	Normal pregnancy	122	424132000	Non-small cell carcinoma of lung  TNM stage 1 (disorder)	1095	384	8	0	384	8	703	0.00000	-0.06305	0.00000	0.00000	0.00000	0.0562985733	0.4605674526	2.80548	-1.92808	384	0	0	0	8	0	0.00000	0.00000
33	429007001	History of cardiac arrest (situation)	122	424132000	Non-small cell carcinoma of lung  TNM stage 1 (disorder)	1095	42	8	1	41	7	1046	3.25893	0.03870	3.64460	30.31510	0.43817	0.2694179494	0.9388450812	0.30685	0.61391	24	0	0	18	8	1	-2.19722	-2.94444
32	410429000	Cardiac Arrest	122	424132000	Non-small cell carcinoma of lung  TNM stage 1 (disorder)	1095	42	8	1	41	7	1046	3.25893	0.03870	3.64460	30.31510	0.43817	0.2694179494	0.9388450812	0.30685	0.61391	24	0	0	18	8	1	-2.19722	-2.94444
31	230690007	Stroke	122	424132000	Non-small cell carcinoma of lung  TNM stage 1 (disorder)	1095	62	8	0	62	8	1025	0.00000	-0.02102	0.00000	0.00000	0.00000	1.0000000000	1.0000000000	0.45297	-0.53900	32	0	0	30	8	0	0.00000	0.00000
30	399211009	History of myocardial infarction (situation)	122	424132000	Non-small cell carcinoma of lung  TNM stage 1 (disorder)	1095	31	8	0	31	8	1056	0.00000	-0.01464	0.00000	0.00000	0.00000	1.0000000000	1.0000000000	0.22648	-0.29453	2	0	0	29	8	0	0.00000	0.00000
29	22298006	Myocardial Infarction	122	424132000	Non-small cell carcinoma of lung  TNM stage 1 (disorder)	1095	31	8	0	31	8	1056	0.00000	-0.01464	0.00000	0.00000	0.00000	1.0000000000	1.0000000000	0.22648	-0.29453	2	0	0	29	8	0	0.00000	0.00000
28	53741008	Coronary Heart Disease	122	424132000	Non-small cell carcinoma of lung  TNM stage 1 (disorder)	1095	80	8	0	80	8	1007	0.00000	-0.02408	0.00000	0.00000	0.00000	1.0000000000	1.0000000000	0.58447	-0.66400	24	0	0	56	8	0	0.00000	0.00000
27	408512008	Body mass index 40+ - severely obese (finding)	122	424132000	Non-small cell carcinoma of lung  TNM stage 1 (disorder)	1095	97	8	0	97	8	990	0.00000	-0.02675	0.00000	0.00000	0.00000	1.0000000000	1.0000000000	0.70868	-0.77288	67	0	0	30	8	0	0.00000	0.00000
26	33737001	Fracture of rib	122	424132000	Non-small cell carcinoma of lung  TNM stage 1 (disorder)	1095	54	8	0	54	8	1033	0.00000	-0.01954	0.00000	0.00000	0.00000	1.0000000000	1.0000000000	0.39452	-0.47977	32	0	0	22	8	0	0.00000	0.00000
25	284551006	Laceration of foot	122	424132000	Non-small cell carcinoma of lung  TNM stage 1 (disorder)	1095	118	8	0	118	8	969	0.00000	-0.02981	0.00000	0.00000	0.00000	1.0000000000	1.0000000000	0.86210	-0.89693	53	0	0	65	8	0	0.00000	0.00000
24	162864005	Body mass index 30+ - obesity (finding)	122	424132000	Non-small cell carcinoma of lung  TNM stage 1 (disorder)	1095	439	8	4	435	4	652	1.24715	0.01735	1.49885	6.02493	0.37288	0.7205465380	1.0000000000	3.20731	0.24903	226	0	0	213	8	4	-1.09861	-3.99360
23	36971009	Sinusitis (disorder)	122	424132000	Non-small cell carcinoma of lung  TNM stage 1 (disorder)	1095	190	8	3	187	5	900	2.16118	0.04564	2.88770	12.18808	0.68418	0.1472481858	0.7510427515	1.38813	0.74412	84	0	0	106	8	3	-1.29928	-3.59274
22	70704007	Sprain of wrist	122	424132000	Non-small cell carcinoma of lung  TNM stage 1 (disorder)	1095	195	8	2	193	6	894	1.40385	0.01613	1.54404	7.70795	0.30930	0.6381889071	1.0000000000	1.42466	0.30718	90	0	0	105	8	2	-1.60944	-3.97968
21	15777000	Prediabetes	122	424132000	Non-small cell carcinoma of lung  TNM stage 1 (disorder)	1095	333	8	6	327	2	760	2.46622	0.08315	6.97248	34.72700	1.39993	0.0118613104	0.1721476562	2.43288	1.02794	159	0	0	174	8	6	-0.84730	-3.40120
20	80394007	Hyperglycemia (disorder)	122	424132000	Non-small cell carcinoma of lung  TNM stage 1 (disorder)	1095	55	8	1	54	7	1033	2.48864	0.02937	2.73280	22.61036	0.33030	0.3387530268	1.0000000000	0.40183	0.51269	23	0	0	32	8	1	-2.19722	-3.49651
19	237602007	Metabolic syndrome X (disorder)	122	424132000	Non-small cell carcinoma of lung  TNM stage 1 (disorder)	1095	64	8	2	62	6	1025	4.27734	0.07005	5.51075	27.86598	1.08980	0.0749717423	0.5403135912	0.46758	1.03152	28	0	0	36	8	2	-1.60944	-2.94444
18	302870006	Hypertriglyceridemia (disorder)	122	424132000	Non-small cell carcinoma of lung  TNM stage 1 (disorder)	1095	64	8	2	62	6	1025	4.27734	0.07005	5.51075	27.86598	1.08980	0.0749717423	0.5403135912	0.46758	1.03152	28	0	0	36	8	2	-1.60944	-2.94444
17	368581000119106	Neuropathy due to type 2 diabetes mellitus (disorder)	122	424132000	Non-small cell carcinoma of lung  TNM stage 1 (disorder)	1095	28	8	1	27	7	1060	4.88839	0.05404	5.60847	47.18618	0.66661	0.1877127711	0.8181443419	0.20457	0.73149	7	0	0	21	8	1	-2.19722	-3.09104
16	44054006	Diabetes	122	424132000	Non-small cell carcinoma of lung  TNM stage 1 (disorder)	1095	68	8	2	66	6	1021	4.02574	0.06679	5.15657	26.04489	1.02094	0.0834664194	0.5700988979	0.49680	1.00308	29	0	0	39	8	2	-1.60944	-3.02042
15	40055000	Chronic sinusitis (disorder)	122	424132000	Non-small cell carcinoma of lung  TNM stage 1 (disorder)	1095	216	8	2	214	6	873	1.26736	0.01137	1.35981	6.78437	0.27255	0.6604667638	1.0000000000	1.57808	0.21866	104	0	0	112	8	2	-1.60944	-4.04305
14	10509002	Acute bronchitis (disorder)	122	424132000	Non-small cell carcinoma of lung  TNM stage 1 (disorder)	1095	863	8	7	856	1	231	1.11023	0.01824	1.88902	15.43107	0.23125	1.0000000000	1.0000000000	6.30502	0.13111	418	0	0	445	8	7	-0.76214	-4.16777
13	370247008	Facial laceration	122	424132000	Non-small cell carcinoma of lung  TNM stage 1 (disorder)	1095	109	8	0	109	8	978	0.00000	-0.02852	0.00000	0.00000	0.00000	1.0000000000	1.0000000000	0.79635	-0.84507	55	0	0	54	8	0	0.00000	0.00000
12	65966004	Fracture of forearm	122	424132000	Non-small cell carcinoma of lung  TNM stage 1 (disorder)	1095	123	8	1	122	7	965	1.11280	0.00344	1.12998	9.26215	0.13786	1.0000000000	1.0000000000	0.89863	0.07504	55	0	0	68	8	1	-2.19722	-4.23411
11	38341003	Hypertension	122	424132000	Non-small cell carcinoma of lung  TNM stage 1 (disorder)	1095	278	8	5	273	3	814	2.46178	0.07315	4.96947	20.93077	1.17987	0.0286404444	0.3115313765	2.03105	0.98514	131	0	0	147	8	5	-0.95551	-3.41444
10	62106007	Concussion with no loss of consciousness	122	424132000	Non-small cell carcinoma of lung  TNM stage 1 (disorder)	1095	206	8	1	205	7	882	0.66444	-0.01386	0.61463	5.02320	0.07521	1.0000000000	1.0000000000	1.50502	-0.32482	96	0	0	110	8	1	-2.19722	-4.70953
9	44465007	Sprain of ankle	122	424132000	Non-small cell carcinoma of lung  TNM stage 1 (disorder)	1095	362	8	5	357	3	730	1.89054	0.05369	3.40803	14.34035	0.80993	0.1242031006	0.6913144812	2.64475	0.71914	185	0	0	177	8	5	-0.95551	-3.59457
8	233678006	Childhood asthma	122	424132000	Non-small cell carcinoma of lung  TNM stage 1 (disorder)	1095	45	8	0	45	8	1042	0.00000	-0.01776	0.00000	0.00000	0.00000	1.0000000000	1.0000000000	0.32877	-0.41009	25	0	0	20	8	0	0.00000	0.00000
7	75498004	Acute bacterial sinusitis (disorder)	122	424132000	Non-small cell carcinoma of lung  TNM stage 1 (disorder)	1095	187	8	0	187	8	900	0.00000	-0.03893	0.00000	0.00000	0.00000	0.3643078077	1.0000000000	1.36621	-1.24258	89	0	0	98	8	0	0.00000	0.00000
6	39848009	Whiplash injury to neck	122	424132000	Non-small cell carcinoma of lung  TNM stage 1 (disorder)	1095	182	8	1	181	7	906	0.75206	-0.00950	0.71507	5.84737	0.08745	1.0000000000	1.0000000000	1.32968	-0.22013	92	0	0	90	8	1	-2.19722	-4.51086
5	284549007	Laceration of hand	122	424132000	Non-small cell carcinoma of lung  TNM stage 1 (disorder)	1095	104	8	2	102	6	985	2.63221	0.04536	3.21895	16.15607	0.64135	0.1716269478	0.7972585288	0.75982	0.76954	54	0	0	50	8	2	-1.60944	-3.25810
4	195662009	Acute viral pharyngitis (disorder)	122	424132000	Non-small cell carcinoma of lung  TNM stage 1 (disorder)	1095	890	8	8	882	0	205	1.23034	0.04117	0.00000	0.00000	0.00000	0.3643124531	1.0000000000	6.50228	0.26260	430	0	0	460	8	8	-0.69315	-4.06903
3	65363002	Otitis media	122	424132000	Non-small cell carcinoma of lung  TNM stage 1 (disorder)	1095	580	8	3	577	5	510	0.70797	-0.02659	0.53033	2.23010	0.12611	0.4859122459	1.0000000000	4.23744	-0.38886	277	0	0	303	8	3	-1.29928	-4.62497
2	43878008	Streptococcal sore throat (disorder)	122	424132000	Non-small cell carcinoma of lung  TNM stage 1 (disorder)	1095	523	8	4	519	4	568	1.04685	0.00384	1.09441	4.39833	0.27232	1.0000000000	1.0000000000	3.82100	0.05259	246	0	0	277	8	4	-1.09861	-4.25206
1	444814009	Viral sinusitis (disorder)	122	424132000	Non-small cell carcinoma of lung  TNM stage 1 (disorder)	1095	993	8	8	985	0	102	1.10272	0.02750	0.00000	0.00000	0.00000	1.0000000000	1.0000000000	7.25479	0.12469	478	0	0	515	8	8	-0.69315	-4.18014
94	703151001	History of single seizure (situation)	96	283371005	Laceration of forearm	1095	39	75	2	37	73	983	0.74872	-0.01309	0.72788	3.08015	0.17201	1.0000000000	1.0000000000	2.67123	-0.29130	14	39	0	25	36	2	-2.94444	-2.60269
114	449868002	Smokes tobacco daily	19	237602007	Metabolic syndrome X (disorder)	1095	9	64	3	6	61	1025	5.70312	0.10667	8.40164	34.40489	2.05167	0.0124238334	0.1776163030	0.52603	1.39022	2	28	1	7	36	2	0.42286	-0.40547
75	431855005	Chronic kidney disease stage 1 (disorder)	96	283371005	Laceration of forearm	1095	28	75	4	24	71	996	2.08571	0.04769	2.33803	6.92297	0.78960	0.1189753943	0.6839332097	1.91781	0.77704	10	39	3	18	36	1	-0.97186	-1.47810
44	58150001	Fracture of clavicle	96	283371005	Laceration of forearm	1095	112	75	6	106	69	914	0.78214	-0.01994	0.74979	1.76855	0.31788	0.6921339014	1.0000000000	7.67123	-0.30888	55	39	3	57	36	3	0.07411	-0.03390
42	16114001	Fracture of ankle	96	283371005	Laceration of forearm	1095	108	75	6	102	69	918	0.81111	-0.01694	0.78261	1.84746	0.33152	0.6911787931	1.0000000000	7.39726	-0.26256	48	39	5	60	36	1	-1.43617	-1.75002
130	314994000	Metastasis from malignant tumor of prostate (disorder)	70	87433001	Pulmonary emphysema (disorder)	1095	1	17	0	1	17	1077	0.00000	-0.00380	0.00000	0.00000	0.00000	1.0000000000	1.0000000000	0.01553	-0.02223	0	9	0	1	8	0	0.00000	0.00000
129	47505003	Posttraumatic stress disorder	70	87433001	Pulmonary emphysema (disorder)	1095	4	17	0	4	17	1074	0.00000	-0.00760	0.00000	0.00000	0.00000	1.0000000000	1.0000000000	0.06210	-0.08692	1	9	0	3	8	0	0.00000	0.00000
15	40055000	Chronic sinusitis (disorder)	96	283371005	Laceration of forearm	1095	216	75	16	200	59	820	1.08148	0.01095	1.11186	1.97330	0.62649	0.7634630173	1.0000000000	14.79452	0.10611	104	39	6	112	36	10	0.48885	0.40728
125	1734006	Fracture of the vertebral column with spinal cord injury	70	87433001	Pulmonary emphysema (disorder)	1095	5	17	0	5	17	1073	0.00000	-0.00851	0.00000	0.00000	0.00000	1.0000000000	1.0000000000	0.07763	-0.10786	3	9	0	2	8	0	0.00000	0.00000
124	1501000119109	Proliferative diabetic retinopathy due to type II diabetes mellitus (disorder)	70	87433001	Pulmonary emphysema (disorder)	1095	1	17	0	1	17	1077	0.00000	-0.00380	0.00000	0.00000	0.00000	1.0000000000	1.0000000000	0.01553	-0.02223	1	9	0	0	8	0	0.00000	0.00000
118	48333001	Burn injury(morphologic abnormality)	20	80394007	Hyperglycemia (disorder)	1095	1	55	0	1	55	1039	0.00000	-0.00695	0.00000	0.00000	0.00000	1.0000000000	1.0000000000	0.05023	-0.07070	0	23	0	1	32	0	0.00000	0.00000
118	48333001	Burn injury(morphologic abnormality)	70	87433001	Pulmonary emphysema (disorder)	1095	1	17	0	1	17	1077	0.00000	-0.00380	0.00000	0.00000	0.00000	1.0000000000	1.0000000000	0.01553	-0.02223	0	9	0	1	8	0	0.00000	0.00000
117	230265002	Familial Alzheimer's disease of early onset (disorder)	70	87433001	Pulmonary emphysema (disorder)	1095	6	17	0	6	17	1072	0.00000	-0.00932	0.00000	0.00000	0.00000	1.0000000000	1.0000000000	0.09315	-0.12849	2	9	0	4	8	0	0.00000	0.00000
115	36923009	Major depression  single episode	70	87433001	Pulmonary emphysema (disorder)	1095	6	17	0	6	17	1072	0.00000	-0.00932	0.00000	0.00000	0.00000	1.0000000000	1.0000000000	0.09315	-0.12849	3	9	0	3	8	0	0.00000	0.00000
114	449868002	Smokes tobacco daily	70	87433001	Pulmonary emphysema (disorder)	1095	9	17	0	9	17	1069	0.00000	-0.01143	0.00000	0.00000	0.00000	1.0000000000	1.0000000000	0.13973	-0.18869	2	9	0	7	8	0	0.00000	0.00000
111	235919008	Cholelithiasis	70	87433001	Pulmonary emphysema (disorder)	1095	9	17	0	9	17	1069	0.00000	-0.01143	0.00000	0.00000	0.00000	1.0000000000	1.0000000000	0.13973	-0.18869	7	9	0	2	8	0	0.00000	0.00000
109	90560007	Gout	70	87433001	Pulmonary emphysema (disorder)	1095	4	17	0	4	17	1074	0.00000	-0.00760	0.00000	0.00000	0.00000	1.0000000000	1.0000000000	0.06210	-0.08692	0	9	0	4	8	0	0.00000	0.00000
107	40275004	Contact dermatitis	70	87433001	Pulmonary emphysema (disorder)	1095	18	17	0	18	17	1060	0.00000	-0.01623	0.00000	0.00000	0.00000	1.0000000000	1.0000000000	0.27945	-0.35553	9	9	0	9	8	0	0.00000	0.00000
106	24079001	Atopic dermatitis	70	87433001	Pulmonary emphysema (disorder)	1095	20	17	0	20	17	1058	0.00000	-0.01713	0.00000	0.00000	0.00000	1.0000000000	1.0000000000	0.31050	-0.39012	13	9	0	7	8	0	0.00000	0.00000
102	90781000119102	Microalbuminuria due to type 2 diabetes mellitus (disorder)	70	87433001	Pulmonary emphysema (disorder)	1095	6	17	0	6	17	1072	0.00000	-0.00932	0.00000	0.00000	0.00000	1.0000000000	1.0000000000	0.09315	-0.12849	3	9	0	3	8	0	0.00000	0.00000
98	1551000119108	Nonproliferative diabetic retinopathy due to type 2 diabetes mellitus (disorder)	70	87433001	Pulmonary emphysema (disorder)	1095	12	17	0	12	17	1066	0.00000	-0.01322	0.00000	0.00000	0.00000	1.0000000000	1.0000000000	0.18630	-0.24647	7	9	0	5	8	0	0.00000	0.00000
97	403192003	Third degree burn	70	87433001	Pulmonary emphysema (disorder)	1095	8	17	0	8	17	1070	0.00000	-0.01077	0.00000	0.00000	0.00000	1.0000000000	1.0000000000	0.12420	-0.16890	3	9	0	5	8	0	0.00000	0.00000
96	283371005	Laceration of forearm	70	87433001	Pulmonary emphysema (disorder)	1095	75	17	0	75	17	1003	0.00000	-0.03405	0.00000	0.00000	0.00000	0.6233556917	1.0000000000	1.16438	-1.11396	39	9	0	36	8	0	0.00000	0.00000
94	703151001	History of single seizure (situation)	70	87433001	Pulmonary emphysema (disorder)	1095	39	17	0	39	17	1039	0.00000	-0.02413	0.00000	0.00000	0.00000	1.0000000000	1.0000000000	0.60548	-0.68300	14	9	0	25	8	0	0.00000	0.00000
93	128613002	Seizure disorder	70	87433001	Pulmonary emphysema (disorder)	1095	39	17	0	39	17	1039	0.00000	-0.02413	0.00000	0.00000	0.00000	1.0000000000	1.0000000000	0.60548	-0.68300	14	9	0	25	8	0	0.00000	0.00000
89	47693006	Rupture of appendix	70	87433001	Pulmonary emphysema (disorder)	1095	20	17	0	20	17	1058	0.00000	-0.01713	0.00000	0.00000	0.00000	1.0000000000	1.0000000000	0.31050	-0.39012	10	9	0	10	8	0	0.00000	0.00000
86	713197008	Recurrent rectal polyp	70	87433001	Pulmonary emphysema (disorder)	1095	22	17	1	21	16	1057	2.92781	0.03466	3.14583	24.82924	0.39857	0.2936207183	0.9796285312	0.34155	0.57610	12	9	1	10	8	0	2.30259	2.56495
82	94260004	Secondary malignant neoplasm of colon	70	87433001	Pulmonary emphysema (disorder)	1095	4	17	0	4	17	1074	0.00000	-0.00760	0.00000	0.00000	0.00000	1.0000000000	1.0000000000	0.06210	-0.08692	2	9	0	2	8	0	0.00000	0.00000
78	239872002	Osteoarthritis of hip	70	87433001	Pulmonary emphysema (disorder)	1095	21	17	0	21	17	1057	0.00000	-0.01756	0.00000	0.00000	0.00000	1.0000000000	1.0000000000	0.32603	-0.40711	13	9	0	8	8	0	0.00000	0.00000
76	127013003	Diabetic renal disease (disorder)	70	87433001	Pulmonary emphysema (disorder)	1095	28	17	0	28	17	1050	0.00000	-0.02034	0.00000	0.00000	0.00000	1.0000000000	1.0000000000	0.43470	-0.52075	10	9	0	18	8	0	0.00000	0.00000
75	431855005	Chronic kidney disease stage 1 (disorder)	70	87433001	Pulmonary emphysema (disorder)	1095	28	17	0	28	17	1050	0.00000	-0.02034	0.00000	0.00000	0.00000	1.0000000000	1.0000000000	0.43470	-0.52075	10	9	0	18	8	0	0.00000	0.00000
72	35999006	Blighted ovum	70	87433001	Pulmonary emphysema (disorder)	1095	53	17	0	53	17	1025	0.00000	-0.02832	0.00000	0.00000	0.00000	1.0000000000	1.0000000000	0.82283	-0.86618	53	9	0	0	8	0	0.00000	0.00000
71	201834006	Localized  primary osteoarthritis of the hand	70	87433001	Pulmonary emphysema (disorder)	1095	28	17	1	27	16	1051	2.30042	0.02645	2.43287	19.01367	0.31129	0.3583103201	1.0000000000	0.43470	0.47925	19	9	0	9	8	1	-2.19722	-2.30259
69	233604007	Pneumonia	70	87433001	Pulmonary emphysema (disorder)	1095	7	17	0	7	17	1071	0.00000	-0.01007	0.00000	0.00000	0.00000	1.0000000000	1.0000000000	0.10868	-0.14884	3	9	0	4	8	0	0.00000	0.00000
67	403191005	Second degree burn	70	87433001	Pulmonary emphysema (disorder)	1095	49	17	3	46	14	1032	3.94358	0.08001	4.80745	17.31576	1.33472	0.0367948388	0.3602444677	0.76073	1.18383	23	9	2	26	8	1	-0.49248	-0.77011
64	444448004	Injury of medial collateral ligament of knee	70	87433001	Pulmonary emphysema (disorder)	1095	32	17	0	32	17	1046	0.00000	-0.02179	0.00000	0.00000	0.00000	1.0000000000	1.0000000000	0.49680	-0.58188	17	9	0	15	8	0	0.00000	0.00000
63	68496003	Polyp of colon	70	87433001	Pulmonary emphysema (disorder)	1095	91	17	3	88	14	990	2.12346	0.04247	2.41071	8.54877	0.67981	0.1617721866	0.7862880696	1.41279	0.72930	43	9	1	48	8	2	0.69315	0.56531
59	262574004	Bullet wound	70	87433001	Pulmonary emphysema (disorder)	1095	20	17	0	20	17	1058	0.00000	-0.01713	0.00000	0.00000	0.00000	1.0000000000	1.0000000000	0.31050	-0.39012	9	9	0	11	8	0	0.00000	0.00000
58	239720000	Tear of meniscus of knee	70	87433001	Pulmonary emphysema (disorder)	1095	20	17	0	20	17	1058	0.00000	-0.01713	0.00000	0.00000	0.00000	1.0000000000	1.0000000000	0.31050	-0.39012	10	9	0	10	8	0	0.00000	0.00000
57	192127007	Child attention deficit disorder	70	87433001	Pulmonary emphysema (disorder)	1095	76	17	1	75	16	1003	0.84752	-0.00523	0.83583	6.38876	0.10935	1.0000000000	1.0000000000	1.17991	-0.12427	24	9	0	52	8	1	-2.19722	-3.97029
56	92691004	Carcinoma in situ of prostate (disorder)	70	87433001	Pulmonary emphysema (disorder)	1095	23	17	0	23	17	1055	0.00000	-0.01839	0.00000	0.00000	0.00000	1.0000000000	1.0000000000	0.35708	-0.44050	0	9	0	23	8	0	0.00000	0.00000
54	5602001	Opioid abuse (disorder)	70	87433001	Pulmonary emphysema (disorder)	1095	7	17	0	7	17	1071	0.00000	-0.01007	0.00000	0.00000	0.00000	1.0000000000	1.0000000000	0.10868	-0.14884	0	9	0	7	8	0	0.00000	0.00000
52	124171000119105	Chronic intractable migraine without aura	70	87433001	Pulmonary emphysema (disorder)	1095	51	17	1	50	16	1028	1.26298	0.00730	1.28500	9.88371	0.16707	0.5582200231	1.0000000000	0.79178	0.15861	21	9	0	30	8	1	-2.19722	-3.43399
50	446096008	Perennial allergic rhinitis	70	87433001	Pulmonary emphysema (disorder)	1095	26	17	0	26	17	1052	0.00000	-0.01958	0.00000	0.00000	0.00000	1.0000000000	1.0000000000	0.40365	-0.48919	14	9	0	12	8	0	0.00000	0.00000
49	88805009	Chronic congestive heart failure (disorder)	70	87433001	Pulmonary emphysema (disorder)	1095	10	17	0	10	17	1068	0.00000	-0.01206	0.00000	0.00000	0.00000	1.0000000000	1.0000000000	0.15525	-0.20821	5	9	0	5	8	0	0.00000	0.00000
47	359817006	Closed fracture of hip	70	87433001	Pulmonary emphysema (disorder)	1095	29	17	1	28	16	1050	2.22110	0.02529	2.34375	18.29455	0.30026	0.3685340544	1.0000000000	0.45023	0.46372	11	9	0	18	8	1	-2.19722	-2.94444
45	263102004	Fracture subluxation of wrist	70	87433001	Pulmonary emphysema (disorder)	1095	109	17	0	109	17	969	0.00000	-0.04175	0.00000	0.00000	0.00000	0.4010905581	1.0000000000	1.69224	-1.42881	51	9	0	58	8	0	0.00000	0.00000
44	58150001	Fracture of clavicle	70	87433001	Pulmonary emphysema (disorder)	1095	112	17	4	108	13	970	2.30042	0.05512	2.76353	8.62499	0.88546	0.0866873797	0.5823623432	1.73881	0.86838	55	9	3	57	8	1	-0.81093	-1.09861
43	307731004	Injury of tendon of the rotator cuff of shoulder	70	87433001	Pulmonary emphysema (disorder)	1095	51	17	1	50	16	1028	1.26298	0.00730	1.28500	9.88371	0.16707	0.5582200231	1.0000000000	0.79178	0.15861	26	9	0	25	8	1	-2.19722	-3.25810
42	16114001	Fracture of ankle	70	87433001	Pulmonary emphysema (disorder)	1095	108	17	4	104	13	974	2.38562	0.05756	2.88166	8.99899	0.92276	0.0778085719	0.5519212949	1.67671	0.90147	48	9	2	60	8	2	0.09531	-0.21511
41	283385000	Laceration of thigh	70	87433001	Pulmonary emphysema (disorder)	1095	105	17	2	103	15	975	1.22689	0.00928	1.26214	5.59640	0.28465	0.6741217213	1.0000000000	1.63014	0.18982	50	9	1	55	8	1	0.10536	-0.09353
39	74400008	Appendicitis	70	87433001	Pulmonary emphysema (disorder)	1095	51	17	0	51	17	1027	0.00000	-0.02776	0.00000	0.00000	0.00000	1.0000000000	1.0000000000	0.79178	-0.84139	27	9	0	24	8	0	0.00000	0.00000
38	398254007	Preeclampsia	70	87433001	Pulmonary emphysema (disorder)	1095	101	17	2	99	15	979	1.27548	0.01103	1.31852	5.84933	0.29721	0.6654811492	1.0000000000	1.56804	0.22430	101	9	2	0	8	0	1.70475	3.94158
35	19169002	Miscarriage in first trimester	70	87433001	Pulmonary emphysema (disorder)	1095	174	17	2	172	15	906	0.74037	-0.01417	0.70233	3.09884	0.15918	1.0000000000	1.0000000000	2.70137	-0.30310	174	9	2	0	8	0	1.70475	4.47734
33	429007001	History of cardiac arrest (situation)	70	87433001	Pulmonary emphysema (disorder)	1095	42	17	1	41	16	1037	1.53361	0.01338	1.58079	12.20904	0.20468	0.4882374054	1.0000000000	0.65205	0.27574	24	9	1	18	8	0	2.30259	3.21888
32	410429000	Cardiac Arrest	70	87433001	Pulmonary emphysema (disorder)	1095	42	17	1	41	16	1037	1.53361	0.01338	1.58079	12.20904	0.20468	0.4882374054	1.0000000000	0.65205	0.27574	24	9	1	18	8	0	2.30259	3.21888
30	399211009	History of myocardial infarction (situation)	70	87433001	Pulmonary emphysema (disorder)	1095	31	17	1	30	16	1048	2.07780	0.02310	2.18333	17.00452	0.28033	0.3885233286	1.0000000000	0.48128	0.43316	2	9	0	29	8	1	-2.19722	-3.40120
29	22298006	Myocardial Infarction	70	87433001	Pulmonary emphysema (disorder)	1095	31	17	1	30	16	1048	2.07780	0.02310	2.18333	17.00452	0.28033	0.3885233286	1.0000000000	0.48128	0.43316	2	9	0	29	8	1	-2.19722	-3.40120
27	408512008	Body mass index 40+ - severely obese (finding)	70	87433001	Pulmonary emphysema (disorder)	1095	97	17	5	92	12	986	3.32019	0.09084	4.46558	12.95297	1.53952	0.0128838070	0.1830000940	1.50594	1.25961	67	9	4	30	8	1	-1.01857	-0.55760
24	162864005	Body mass index 30+ - obesity (finding)	70	87433001	Pulmonary emphysema (disorder)	1095	439	17	13	426	4	652	1.90741	0.09322	4.97418	15.35661	1.61119	0.0043308793	0.0814056931	6.81553	0.84101	226	9	8	213	8	5	-0.20174	-0.39918
23	36971009	Sinusitis (disorder)	70	87433001	Pulmonary emphysema (disorder)	1095	190	17	1	189	16	889	0.33901	-0.03803	0.29398	2.23031	0.03875	0.3337402855	1.0000000000	2.94977	-0.98177	84	9	0	106	8	1	-2.19722	-4.67283
21	15777000	Prediabetes	70	87433001	Pulmonary emphysema (disorder)	1095	333	17	4	329	13	749	0.77371	-0.01879	0.70049	2.16442	0.22671	0.7908315801	1.0000000000	5.16986	-0.30331	159	9	0	174	8	4	-1.09861	-3.79549
20	80394007	Hyperglycemia (disorder)	70	87433001	Pulmonary emphysema (disorder)	1095	55	17	0	55	17	1023	0.00000	-0.02888	0.00000	0.00000	0.00000	1.0000000000	1.0000000000	0.85388	-0.89055	23	9	0	32	8	0	0.00000	0.00000
19	237602007	Metabolic syndrome X (disorder)	70	87433001	Pulmonary emphysema (disorder)	1095	64	17	0	64	17	1014	0.00000	-0.03129	0.00000	0.00000	0.00000	0.6179354873	1.0000000000	0.99361	-0.99538	28	9	0	36	8	0	0.00000	0.00000
18	302870006	Hypertriglyceridemia (disorder)	70	87433001	Pulmonary emphysema (disorder)	1095	64	17	0	64	17	1014	0.00000	-0.03129	0.00000	0.00000	0.00000	0.6179354873	1.0000000000	0.99361	-0.99538	28	9	0	36	8	0	0.00000	0.00000
17	368581000119106	Neuropathy due to type 2 diabetes mellitus (disorder)	70	87433001	Pulmonary emphysema (disorder)	1095	28	17	0	28	17	1050	0.00000	-0.02034	0.00000	0.00000	0.00000	1.0000000000	1.0000000000	0.43470	-0.52075	7	9	0	21	8	0	0.00000	0.00000
15	40055000	Chronic sinusitis (disorder)	70	87433001	Pulmonary emphysema (disorder)	1095	216	17	2	214	15	864	0.59641	-0.02512	0.53832	2.37186	0.12218	0.5488185329	1.0000000000	3.35342	-0.53719	104	9	2	112	8	0	1.70475	3.97029
14	10509002	Acute bronchitis (disorder)	70	87433001	Pulmonary emphysema (disorder)	1095	863	17	15	848	2	230	1.11956	0.02896	2.03420	8.95927	0.46186	0.5490951579	1.0000000000	13.39817	0.15219	418	9	9	445	8	6	-0.15415	-0.46015
13	370247008	Facial laceration	70	87433001	Pulmonary emphysema (disorder)	1095	109	17	2	107	15	971	1.18187	0.00759	1.20997	5.36260	0.27301	0.6830838866	1.0000000000	1.69224	0.15616	55	9	1	54	8	1	0.10536	0.01802
10	62106007	Concussion with no loss of consciousness	70	87433001	Pulmonary emphysema (disorder)	1095	206	17	0	206	17	872	0.00000	-0.06045	0.00000	0.00000	0.00000	0.0547438973	0.4520620234	3.19817	-2.06976	96	9	0	110	8	0	0.00000	0.00000
7	75498004	Acute bacterial sinusitis (disorder)	70	87433001	Pulmonary emphysema (disorder)	1095	187	17	3	184	14	894	1.03334	0.00190	1.04115	3.65950	0.29621	1.0000000000	1.0000000000	2.90320	0.03534	89	9	1	98	8	2	0.69315	0.58779
6	39848009	Whiplash injury to neck	70	87433001	Pulmonary emphysema (disorder)	1095	182	17	4	178	13	900	1.41564	0.02330	1.55575	4.82632	0.50149	0.5061648852	1.0000000000	2.82557	0.38625	92	9	1	90	8	3	1.00330	1.09861
5	284549007	Laceration of hand	70	87433001	Pulmonary emphysema (disorder)	1095	104	17	3	101	14	977	1.85803	0.03491	2.07284	7.33447	0.58582	0.2140283402	0.8672161313	1.61461	0.61340	54	9	2	50	8	1	-0.49248	-0.59962
1	444814009	Viral sinusitis (disorder)	70	87433001	Pulmonary emphysema (disorder)	1095	993	17	17	976	0	102	1.10272	0.04025	0.00000	0.00000	0.00000	0.3929919309	1.0000000000	15.41644	0.13286	478	9	9	515	8	8	0.00000	-0.18910
114	449868002	Smokes tobacco daily	22	70704007	Sprain of wrist	1095	9	195	3	6	192	894	1.87179	0.03694	2.32812	9.39060	0.57719	0.2050681363	0.8535268376	1.60274	0.61997	2	90	0	7	105	3	-3.58352	-1.20397
75	431855005	Chronic kidney disease stage 1 (disorder)	44	58150001	Fracture of clavicle	1095	28	112	3	25	109	958	1.04751	0.00260	1.05468	3.55045	0.31330	0.7594661643	1.0000000000	2.86393	0.04993	10	55	1	18	57	2	0.64096	0.09531
42	16114001	Fracture of ankle	44	58150001	Fracture of clavicle	1095	108	112	10	98	102	885	0.90526	-0.01058	0.88535	1.75137	0.44757	0.8673876709	1.0000000000	11.04658	-0.13112	48	55	6	60	57	4	-0.40547	-0.57536
15	40055000	Chronic sinusitis (disorder)	44	58150001	Fracture of clavicle	1095	216	112	28	188	84	795	1.26736	0.04474	1.40957	2.22458	0.89316	0.1670944068	0.7942848378	22.09315	0.32859	104	55	18	112	57	10	-0.50202	-0.58779
125	1734006	Fracture of the vertebral column with spinal cord injury	18	302870006	Hypertriglyceridemia (disorder)	1095	5	64	0	5	64	1026	0.00000	-0.01687	0.00000	0.00000	0.00000	1.0000000000	1.0000000000	0.29224	-0.36987	3	28	0	2	36	0	0.00000	0.00000
118	48333001	Burn injury(morphologic abnormality)	18	302870006	Hypertriglyceridemia (disorder)	1095	1	64	0	1	64	1030	0.00000	-0.00753	0.00000	0.00000	0.00000	1.0000000000	1.0000000000	0.05845	-0.08195	0	28	0	1	36	0	0.00000	0.00000
117	230265002	Familial Alzheimer's disease of early onset (disorder)	18	302870006	Hypertriglyceridemia (disorder)	1095	6	64	2	4	62	1027	5.70312	0.08698	8.28226	46.09666	1.48809	0.0433161433	0.3987203055	0.35068	1.15127	2	28	2	4	36	0	2.70805	0.69315
109	90560007	Gout	18	302870006	Hypertriglyceridemia (disorder)	1095	4	64	0	4	64	1027	0.00000	-0.01509	0.00000	0.00000	0.00000	1.0000000000	1.0000000000	0.23379	-0.30310	0	28	0	4	36	0	0.00000	0.00000
97	403192003	Third degree burn	18	302870006	Hypertriglyceridemia (disorder)	1095	8	64	1	7	63	1024	2.13867	0.02434	2.32200	19.16544	0.28132	0.3833144949	1.0000000000	0.46758	0.44656	3	28	0	5	36	1	-3.61092	-1.79176
96	283371005	Laceration of forearm	18	302870006	Hypertriglyceridemia (disorder)	1095	75	64	5	70	59	961	1.14062	0.00950	1.16344	2.99213	0.45238	0.7966432752	1.0000000000	4.38356	0.15640	39	28	4	36	36	1	-1.53148	-1.23601
94	703151001	History of single seizure (situation)	18	302870006	Hypertriglyceridemia (disorder)	1095	39	64	2	37	62	994	0.87740	-0.00587	0.86661	3.67902	0.20413	1.0000000000	1.0000000000	2.27945	-0.12849	14	28	0	25	36	2	-2.94444	-2.60269
93	128613002	Seizure disorder	18	302870006	Hypertriglyceridemia (disorder)	1095	39	64	2	37	62	994	0.87740	-0.00587	0.86661	3.67902	0.20413	1.0000000000	1.0000000000	2.27945	-0.12849	14	28	0	25	36	2	-2.94444	-2.60269
89	47693006	Rupture of appendix	18	302870006	Hypertriglyceridemia (disorder)	1095	20	64	0	20	64	1011	0.00000	-0.03398	0.00000	0.00000	0.00000	0.6248676804	1.0000000000	1.16895	-1.11700	10	28	0	10	36	0	0.00000	0.00000
86	713197008	Recurrent rectal polyp	18	302870006	Hypertriglyceridemia (disorder)	1095	22	64	2	20	62	1011	1.55540	0.01981	1.63065	7.13472	0.37269	0.3720143327	1.0000000000	1.28584	0.39224	12	28	1	10	36	1	-0.24362	0.16705
128	86849004	Suicidal deliberate poisoning	91	64859006	Osteoporosis (disorder)	1095	1	37	0	1	37	1057	0.00000	-0.00565	0.00000	0.00000	0.00000	1.0000000000	1.0000000000	0.03379	-0.04794	0	24	0	1	13	0	0.00000	0.00000
75	431855005	Chronic kidney disease stage 1 (disorder)	18	302870006	Hypertriglyceridemia (disorder)	1095	28	64	28	0	36	1031	17.10937	0.65018	0.00000	0.00000	0.00000	0.0000000000	0.0000000000	1.63653	3.45934	10	28	10	18	36	18	0.23639	0.00000
69	233604007	Pneumonia	18	302870006	Hypertriglyceridemia (disorder)	1095	7	64	0	7	64	1024	0.00000	-0.01998	0.00000	0.00000	0.00000	1.0000000000	1.0000000000	0.40913	-0.49481	3	28	0	4	36	0	0.00000	0.00000
64	444448004	Injury of medial collateral ligament of knee	18	302870006	Hypertriglyceridemia (disorder)	1095	32	64	3	29	61	1002	1.60400	0.02611	1.69927	5.73536	0.50346	0.4277586209	1.0000000000	1.87032	0.47879	17	28	2	15	36	1	-0.90287	-0.52130
49	88805009	Chronic congestive heart failure (disorder)	18	302870006	Hypertriglyceridemia (disorder)	1095	10	64	0	10	64	1021	0.00000	-0.02392	0.00000	0.00000	0.00000	1.0000000000	1.0000000000	0.58447	-0.66400	5	28	0	5	36	0	0.00000	0.00000
47	359817006	Closed fracture of hip	18	302870006	Hypertriglyceridemia (disorder)	1095	29	64	0	29	64	1002	0.00000	-0.04109	0.00000	0.00000	0.00000	0.4078952467	1.0000000000	1.69498	-1.43027	11	28	0	18	36	0	0.00000	0.00000
44	58150001	Fracture of clavicle	18	302870006	Hypertriglyceridemia (disorder)	1095	112	64	9	103	55	928	1.37486	0.03153	1.47432	3.07023	0.70796	0.2879641576	0.9712041902	6.54612	0.40619	55	28	4	57	36	5	-0.02469	0.17355
43	307731004	Injury of tendon of the rotator cuff of shoulder	18	302870006	Hypertriglyceridemia (disorder)	1095	51	64	8	43	56	988	2.68382	0.09272	3.28239	7.31425	1.47303	0.0074735505	0.1247202016	2.98082	1.17686	26	28	3	25	36	5	0.23124	0.47692
42	16114001	Fracture of ankle	18	302870006	Hypertriglyceridemia (disorder)	1095	108	64	4	104	60	927	0.63368	-0.03019	0.59423	1.66817	0.21167	0.3930397225	1.0000000000	6.31233	-0.54840	48	28	1	60	36	3	0.80235	0.84730
41	283385000	Laceration of thigh	18	302870006	Hypertriglyceridemia (disorder)	1095	105	64	9	96	55	935	1.46652	0.03785	1.59375	3.32503	0.76391	0.1939583559	0.8321439142	6.13699	0.48661	50	28	5	55	36	4	-0.41552	-0.29335
39	74400008	Appendicitis	18	302870006	Hypertriglyceridemia (disorder)	1095	51	64	1	50	63	981	0.33548	-0.03659	0.31143	2.29150	0.04232	0.3580233069	1.0000000000	2.98082	-0.99307	27	28	0	24	36	1	-3.61092	-3.21888
38	398254007	Preeclampsia	18	302870006	Hypertriglyceridemia (disorder)	1095	101	64	11	90	53	941	1.86340	0.06857	2.17002	4.30245	1.09449	0.0405687125	0.3849833570	5.90320	0.79770	101	28	11	0	36	0	1.26567	2.32060
35	19169002	Miscarriage in first trimester	18	302870006	Hypertriglyceridemia (disorder)	1095	174	64	15	159	49	872	1.47495	0.05143	1.67886	3.06688	0.91904	0.1103653826	0.6550286197	10.16986	0.51846	174	28	15	0	36	0	1.05315	2.53370
33	429007001	History of cardiac arrest (situation)	18	302870006	Hypertriglyceridemia (disorder)	1095	42	64	2	40	62	991	0.81473	-0.00922	0.79919	3.38371	0.18876	1.0000000000	1.0000000000	2.45479	-0.20364	24	28	2	18	36	0	2.70805	2.56495
32	410429000	Cardiac Arrest	18	302870006	Hypertriglyceridemia (disorder)	1095	42	64	2	40	62	991	0.81473	-0.00922	0.79919	3.38371	0.18876	1.0000000000	1.0000000000	2.45479	-0.20364	24	28	2	18	36	0	2.70805	2.56495
27	408512008	Body mass index 40+ - severely obese (finding)	18	302870006	Hypertriglyceridemia (disorder)	1095	97	64	5	92	59	939	0.88193	-0.00917	0.86496	2.20916	0.33866	1.0000000000	1.0000000000	5.66941	-0.15260	67	28	4	30	36	1	-1.53148	-0.55760
21	15777000	Prediabetes	18	302870006	Hypertriglyceridemia (disorder)	1095	333	64	38	295	26	736	1.95242	0.15687	3.64641	6.11377	2.17482	0.0000008797	0.0000441265	19.46301	0.93046	159	28	14	174	36	24	0.18232	0.40402
15	40055000	Chronic sinusitis (disorder)	18	302870006	Hypertriglyceridemia (disorder)	1095	216	64	14	202	50	829	1.10894	0.01346	1.14911	2.11966	0.62296	0.6292558955	1.0000000000	12.62466	0.13874	104	28	6	112	36	8	0.02985	0.20067
14	10509002	Acute bronchitis (disorder)	18	302870006	Hypertriglyceridemia (disorder)	1095	863	64	58	805	6	226	1.14988	0.07202	2.71387	6.37096	1.15604	0.0171074362	0.2232466162	50.44018	0.19782	418	28	23	445	36	35	0.08900	0.33511
118	48333001	Burn injury(morphologic abnormality)	36	156073000	Fetus with unknown complication	1095	1	125	0	1	125	969	0.00000	-0.01085	0.00000	0.00000	0.00000	1.0000000000	1.0000000000	0.11416	-0.15595	0	125	0	1	0	0	0.00000	0.00000
119	275272006	Brain damage - traumatic	36	156073000	Fetus with unknown complication	1095	4	125	0	4	125	966	0.00000	-0.02174	0.00000	0.00000	0.00000	1.0000000000	1.0000000000	0.45662	-0.54263	0	125	0	4	0	0	0.00000	0.00000
120	162573006	Suspected lung cancer (situation)	36	156073000	Fetus with unknown complication	1095	8	125	0	8	125	962	0.00000	-0.03080	0.00000	0.00000	0.00000	0.6075389592	1.0000000000	0.91324	-0.93602	0	125	0	8	0	0	0.00000	0.00000
121	254637007	Non-small cell lung cancer (disorder)	36	156073000	Fetus with unknown complication	1095	8	125	0	8	125	962	0.00000	-0.03080	0.00000	0.00000	0.00000	0.6075389592	1.0000000000	0.91324	-0.93602	0	125	0	8	0	0	0.00000	0.00000
123	195967001	Asthma	36	156073000	Fetus with unknown complication	1095	2	125	1	1	124	969	4.38000	0.05190	7.81452	125.72417	0.48572	0.2153715159	0.8672161313	0.22831	0.70332	1	125	1	1	0	0	4.83628	0.69315
126	698754002	Chronic paralysis due to lesion of spinal cord	36	156073000	Fetus with unknown complication	1095	2	125	1	1	124	969	4.38000	0.05190	7.81452	125.72417	0.48572	0.2153715159	0.8672161313	0.22831	0.70332	2	125	1	0	0	0	4.83628	1.09861
127	431856006	Chronic kidney disease stage 2 (disorder)	36	156073000	Fetus with unknown complication	1095	5	125	1	4	124	966	1.75200	0.01828	1.94758	17.56413	0.21596	0.4551518545	1.0000000000	0.57078	0.34852	3	125	1	2	0	0	4.83628	1.38629
128	86849004	Suicidal deliberate poisoning	36	156073000	Fetus with unknown complication	1095	1	125	0	1	125	969	0.00000	-0.01085	0.00000	0.00000	0.00000	1.0000000000	1.0000000000	0.11416	-0.15595	0	125	0	1	0	0	0.00000	0.00000
130	314994000	Metastasis from malignant tumor of prostate (disorder)	36	156073000	Fetus with unknown complication	1095	1	125	0	1	125	969	0.00000	-0.01085	0.00000	0.00000	0.00000	1.0000000000	1.0000000000	0.11416	-0.15595	0	125	0	1	0	0	0.00000	0.00000
131	93761005	Primary malignant neoplasm of colon	36	156073000	Fetus with unknown complication	1095	5	125	2	3	123	967	3.50400	0.06088	5.24119	31.67591	0.86722	0.1026362324	0.6300285649	0.57078	0.93348	3	125	2	2	0	0	4.15104	0.91629
132	69896004	Rheumatoid arthritis	36	156073000	Fetus with unknown complication	1095	3	125	0	3	125	967	0.00000	-0.01882	0.00000	0.00000	0.00000	1.0000000000	1.0000000000	0.34247	-0.42489	2	125	0	1	0	0	0.00000	0.00000
114	449868002	Smokes tobacco daily	25	284551006	Laceration of foot	1095	9	118	3	6	115	971	3.09322	0.06622	4.22174	17.10835	1.04178	0.0631312162	0.4891136942	0.96986	1.02190	2	53	1	7	65	2	0.47744	-0.40547
114	449868002	Smokes tobacco daily	26	33737001	Fracture of rib	1095	9	54	1	8	53	1033	2.25309	0.02598	2.43632	19.83790	0.29921	0.3667358794	1.0000000000	0.44384	0.47009	2	32	0	7	22	1	-3.13549	-2.07944
118	48333001	Burn injury(morphologic abnormality)	27	408512008	Body mass index 40+ - severely obese (finding)	1095	1	97	0	1	97	997	0.00000	-0.00943	0.00000	0.00000	0.00000	1.0000000000	1.0000000000	0.08858	-0.12245	0	67	0	1	30	0	0.00000	0.00000
118	48333001	Burn injury(morphologic abnormality)	28	53741008	Coronary Heart Disease	1095	1	80	0	1	80	1014	0.00000	-0.00849	0.00000	0.00000	0.00000	1.0000000000	1.0000000000	0.07306	-0.10173	0	24	0	1	56	0	0.00000	0.00000
116	370143000	Major depression disorder	90	444470001	Injury of anterior cruciate ligament	1095	8	19	1	7	18	1069	7.20395	0.07072	8.48413	72.57709	0.99178	0.1310631548	0.7119259731	0.13881	0.81247	3	10	1	5	9	0	2.39790	1.38629
118	48333001	Burn injury(morphologic abnormality)	90	444470001	Injury of anterior cruciate ligament	1095	1	19	0	1	19	1075	0.00000	-0.00402	0.00000	0.00000	0.00000	1.0000000000	1.0000000000	0.01735	-0.02482	0	10	0	1	9	0	0.00000	0.00000
119	275272006	Brain damage - traumatic	90	444470001	Injury of anterior cruciate ligament	1095	4	19	0	4	19	1072	0.00000	-0.00805	0.00000	0.00000	0.00000	1.0000000000	1.0000000000	0.06941	-0.09681	0	10	0	4	9	0	0.00000	0.00000
121	254637007	Non-small cell lung cancer (disorder)	90	444470001	Injury of anterior cruciate ligament	1095	8	19	1	7	18	1069	7.20395	0.07072	8.48413	72.57709	0.99178	0.1310631548	0.7119259731	0.13881	0.81247	0	10	0	8	9	1	-2.30259	-2.19722
126	698754002	Chronic paralysis due to lesion of spinal cord	90	444470001	Injury of anterior cruciate ligament	1095	2	19	0	2	19	1074	0.00000	-0.00568	0.00000	0.00000	0.00000	1.0000000000	1.0000000000	0.03470	-0.04922	2	10	0	0	9	0	0.00000	0.00000
127	431856006	Chronic kidney disease stage 2 (disorder)	90	444470001	Injury of anterior cruciate ligament	1095	5	19	0	5	19	1071	0.00000	-0.00900	0.00000	0.00000	0.00000	1.0000000000	1.0000000000	0.08676	-0.12003	3	10	0	2	9	0	0.00000	0.00000
128	86849004	Suicidal deliberate poisoning	90	444470001	Injury of anterior cruciate ligament	1095	1	19	0	1	19	1075	0.00000	-0.00402	0.00000	0.00000	0.00000	1.0000000000	1.0000000000	0.01735	-0.02482	0	10	0	1	9	0	0.00000	0.00000
114	449868002	Smokes tobacco daily	29	22298006	Myocardial Infarction	1095	9	31	0	9	31	1055	0.00000	-0.01554	0.00000	0.00000	0.00000	1.0000000000	1.0000000000	0.25479	-0.32745	2	2	0	7	29	0	0.00000	0.00000
118	48333001	Burn injury(morphologic abnormality)	100	161622006	History of lower limb amputation (situation)	1095	1	1	0	1	1	1093	0.00000	-0.00091	0.00000	0.00000	0.00000	1.0000000000	1.0000000000	0.00091	-0.00132	0	0	0	1	1	0	0.00000	0.00000
132	69896004	Rheumatoid arthritis	90	444470001	Injury of anterior cruciate ligament	1095	3	19	0	3	19	1073	0.00000	-0.00696	0.00000	0.00000	0.00000	1.0000000000	1.0000000000	0.05205	-0.07321	2	10	0	1	9	0	0.00000	0.00000
130	314994000	Metastasis from malignant tumor of prostate (disorder)	131	93761005	Primary malignant neoplasm of colon	1095	1	5	0	1	5	1089	0.00000	-0.00205	0.00000	0.00000	0.00000	1.0000000000	1.0000000000	0.00457	-0.00657	0	3	0	1	2	0	0.00000	0.00000
129	47505003	Posttraumatic stress disorder	131	93761005	Primary malignant neoplasm of colon	1095	4	5	0	4	5	1086	0.00000	-0.00410	0.00000	0.00000	0.00000	1.0000000000	1.0000000000	0.01826	-0.02611	1	3	0	3	2	0	0.00000	0.00000
128	86849004	Suicidal deliberate poisoning	131	93761005	Primary malignant neoplasm of colon	1095	1	5	0	1	5	1089	0.00000	-0.00205	0.00000	0.00000	0.00000	1.0000000000	1.0000000000	0.00457	-0.00657	0	3	0	1	2	0	0.00000	0.00000
127	431856006	Chronic kidney disease stage 2 (disorder)	131	93761005	Primary malignant neoplasm of colon	1095	5	5	0	5	5	1085	0.00000	-0.00459	0.00000	0.00000	0.00000	1.0000000000	1.0000000000	0.02283	-0.03257	3	3	0	2	2	0	0.00000	0.00000
125	1734006	Fracture of the vertebral column with spinal cord injury	131	93761005	Primary malignant neoplasm of colon	1095	5	5	0	5	5	1085	0.00000	-0.00459	0.00000	0.00000	0.00000	1.0000000000	1.0000000000	0.02283	-0.03257	3	3	0	2	2	0	0.00000	0.00000
124	1501000119109	Proliferative diabetic retinopathy due to type II diabetes mellitus (disorder)	131	93761005	Primary malignant neoplasm of colon	1095	1	5	0	1	5	1089	0.00000	-0.00205	0.00000	0.00000	0.00000	1.0000000000	1.0000000000	0.00457	-0.00657	1	3	0	0	2	0	0.00000	0.00000
121	254637007	Non-small cell lung cancer (disorder)	131	93761005	Primary malignant neoplasm of colon	1095	8	5	0	8	5	1082	0.00000	-0.00581	0.00000	0.00000	0.00000	1.0000000000	1.0000000000	0.03653	-0.05176	0	3	0	8	2	0	0.00000	0.00000
120	162573006	Suspected lung cancer (situation)	131	93761005	Primary malignant neoplasm of colon	1095	8	5	0	8	5	1082	0.00000	-0.00581	0.00000	0.00000	0.00000	1.0000000000	1.0000000000	0.03653	-0.05176	0	3	0	8	2	0	0.00000	0.00000
118	48333001	Burn injury(morphologic abnormality)	131	93761005	Primary malignant neoplasm of colon	1095	1	5	0	1	5	1089	0.00000	-0.00205	0.00000	0.00000	0.00000	1.0000000000	1.0000000000	0.00457	-0.00657	0	3	0	1	2	0	0.00000	0.00000
117	230265002	Familial Alzheimer's disease of early onset (disorder)	131	93761005	Primary malignant neoplasm of colon	1095	6	5	0	6	5	1084	0.00000	-0.00503	0.00000	0.00000	0.00000	1.0000000000	1.0000000000	0.02740	-0.03899	2	3	0	4	2	0	0.00000	0.00000
115	36923009	Major depression  single episode	131	93761005	Primary malignant neoplasm of colon	1095	6	5	0	6	5	1084	0.00000	-0.00503	0.00000	0.00000	0.00000	1.0000000000	1.0000000000	0.02740	-0.03899	3	3	0	3	2	0	0.00000	0.00000
114	449868002	Smokes tobacco daily	131	93761005	Primary malignant neoplasm of colon	1095	9	5	0	9	5	1081	0.00000	-0.00617	0.00000	0.00000	0.00000	1.0000000000	1.0000000000	0.04110	-0.05810	2	3	0	7	2	0	0.00000	0.00000
112	49436004	Atrial Fibrillation	131	93761005	Primary malignant neoplasm of colon	1095	35	5	0	35	5	1055	0.00000	-0.01231	0.00000	0.00000	0.00000	1.0000000000	1.0000000000	0.15982	-0.21390	9	3	0	26	2	0	0.00000	0.00000
111	235919008	Cholelithiasis	131	93761005	Primary malignant neoplasm of colon	1095	9	5	0	9	5	1081	0.00000	-0.00617	0.00000	0.00000	0.00000	1.0000000000	1.0000000000	0.04110	-0.05810	7	3	0	2	2	0	0.00000	0.00000
110	65275009	Acute Cholecystitis	131	93761005	Primary malignant neoplasm of colon	1095	9	5	0	9	5	1081	0.00000	-0.00617	0.00000	0.00000	0.00000	1.0000000000	1.0000000000	0.04110	-0.05810	7	3	0	2	2	0	0.00000	0.00000
109	90560007	Gout	131	93761005	Primary malignant neoplasm of colon	1095	4	5	0	4	5	1086	0.00000	-0.00410	0.00000	0.00000	0.00000	1.0000000000	1.0000000000	0.01826	-0.02611	0	3	0	4	2	0	0.00000	0.00000
108	40930008	Hypothyroidism (disorder)	131	93761005	Primary malignant neoplasm of colon	1095	13	5	1	12	4	1078	16.84615	0.11764	22.45833	216.07446	2.33427	0.0580715302	0.4685406893	0.05936	0.91681	11	3	1	2	2	0	1.38629	2.48491
107	40275004	Contact dermatitis	131	93761005	Primary malignant neoplasm of colon	1095	18	5	1	17	4	1073	12.16667	0.09777	15.77941	148.67768	1.67470	0.0796745113	0.5585774477	0.08219	0.88604	9	3	0	9	2	1	-1.09861	-2.30259
106	24079001	Atopic dermatitis	131	93761005	Primary malignant neoplasm of colon	1095	20	5	0	20	5	1070	0.00000	-0.00924	0.00000	0.00000	0.00000	1.0000000000	1.0000000000	0.09132	-0.12608	13	3	0	7	2	0	0.00000	0.00000
105	363406005	Malignant tumor of colon	131	93761005	Primary malignant neoplasm of colon	1095	6	5	0	6	5	1084	0.00000	-0.00503	0.00000	0.00000	0.00000	1.0000000000	1.0000000000	0.02740	-0.03899	4	3	0	2	2	0	0.00000	0.00000
104	367498001	Seasonal allergic rhinitis	131	93761005	Primary malignant neoplasm of colon	1095	20	5	0	20	5	1070	0.00000	-0.00924	0.00000	0.00000	0.00000	1.0000000000	1.0000000000	0.09132	-0.12608	9	3	0	11	2	0	0.00000	0.00000
102	90781000119102	Microalbuminuria due to type 2 diabetes mellitus (disorder)	131	93761005	Primary malignant neoplasm of colon	1095	6	5	0	6	5	1084	0.00000	-0.00503	0.00000	0.00000	0.00000	1.0000000000	1.0000000000	0.02740	-0.03899	3	3	0	3	2	0	0.00000	0.00000
101	433144002	Chronic kidney disease stage 3 (disorder)	131	93761005	Primary malignant neoplasm of colon	1095	3	5	0	3	5	1087	0.00000	-0.00355	0.00000	0.00000	0.00000	1.0000000000	1.0000000000	0.01370	-0.01963	1	3	0	2	2	0	0.00000	0.00000
100	161622006	History of lower limb amputation (situation)	131	93761005	Primary malignant neoplasm of colon	1095	1	5	0	1	5	1089	0.00000	-0.00205	0.00000	0.00000	0.00000	1.0000000000	1.0000000000	0.00457	-0.00657	0	3	0	1	2	0	0.00000	0.00000
99	30832001	Rupture of patellar tendon	131	93761005	Primary malignant neoplasm of colon	1095	23	5	0	23	5	1067	0.00000	-0.00992	0.00000	0.00000	0.00000	1.0000000000	1.0000000000	0.10502	-0.14408	14	3	0	9	2	0	0.00000	0.00000
98	1551000119108	Nonproliferative diabetic retinopathy due to type 2 diabetes mellitus (disorder)	131	93761005	Primary malignant neoplasm of colon	1095	12	5	0	12	5	1078	0.00000	-0.00713	0.00000	0.00000	0.00000	1.0000000000	1.0000000000	0.05479	-0.07696	7	3	0	5	2	0	0.00000	0.00000
97	403192003	Third degree burn	131	93761005	Primary malignant neoplasm of colon	1095	8	5	0	8	5	1082	0.00000	-0.00581	0.00000	0.00000	0.00000	1.0000000000	1.0000000000	0.03653	-0.05176	3	3	0	5	2	0	0.00000	0.00000
96	283371005	Laceration of forearm	131	93761005	Primary malignant neoplasm of colon	1095	75	5	0	75	5	1015	0.00000	-0.01837	0.00000	0.00000	0.00000	1.0000000000	1.0000000000	0.34247	-0.42489	39	3	0	36	2	0	0.00000	0.00000
95	84757009	Epilepsy	131	93761005	Primary malignant neoplasm of colon	1095	30	5	0	30	5	1060	0.00000	-0.01137	0.00000	0.00000	0.00000	1.0000000000	1.0000000000	0.13699	-0.18521	13	3	0	17	2	0	0.00000	0.00000
94	703151001	History of single seizure (situation)	131	93761005	Primary malignant neoplasm of colon	1095	39	5	0	39	5	1051	0.00000	-0.01302	0.00000	0.00000	0.00000	1.0000000000	1.0000000000	0.17808	-0.23644	14	3	0	25	2	0	0.00000	0.00000
93	128613002	Seizure disorder	131	93761005	Primary malignant neoplasm of colon	1095	39	5	0	39	5	1051	0.00000	-0.01302	0.00000	0.00000	0.00000	1.0000000000	1.0000000000	0.17808	-0.23644	14	3	0	25	2	0	0.00000	0.00000
89	47693006	Rupture of appendix	131	93761005	Primary malignant neoplasm of colon	1095	20	5	0	20	5	1070	0.00000	-0.00924	0.00000	0.00000	0.00000	1.0000000000	1.0000000000	0.09132	-0.12608	10	3	0	10	2	0	0.00000	0.00000
86	713197008	Recurrent rectal polyp	131	93761005	Primary malignant neoplasm of colon	1095	22	5	0	22	5	1068	0.00000	-0.00970	0.00000	0.00000	0.00000	1.0000000000	1.0000000000	0.10046	-0.13810	12	3	0	10	2	0	0.00000	0.00000
85	241929008	Acute allergic reaction	131	93761005	Primary malignant neoplasm of colon	1095	47	5	0	47	5	1043	0.00000	-0.01434	0.00000	0.00000	0.00000	1.0000000000	1.0000000000	0.21461	-0.28050	25	3	0	22	2	0	0.00000	0.00000
82	94260004	Secondary malignant neoplasm of colon	131	93761005	Primary malignant neoplasm of colon	1095	4	5	0	4	5	1086	0.00000	-0.00410	0.00000	0.00000	0.00000	1.0000000000	1.0000000000	0.01826	-0.02611	2	3	0	2	2	0	0.00000	0.00000
81	236077008	Protracted diarrhea	131	93761005	Primary malignant neoplasm of colon	1095	4	5	0	4	5	1086	0.00000	-0.00410	0.00000	0.00000	0.00000	1.0000000000	1.0000000000	0.01826	-0.02611	2	3	0	2	2	0	0.00000	0.00000
80	6072007	Bleeding from anus	131	93761005	Primary malignant neoplasm of colon	1095	4	5	0	4	5	1086	0.00000	-0.00410	0.00000	0.00000	0.00000	1.0000000000	1.0000000000	0.01826	-0.02611	2	3	0	2	2	0	0.00000	0.00000
79	45816000	Pyelonephritis	131	93761005	Primary malignant neoplasm of colon	1095	1	5	0	1	5	1089	0.00000	-0.00205	0.00000	0.00000	0.00000	1.0000000000	1.0000000000	0.00457	-0.00657	1	3	0	0	2	0	0.00000	0.00000
78	239872002	Osteoarthritis of hip	131	93761005	Primary malignant neoplasm of colon	1095	21	5	0	21	5	1069	0.00000	-0.00947	0.00000	0.00000	0.00000	1.0000000000	1.0000000000	0.09589	-0.13210	13	3	0	8	2	0	0.00000	0.00000
76	127013003	Diabetic renal disease (disorder)	131	93761005	Primary malignant neoplasm of colon	1095	28	5	0	28	5	1062	0.00000	-0.01097	0.00000	0.00000	0.00000	1.0000000000	1.0000000000	0.12785	-0.17358	10	3	0	18	2	0	0.00000	0.00000
75	431855005	Chronic kidney disease stage 1 (disorder)	131	93761005	Primary malignant neoplasm of colon	1095	28	5	0	28	5	1062	0.00000	-0.01097	0.00000	0.00000	0.00000	1.0000000000	1.0000000000	0.12785	-0.17358	10	3	0	18	2	0	0.00000	0.00000
73	196416002	Impacted molars	131	93761005	Primary malignant neoplasm of colon	1095	49	5	1	48	4	1042	4.46939	0.05086	5.42708	49.48801	0.59516	0.2049370625	0.8533859271	0.22374	0.70870	25	3	0	24	2	1	-1.09861	-3.21888
72	35999006	Blighted ovum	131	93761005	Primary malignant neoplasm of colon	1095	53	5	1	52	4	1038	4.13208	0.04784	4.99038	45.44268	0.54803	0.2200519138	0.8776082232	0.24201	0.68732	53	3	1	0	2	0	1.38629	3.98898
71	201834006	Localized  primary osteoarthritis of the hand	131	93761005	Primary malignant neoplasm of colon	1095	28	5	0	28	5	1062	0.00000	-0.01097	0.00000	0.00000	0.00000	1.0000000000	1.0000000000	0.12785	-0.17358	19	3	0	9	2	0	0.00000	0.00000
70	87433001	Pulmonary emphysema (disorder)	131	93761005	Primary malignant neoplasm of colon	1095	17	5	0	17	5	1073	0.00000	-0.00851	0.00000	0.00000	0.00000	1.0000000000	1.0000000000	0.07763	-0.10786	9	3	0	8	2	0	0.00000	0.00000
69	233604007	Pneumonia	131	93761005	Primary malignant neoplasm of colon	1095	7	5	0	7	5	1083	0.00000	-0.00543	0.00000	0.00000	0.00000	1.0000000000	1.0000000000	0.03196	-0.04539	3	3	0	4	2	0	0.00000	0.00000
68	26929004	Alzheimer's disease (disorder)	131	93761005	Primary malignant neoplasm of colon	1095	23	5	1	22	4	1068	9.52174	0.08454	12.13636	113.04743	1.30292	0.1008792930	0.6283150080	0.10502	0.85592	15	3	1	8	2	0	1.38629	2.77259
67	403191005	Second degree burn	131	93761005	Primary malignant neoplasm of colon	1095	49	5	0	49	5	1041	0.00000	-0.01466	0.00000	0.00000	0.00000	1.0000000000	1.0000000000	0.22374	-0.29130	23	3	0	26	2	0	0.00000	0.00000
65	239873007	Osteoarthritis of knee	131	93761005	Primary malignant neoplasm of colon	1095	57	5	0	57	5	1033	0.00000	-0.01587	0.00000	0.00000	0.00000	1.0000000000	1.0000000000	0.26027	-0.33374	30	3	0	27	2	0	0.00000	0.00000
64	444448004	Injury of medial collateral ligament of knee	131	93761005	Primary malignant neoplasm of colon	1095	32	5	0	32	5	1058	0.00000	-0.01175	0.00000	0.00000	0.00000	1.0000000000	1.0000000000	0.14612	-0.19676	17	3	0	15	2	0	0.00000	0.00000
63	68496003	Polyp of colon	131	93761005	Primary malignant neoplasm of colon	1095	91	5	5	86	0	1004	12.03297	0.22497	0.00000	0.00000	0.00000	0.0000035775	0.0001661539	0.41553	2.08363	43	3	3	48	2	2	0.00000	-0.48885
62	185086009	Chronic obstructive bronchitis (disorder)	131	93761005	Primary malignant neoplasm of colon	1095	6	5	0	6	5	1084	0.00000	-0.00503	0.00000	0.00000	0.00000	1.0000000000	1.0000000000	0.02740	-0.03899	4	3	0	2	2	0	0.00000	0.00000
59	262574004	Bullet wound	131	93761005	Primary malignant neoplasm of colon	1095	20	5	0	20	5	1070	0.00000	-0.00924	0.00000	0.00000	0.00000	1.0000000000	1.0000000000	0.09132	-0.12608	9	3	0	11	2	0	0.00000	0.00000
58	239720000	Tear of meniscus of knee	131	93761005	Primary malignant neoplasm of colon	1095	20	5	0	20	5	1070	0.00000	-0.00924	0.00000	0.00000	0.00000	1.0000000000	1.0000000000	0.09132	-0.12608	10	3	0	10	2	0	0.00000	0.00000
57	192127007	Child attention deficit disorder	131	93761005	Primary malignant neoplasm of colon	1095	76	5	1	75	4	1015	2.88158	0.03480	3.38333	30.65161	0.37345	0.3025651046	0.9949586182	0.34703	0.57022	24	3	0	52	2	1	-1.09861	-3.97029
56	92691004	Carcinoma in situ of prostate (disorder)	131	93761005	Primary malignant neoplasm of colon	1095	23	5	0	23	5	1067	0.00000	-0.00992	0.00000	0.00000	0.00000	1.0000000000	1.0000000000	0.10502	-0.14408	0	3	0	23	2	0	0.00000	0.00000
54	5602001	Opioid abuse (disorder)	131	93761005	Primary malignant neoplasm of colon	1095	7	5	0	7	5	1083	0.00000	-0.00543	0.00000	0.00000	0.00000	1.0000000000	1.0000000000	0.03196	-0.04539	0	3	0	7	2	0	0.00000	0.00000
53	7200002	Alcoholism	131	93761005	Primary malignant neoplasm of colon	1095	5	5	0	5	5	1085	0.00000	-0.00459	0.00000	0.00000	0.00000	1.0000000000	1.0000000000	0.02283	-0.03257	0	3	0	5	2	0	0.00000	0.00000
52	124171000119105	Chronic intractable migraine without aura	131	93761005	Primary malignant neoplasm of colon	1095	51	5	1	50	4	1040	4.29412	0.04931	5.20000	47.38305	0.57067	0.2125234992	0.8671354646	0.23288	0.69797	21	3	0	30	2	1	-1.09861	-3.43399
50	446096008	Perennial allergic rhinitis	131	93761005	Primary malignant neoplasm of colon	1095	26	5	0	26	5	1064	0.00000	-0.01056	0.00000	0.00000	0.00000	1.0000000000	1.0000000000	0.11872	-0.16185	14	3	0	12	2	0	0.00000	0.00000
49	88805009	Chronic congestive heart failure (disorder)	131	93761005	Primary malignant neoplasm of colon	1095	10	5	1	9	4	1081	21.90000	0.13589	30.02778	295.75376	3.04871	0.0449162858	0.4084765375	0.04566	0.93558	5	3	0	5	2	1	-1.09861	-1.79176
47	359817006	Closed fracture of hip	131	93761005	Primary malignant neoplasm of colon	1095	29	5	0	29	5	1061	0.00000	-0.01117	0.00000	0.00000	0.00000	1.0000000000	1.0000000000	0.13242	-0.17941	11	3	0	18	2	0	0.00000	0.00000
46	62564004	Concussion with loss of consciousness	131	93761005	Primary malignant neoplasm of colon	1095	67	5	0	67	5	1023	0.00000	-0.01729	0.00000	0.00000	0.00000	1.0000000000	1.0000000000	0.30594	-0.38508	36	3	0	31	2	0	0.00000	0.00000
45	263102004	Fracture subluxation of wrist	131	93761005	Primary malignant neoplasm of colon	1095	109	5	3	106	2	984	6.02752	0.11321	13.92453	84.27049	2.30083	0.0082733489	0.1342392906	0.49772	1.41724	51	3	1	58	2	2	0.69315	0.55005
44	58150001	Fracture of clavicle	131	93761005	Primary malignant neoplasm of colon	1095	112	5	0	112	5	978	0.00000	-0.02286	0.00000	0.00000	0.00000	1.0000000000	1.0000000000	0.51142	-0.59590	55	3	0	57	2	0	0.00000	0.00000
43	307731004	Injury of tendon of the rotator cuff of shoulder	131	93761005	Primary malignant neoplasm of colon	1095	51	5	1	50	4	1040	4.29412	0.04931	5.20000	47.38305	0.57067	0.2125234992	0.8671354646	0.23288	0.69797	26	3	1	25	2	0	1.38629	3.29584
42	16114001	Fracture of ankle	131	93761005	Primary malignant neoplasm of colon	1095	108	5	2	106	3	984	4.05556	0.06846	6.18868	37.45355	1.02259	0.0790706635	0.5566016712	0.49315	1.00660	48	3	1	60	2	1	0.28768	-0.21905
41	283385000	Laceration of thigh	131	93761005	Primary malignant neoplasm of colon	1095	105	5	2	103	3	987	4.17143	0.06995	6.38835	38.67315	1.05528	0.0751505221	0.5403171639	0.47945	1.01990	50	3	2	55	2	0	0.91629	3.25810
40	428251008	History of appendectomy	131	93761005	Primary malignant neoplasm of colon	1095	51	5	0	51	5	1039	0.00000	-0.01497	0.00000	0.00000	0.00000	1.0000000000	1.0000000000	0.23288	-0.30203	27	3	0	24	2	0	0.00000	0.00000
39	74400008	Appendicitis	131	93761005	Primary malignant neoplasm of colon	1095	51	5	0	51	5	1039	0.00000	-0.01497	0.00000	0.00000	0.00000	1.0000000000	1.0000000000	0.23288	-0.30203	27	3	0	24	2	0	0.00000	0.00000
38	398254007	Preeclampsia	131	93761005	Primary malignant neoplasm of colon	1095	101	5	1	100	4	990	2.16832	0.02522	2.47500	22.35788	0.27398	0.3841752176	1.0000000000	0.46119	0.45286	101	3	1	0	2	0	1.38629	4.62497
35	19169002	Miscarriage in first trimester	131	93761005	Primary malignant neoplasm of colon	1095	174	5	3	171	2	919	3.77586	0.08172	8.06140	48.60442	1.33704	0.0308338435	0.3245317488	0.79452	1.15640	174	3	3	0	2	0	0.69315	4.07754
33	429007001	History of cardiac arrest (situation)	131	93761005	Primary malignant neoplasm of colon	1095	42	5	0	42	5	1048	0.00000	-0.01353	0.00000	0.00000	0.00000	1.0000000000	1.0000000000	0.19178	-0.25312	24	3	0	18	2	0	0.00000	0.00000
32	410429000	Cardiac Arrest	131	93761005	Primary malignant neoplasm of colon	1095	42	5	0	42	5	1048	0.00000	-0.01353	0.00000	0.00000	0.00000	1.0000000000	1.0000000000	0.19178	-0.25312	24	3	0	18	2	0	0.00000	0.00000
30	399211009	History of myocardial infarction (situation)	131	93761005	Primary malignant neoplasm of colon	1095	31	5	1	30	4	1060	7.06452	0.07011	8.83333	81.42502	0.95828	0.1339924739	0.7192732770	0.14155	0.80900	2	3	0	29	2	1	-1.09861	-3.40120
29	22298006	Myocardial Infarction	131	93761005	Primary malignant neoplasm of colon	1095	31	5	1	30	4	1060	7.06452	0.07011	8.83333	81.42502	0.95828	0.1339924739	0.7192732770	0.14155	0.80900	2	3	0	29	2	1	-1.09861	-3.40120
28	53741008	Coronary Heart Disease	131	93761005	Primary malignant neoplasm of colon	1095	80	5	1	79	4	1011	2.73750	0.03304	3.19937	28.96800	0.35335	0.3161731980	1.0000000000	0.36530	0.55079	24	3	0	56	2	1	-1.09861	-4.04305
27	408512008	Body mass index 40+ - severely obese (finding)	131	93761005	Primary malignant neoplasm of colon	1095	97	5	1	96	4	994	2.25773	0.02656	2.58854	23.39198	0.28645	0.3716588377	1.0000000000	0.44292	0.47101	67	3	1	30	2	0	1.38629	4.21951
26	33737001	Fracture of rib	131	93761005	Primary malignant neoplasm of colon	1095	54	5	0	54	5	1036	0.00000	-0.01543	0.00000	0.00000	0.00000	1.0000000000	1.0000000000	0.24658	-0.31797	32	3	0	22	2	0	0.00000	0.00000
24	162864005	Body mass index 30+ - obesity (finding)	131	93761005	Primary malignant neoplasm of colon	1095	439	5	3	436	2	654	1.49658	0.02751	2.25000	13.52075	0.37442	0.3954031145	1.0000000000	2.00457	0.41284	226	3	2	213	2	1	-0.18232	-0.62978
23	36971009	Sinusitis (disorder)	131	93761005	Primary malignant neoplasm of colon	1095	190	5	0	190	5	900	0.00000	-0.03103	0.00000	0.00000	0.00000	0.5941776973	1.0000000000	0.86758	-0.90117	84	3	0	106	2	0	0.00000	0.00000
21	15777000	Prediabetes	131	93761005	Primary malignant neoplasm of colon	1095	333	5	2	331	3	759	1.31532	0.01412	1.52870	9.19138	0.25425	0.6429654520	1.0000000000	1.52055	0.25123	159	3	1	174	2	1	0.28768	-0.08961
20	80394007	Hyperglycemia (disorder)	131	93761005	Primary malignant neoplasm of colon	1095	55	5	0	55	5	1035	0.00000	-0.01558	0.00000	0.00000	0.00000	1.0000000000	1.0000000000	0.25114	-0.32325	23	3	0	32	2	0	0.00000	0.00000
19	237602007	Metabolic syndrome X (disorder)	131	93761005	Primary malignant neoplasm of colon	1095	64	5	0	64	5	1026	0.00000	-0.01687	0.00000	0.00000	0.00000	1.0000000000	1.0000000000	0.29224	-0.36987	28	3	0	36	2	0	0.00000	0.00000
18	302870006	Hypertriglyceridemia (disorder)	131	93761005	Primary malignant neoplasm of colon	1095	64	5	0	64	5	1026	0.00000	-0.01687	0.00000	0.00000	0.00000	1.0000000000	1.0000000000	0.29224	-0.36987	28	3	0	36	2	0	0.00000	0.00000
17	368581000119106	Neuropathy due to type 2 diabetes mellitus (disorder)	131	93761005	Primary malignant neoplasm of colon	1095	28	5	0	28	5	1062	0.00000	-0.01097	0.00000	0.00000	0.00000	1.0000000000	1.0000000000	0.12785	-0.17358	7	3	0	21	2	0	0.00000	0.00000
129	47505003	Posttraumatic stress disorder	105	363406005	Malignant tumor of colon	1095	4	6	0	4	6	1085	0.00000	-0.00449	0.00000	0.00000	0.00000	1.0000000000	1.0000000000	0.02192	-0.03128	1	4	0	3	2	0	0.00000	0.00000
15	40055000	Chronic sinusitis (disorder)	131	93761005	Primary malignant neoplasm of colon	1095	216	5	0	216	5	874	0.00000	-0.03357	0.00000	0.00000	0.00000	0.5895012359	1.0000000000	0.98630	-0.99008	104	3	0	112	2	0	0.00000	0.00000
14	10509002	Acute bronchitis (disorder)	131	93761005	Primary malignant neoplasm of colon	1095	863	5	4	859	1	231	1.01506	0.00197	1.07567	9.67032	0.11965	1.0000000000	1.0000000000	3.94064	0.01723	418	3	2	445	2	2	0.22314	-0.06230
13	370247008	Facial laceration	131	93761005	Primary malignant neoplasm of colon	1095	109	5	0	109	5	981	0.00000	-0.02252	0.00000	0.00000	0.00000	1.0000000000	1.0000000000	0.49772	-0.58276	55	3	0	54	2	0	0.00000	0.00000
125	1734006	Fracture of the vertebral column with spinal cord injury	105	363406005	Malignant tumor of colon	1095	5	6	0	5	6	1084	0.00000	-0.00503	0.00000	0.00000	0.00000	1.0000000000	1.0000000000	0.02740	-0.03899	3	4	0	2	2	0	0.00000	0.00000
124	1501000119109	Proliferative diabetic retinopathy due to type II diabetes mellitus (disorder)	105	363406005	Malignant tumor of colon	1095	1	6	0	1	6	1088	0.00000	-0.00224	0.00000	0.00000	0.00000	1.0000000000	1.0000000000	0.00548	-0.00788	1	4	0	0	2	0	0.00000	0.00000
10	62106007	Concussion with no loss of consciousness	131	93761005	Primary malignant neoplasm of colon	1095	206	5	2	204	3	886	2.12621	0.03672	2.89542	17.44042	0.48069	0.2383738363	0.9069984981	0.94064	0.62843	96	3	0	110	2	2	-0.69315	-4.02535
9	44465007	Sprain of ankle	131	93761005	Primary malignant neoplasm of colon	1095	362	5	0	362	5	728	0.00000	-0.04760	0.00000	0.00000	0.00000	0.1773661210	0.8029498763	1.65297	-1.40761	185	3	0	177	2	0	0.00000	0.00000
8	233678006	Childhood asthma	131	93761005	Primary malignant neoplasm of colon	1095	45	5	0	45	5	1045	0.00000	-0.01402	0.00000	0.00000	0.00000	1.0000000000	1.0000000000	0.20548	-0.26961	25	3	0	20	2	0	0.00000	0.00000
7	75498004	Acute bacterial sinusitis (disorder)	131	93761005	Primary malignant neoplasm of colon	1095	187	5	0	187	5	903	0.00000	-0.03074	0.00000	0.00000	0.00000	0.5952540318	1.0000000000	0.85388	-0.89055	89	3	0	98	2	0	0.00000	0.00000
6	39848009	Whiplash injury to neck	131	93761005	Primary malignant neoplasm of colon	1095	182	5	2	180	3	910	2.40659	0.04253	3.37037	20.31477	0.55917	0.1950681871	0.8340316782	0.83105	0.71229	92	3	2	90	2	0	0.91629	3.85015
5	284549007	Laceration of hand	131	93761005	Primary malignant neoplasm of colon	1095	104	5	0	104	5	986	0.00000	-0.02194	0.00000	0.00000	0.00000	1.0000000000	1.0000000000	0.47489	-0.56060	54	3	0	50	2	0	0.00000	0.00000
117	230265002	Familial Alzheimer's disease of early onset (disorder)	105	363406005	Malignant tumor of colon	1095	6	6	0	6	6	1083	0.00000	-0.00551	0.00000	0.00000	0.00000	1.0000000000	1.0000000000	0.03288	-0.04667	2	4	0	4	2	0	0.00000	0.00000
115	36923009	Major depression  single episode	105	363406005	Malignant tumor of colon	1095	6	6	0	6	6	1083	0.00000	-0.00551	0.00000	0.00000	0.00000	1.0000000000	1.0000000000	0.03288	-0.04667	3	4	0	3	2	0	0.00000	0.00000
1	444814009	Viral sinusitis (disorder)	131	93761005	Primary malignant neoplasm of colon	1095	993	5	5	988	0	102	1.10272	0.02171	0.00000	0.00000	0.00000	1.0000000000	1.0000000000	4.53425	0.11658	478	3	3	515	2	2	0.00000	-0.47764
111	235919008	Cholelithiasis	105	363406005	Malignant tumor of colon	1095	9	6	0	9	6	1080	0.00000	-0.00676	0.00000	0.00000	0.00000	1.0000000000	1.0000000000	0.04932	-0.06945	7	4	0	2	2	0	0.00000	0.00000
109	90560007	Gout	105	363406005	Malignant tumor of colon	1095	4	6	0	4	6	1085	0.00000	-0.00449	0.00000	0.00000	0.00000	1.0000000000	1.0000000000	0.02192	-0.03128	0	4	0	4	2	0	0.00000	0.00000
108	40930008	Hypothyroidism (disorder)	105	363406005	Malignant tumor of colon	1095	13	6	0	13	6	1076	0.00000	-0.00814	0.00000	0.00000	0.00000	1.0000000000	1.0000000000	0.07123	-0.09927	11	4	0	2	2	0	0.00000	0.00000
107	40275004	Contact dermatitis	105	363406005	Malignant tumor of colon	1095	18	6	0	18	6	1071	0.00000	-0.00960	0.00000	0.00000	0.00000	1.0000000000	1.0000000000	0.09863	-0.13571	9	4	0	9	2	0	0.00000	0.00000
106	24079001	Atopic dermatitis	105	363406005	Malignant tumor of colon	1095	20	6	0	20	6	1069	0.00000	-0.01012	0.00000	0.00000	0.00000	1.0000000000	1.0000000000	0.10959	-0.15003	13	4	0	7	2	0	0.00000	0.00000
102	90781000119102	Microalbuminuria due to type 2 diabetes mellitus (disorder)	105	363406005	Malignant tumor of colon	1095	6	6	1	5	5	1084	30.41667	0.16208	43.36000	441.14109	4.26188	0.0325028936	0.3325947436	0.03288	0.95333	3	4	1	3	2	0	1.60944	1.38629
101	433144002	Chronic kidney disease stage 3 (disorder)	105	363406005	Malignant tumor of colon	1095	3	6	0	3	6	1086	0.00000	-0.00389	0.00000	0.00000	0.00000	1.0000000000	1.0000000000	0.01644	-0.02352	1	4	0	2	2	0	0.00000	0.00000
100	161622006	History of lower limb amputation (situation)	105	363406005	Malignant tumor of colon	1095	1	6	0	1	6	1088	0.00000	-0.00224	0.00000	0.00000	0.00000	1.0000000000	1.0000000000	0.00548	-0.00788	0	4	0	1	2	0	0.00000	0.00000
98	1551000119108	Nonproliferative diabetic retinopathy due to type 2 diabetes mellitus (disorder)	105	363406005	Malignant tumor of colon	1095	12	6	0	12	6	1077	0.00000	-0.00781	0.00000	0.00000	0.00000	1.0000000000	1.0000000000	0.06575	-0.09187	7	4	0	5	2	0	0.00000	0.00000
97	403192003	Third degree burn	105	363406005	Malignant tumor of colon	1095	8	6	0	8	6	1081	0.00000	-0.00637	0.00000	0.00000	0.00000	1.0000000000	1.0000000000	0.04384	-0.06189	3	4	0	5	2	0	0.00000	0.00000
96	283371005	Laceration of forearm	105	363406005	Malignant tumor of colon	1095	75	6	0	75	6	1014	0.00000	-0.02013	0.00000	0.00000	0.00000	1.0000000000	1.0000000000	0.41096	-0.49668	39	4	0	36	2	0	0.00000	0.00000
94	703151001	History of single seizure (situation)	105	363406005	Malignant tumor of colon	1095	39	6	1	38	5	1051	4.67949	0.05249	5.53158	48.50976	0.63077	0.1959587581	0.8340316782	0.21370	0.72059	14	4	0	25	2	1	-1.09861	-3.25810
93	128613002	Seizure disorder	105	363406005	Malignant tumor of colon	1095	39	6	1	38	5	1051	4.67949	0.05249	5.53158	48.50976	0.63077	0.1959587581	0.8340316782	0.21370	0.72059	14	4	0	25	2	1	-1.09861	-3.25810
89	47693006	Rupture of appendix	105	363406005	Malignant tumor of colon	1095	20	6	0	20	6	1069	0.00000	-0.01012	0.00000	0.00000	0.00000	1.0000000000	1.0000000000	0.10959	-0.15003	10	4	0	10	2	0	0.00000	0.00000
86	713197008	Recurrent rectal polyp	105	363406005	Malignant tumor of colon	1095	22	6	6	16	0	1073	49.77273	0.51838	0.00000	0.00000	0.00000	0.0000000000	0.0000000027	0.12055	2.64315	12	4	4	10	2	2	0.00000	-0.40547
82	94260004	Secondary malignant neoplasm of colon	105	363406005	Malignant tumor of colon	1095	4	6	0	4	6	1085	0.00000	-0.00449	0.00000	0.00000	0.00000	1.0000000000	1.0000000000	0.02192	-0.03128	2	4	0	2	2	0	0.00000	0.00000
78	239872002	Osteoarthritis of hip	105	363406005	Malignant tumor of colon	1095	21	6	0	21	6	1068	0.00000	-0.01038	0.00000	0.00000	0.00000	1.0000000000	1.0000000000	0.11507	-0.15713	13	4	0	8	2	0	0.00000	0.00000
76	127013003	Diabetic renal disease (disorder)	105	363406005	Malignant tumor of colon	1095	28	6	1	27	5	1062	6.51786	0.06635	7.86667	69.64292	0.88860	0.1442534615	0.7404942507	0.15342	0.79408	10	4	1	18	2	0	1.60944	2.39790
75	431855005	Chronic kidney disease stage 1 (disorder)	105	363406005	Malignant tumor of colon	1095	28	6	1	27	5	1062	6.51786	0.06635	7.86667	69.64292	0.88860	0.1442534615	0.7404942507	0.15342	0.79408	10	4	1	18	2	0	1.60944	2.39790
72	35999006	Blighted ovum	105	363406005	Malignant tumor of colon	1095	53	6	1	52	5	1037	3.44340	0.04090	3.98846	34.75878	0.45766	0.2579759950	0.9227845495	0.29041	0.63217	53	4	1	0	2	0	1.60944	3.98898
71	201834006	Localized  primary osteoarthritis of the hand	105	363406005	Malignant tumor of colon	1095	28	6	1	27	5	1062	6.51786	0.06635	7.86667	69.64292	0.88860	0.1442534615	0.7404942507	0.15342	0.79408	19	4	1	9	2	0	1.60944	2.99573
70	87433001	Pulmonary emphysema (disorder)	105	363406005	Malignant tumor of colon	1095	17	6	0	17	6	1072	0.00000	-0.00932	0.00000	0.00000	0.00000	1.0000000000	1.0000000000	0.09315	-0.12849	9	4	0	8	2	0	0.00000	0.00000
69	233604007	Pneumonia	105	363406005	Malignant tumor of colon	1095	7	6	0	7	6	1082	0.00000	-0.00595	0.00000	0.00000	0.00000	1.0000000000	1.0000000000	0.03836	-0.05430	3	4	0	4	2	0	0.00000	0.00000
68	26929004	Alzheimer's disease (disorder)	105	363406005	Malignant tumor of colon	1095	23	6	1	22	5	1067	7.93478	0.07540	9.70000	86.51085	1.08761	0.1198515648	0.6843537581	0.12603	0.82876	15	4	1	8	2	0	1.60944	2.77259
67	403191005	Second degree burn	105	363406005	Malignant tumor of colon	1095	49	6	1	48	5	1041	3.72449	0.04377	4.33750	37.85423	0.49701	0.2406784239	0.9095097439	0.26849	0.65688	23	4	1	26	2	0	1.60944	3.17805
65	239873007	Osteoarthritis of knee	105	363406005	Malignant tumor of colon	1095	57	6	1	56	5	1033	3.20175	0.03830	3.68929	32.11245	0.42385	0.2749439423	0.9503524867	0.31233	0.60787	30	4	1	27	2	0	1.60944	3.43399
64	444448004	Injury of medial collateral ligament of knee	105	363406005	Malignant tumor of colon	1095	32	6	1	31	5	1058	5.70312	0.06057	6.82581	60.17440	0.77428	0.1633666582	0.7879650300	0.17534	0.76692	17	4	1	15	2	0	1.60944	2.89037
63	68496003	Polyp of colon	105	363406005	Malignant tumor of colon	1095	91	6	6	85	0	1004	12.03297	0.24655	0.00000	0.00000	0.00000	0.0000002823	0.0000157814	0.49863	2.22371	43	4	4	48	2	2	0.00000	-0.75502
59	262574004	Bullet wound	105	363406005	Malignant tumor of colon	1095	20	6	0	20	6	1069	0.00000	-0.01012	0.00000	0.00000	0.00000	1.0000000000	1.0000000000	0.10959	-0.15003	9	4	0	11	2	0	0.00000	0.00000
58	239720000	Tear of meniscus of knee	105	363406005	Malignant tumor of colon	1095	20	6	0	20	6	1069	0.00000	-0.01012	0.00000	0.00000	0.00000	1.0000000000	1.0000000000	0.10959	-0.15003	10	4	0	10	2	0	0.00000	0.00000
57	192127007	Child attention deficit disorder	105	363406005	Malignant tumor of colon	1095	76	6	0	76	6	1013	0.00000	-0.02027	0.00000	0.00000	0.00000	1.0000000000	1.0000000000	0.41644	-0.50227	24	4	0	52	2	0	0.00000	0.00000
56	92691004	Carcinoma in situ of prostate (disorder)	105	363406005	Malignant tumor of colon	1095	23	6	1	22	5	1067	7.93478	0.07540	9.70000	86.51085	1.08761	0.1198515648	0.6843537581	0.12603	0.82876	0	4	0	23	2	1	-1.09861	-3.17805
54	5602001	Opioid abuse (disorder)	105	363406005	Malignant tumor of colon	1095	7	6	0	7	6	1082	0.00000	-0.00595	0.00000	0.00000	0.00000	1.0000000000	1.0000000000	0.03836	-0.05430	0	4	0	7	2	0	0.00000	0.00000
52	124171000119105	Chronic intractable migraine without aura	105	363406005	Malignant tumor of colon	1095	51	6	1	50	5	1039	3.57843	0.04230	4.15600	36.24351	0.47656	0.2493687300	0.9133257124	0.27945	0.64447	21	4	0	30	2	1	-1.09861	-3.43399
50	446096008	Perennial allergic rhinitis	105	363406005	Malignant tumor of colon	1095	26	6	0	26	6	1063	0.00000	-0.01158	0.00000	0.00000	0.00000	1.0000000000	1.0000000000	0.14247	-0.19215	14	4	0	12	2	0	0.00000	0.00000
49	88805009	Chronic congestive heart failure (disorder)	105	363406005	Malignant tumor of colon	1095	10	6	1	9	5	1080	18.25000	0.12292	24.00000	226.57620	2.54219	0.0536785217	0.4487524417	0.05479	0.92304	5	4	1	5	2	0	1.60944	1.79176
47	359817006	Closed fracture of hip	105	363406005	Malignant tumor of colon	1095	29	6	0	29	6	1060	0.00000	-0.01224	0.00000	0.00000	0.00000	1.0000000000	1.0000000000	0.15890	-0.21276	11	4	0	18	2	0	0.00000	0.00000
45	263102004	Fracture subluxation of wrist	105	363406005	Malignant tumor of colon	1095	109	6	1	108	5	981	1.67431	0.01664	1.81667	15.69300	0.21030	0.4677486559	1.0000000000	0.59726	0.32440	51	4	1	58	2	0	1.60944	3.95124
44	58150001	Fracture of clavicle	105	363406005	Malignant tumor of colon	1095	112	6	0	112	6	977	0.00000	-0.02505	0.00000	0.00000	0.00000	1.0000000000	1.0000000000	0.61370	-0.69037	55	4	0	57	2	0	0.00000	0.00000
43	307731004	Injury of tendon of the rotator cuff of shoulder	105	363406005	Malignant tumor of colon	1095	51	6	0	51	6	1038	0.00000	-0.01641	0.00000	0.00000	0.00000	1.0000000000	1.0000000000	0.27945	-0.35553	26	4	0	25	2	0	0.00000	0.00000
42	16114001	Fracture of ankle	105	363406005	Malignant tumor of colon	1095	108	6	0	108	6	981	0.00000	-0.02455	0.00000	0.00000	0.00000	1.0000000000	1.0000000000	0.59178	-0.67064	48	4	0	60	2	0	0.00000	0.00000
41	283385000	Laceration of thigh	105	363406005	Malignant tumor of colon	1095	105	6	0	105	6	984	0.00000	-0.02417	0.00000	0.00000	0.00000	1.0000000000	1.0000000000	0.57534	-0.65567	50	4	0	55	2	0	0.00000	0.00000
39	74400008	Appendicitis	105	363406005	Malignant tumor of colon	1095	51	6	1	50	5	1039	3.57843	0.04230	4.15600	36.24351	0.47656	0.2493687300	0.9133257124	0.27945	0.64447	27	4	1	24	2	0	1.60944	3.33220
38	398254007	Preeclampsia	105	363406005	Malignant tumor of colon	1095	101	6	1	100	5	989	1.80693	0.01909	1.97800	17.09780	0.22883	0.4412378809	1.0000000000	0.55342	0.36455	101	4	1	0	2	0	1.60944	4.62497
35	19169002	Miscarriage in first trimester	105	363406005	Malignant tumor of colon	1095	174	6	1	173	5	916	1.04885	0.00158	1.05896	9.11992	0.12296	1.0000000000	1.0000000000	0.95342	0.03399	174	4	1	0	2	0	1.60944	5.16479
33	429007001	History of cardiac arrest (situation)	105	363406005	Malignant tumor of colon	1095	42	6	0	42	6	1047	0.00000	-0.01482	0.00000	0.00000	0.00000	1.0000000000	1.0000000000	0.23014	-0.29882	24	4	0	18	2	0	0.00000	0.00000
32	410429000	Cardiac Arrest	105	363406005	Malignant tumor of colon	1095	42	6	0	42	6	1047	0.00000	-0.01482	0.00000	0.00000	0.00000	1.0000000000	1.0000000000	0.23014	-0.29882	24	4	0	18	2	0	0.00000	0.00000
30	399211009	History of myocardial infarction (situation)	105	363406005	Malignant tumor of colon	1095	31	6	0	31	6	1058	0.00000	-0.01267	0.00000	0.00000	0.00000	1.0000000000	1.0000000000	0.16986	-0.22634	2	4	0	29	2	0	0.00000	0.00000
29	22298006	Myocardial Infarction	105	363406005	Malignant tumor of colon	1095	31	6	0	31	6	1058	0.00000	-0.01267	0.00000	0.00000	0.00000	1.0000000000	1.0000000000	0.16986	-0.22634	2	4	0	29	2	0	0.00000	0.00000
27	408512008	Body mass index 40+ - severely obese (finding)	105	363406005	Malignant tumor of colon	1095	97	6	1	96	5	993	1.88144	0.02040	2.06875	17.88881	0.23924	0.4275754365	1.0000000000	0.53151	0.38505	67	4	1	30	2	0	1.60944	4.21951
24	162864005	Body mass index 30+ - obesity (finding)	105	363406005	Malignant tumor of colon	1095	439	6	5	434	1	655	2.07859	0.06549	7.54608	64.81186	0.87859	0.0409592279	0.3866022603	2.40548	0.81710	226	4	4	213	2	1	-0.40547	-1.31419
23	36971009	Sinusitis (disorder)	105	363406005	Malignant tumor of colon	1095	190	6	0	190	6	899	0.00000	-0.03401	0.00000	0.00000	0.00000	0.5974540609	1.0000000000	1.04110	-1.02934	84	4	0	106	2	0	0.00000	0.00000
21	15777000	Prediabetes	105	363406005	Malignant tumor of colon	1095	333	6	4	329	2	760	2.19219	0.05850	4.62006	25.34825	0.84207	0.0732270143	0.5352096013	1.82466	0.82385	159	4	3	174	2	1	-0.25131	-1.17580
20	80394007	Hyperglycemia (disorder)	105	363406005	Malignant tumor of colon	1095	55	6	1	54	5	1035	3.31818	0.03957	3.83333	33.38581	0.44014	0.2665008550	0.9357378021	0.30137	0.61997	23	4	1	32	2	0	1.60944	3.17805
19	237602007	Metabolic syndrome X (disorder)	105	363406005	Malignant tumor of colon	1095	64	6	1	63	5	1026	2.85156	0.03424	3.25714	28.30123	0.37486	0.3038598319	0.9949586182	0.35068	0.56631	28	4	1	36	2	0	1.60944	3.36730
18	302870006	Hypertriglyceridemia (disorder)	105	363406005	Malignant tumor of colon	1095	64	6	1	63	5	1026	2.85156	0.03424	3.25714	28.30123	0.37486	0.3038598319	0.9949586182	0.35068	0.56631	28	4	1	36	2	0	1.60944	3.36730
17	368581000119106	Neuropathy due to type 2 diabetes mellitus (disorder)	105	363406005	Malignant tumor of colon	1095	28	6	0	28	6	1061	0.00000	-0.01202	0.00000	0.00000	0.00000	1.0000000000	1.0000000000	0.15342	-0.20592	7	4	0	21	2	0	0.00000	0.00000
129	47505003	Posttraumatic stress disorder	79	45816000	Pyelonephritis	1095	4	1	0	4	1	1090	0.00000	-0.00183	0.00000	0.00000	0.00000	1.0000000000	1.0000000000	0.00365	-0.00526	1	1	0	3	0	0	0.00000	0.00000
15	40055000	Chronic sinusitis (disorder)	105	363406005	Malignant tumor of colon	1095	216	6	1	215	5	874	0.84491	-0.00571	0.81302	6.99516	0.09449	1.0000000000	1.0000000000	1.18356	-0.12668	104	4	0	112	2	1	-1.09861	-4.72739
14	10509002	Acute bronchitis (disorder)	105	363406005	Malignant tumor of colon	1095	863	6	5	858	1	231	1.05736	0.00821	1.34615	11.57904	0.15650	1.0000000000	1.0000000000	4.72877	0.06674	418	4	3	445	2	2	0.15415	-0.46539
13	370247008	Facial laceration	105	363406005	Malignant tumor of colon	1095	109	6	1	108	5	981	1.67431	0.01664	1.81667	15.69300	0.21030	0.4677486559	1.0000000000	0.59726	0.32440	55	4	1	54	2	0	1.60944	4.02535
125	1734006	Fracture of the vertebral column with spinal cord injury	79	45816000	Pyelonephritis	1095	5	1	0	5	1	1089	0.00000	-0.00205	0.00000	0.00000	0.00000	1.0000000000	1.0000000000	0.00457	-0.00657	3	1	0	2	0	0	0.00000	0.00000
124	1501000119109	Proliferative diabetic retinopathy due to type II diabetes mellitus (disorder)	79	45816000	Pyelonephritis	1095	1	1	0	1	1	1093	0.00000	-0.00091	0.00000	0.00000	0.00000	1.0000000000	1.0000000000	0.00091	-0.00132	1	1	0	0	0	0	0.00000	0.00000
10	62106007	Concussion with no loss of consciousness	105	363406005	Malignant tumor of colon	1095	206	6	1	205	5	884	0.88592	-0.00408	0.86244	7.42174	0.10022	1.0000000000	1.0000000000	1.12877	-0.09002	96	4	1	110	2	0	1.60944	4.57471
8	233678006	Childhood asthma	105	363406005	Malignant tumor of colon	1095	45	6	0	45	6	1044	0.00000	-0.01537	0.00000	0.00000	0.00000	1.0000000000	1.0000000000	0.24658	-0.31797	25	4	0	20	2	0	0.00000	0.00000
7	75498004	Acute bacterial sinusitis (disorder)	105	363406005	Malignant tumor of colon	1095	187	6	1	186	5	903	0.97594	-0.00081	0.97097	8.35923	0.11278	1.0000000000	1.0000000000	1.02466	-0.01768	89	4	1	98	2	0	1.60944	4.49981
6	39848009	Whiplash injury to neck	105	363406005	Malignant tumor of colon	1095	182	6	3	179	3	910	3.00824	0.06655	5.08380	25.39034	1.01791	0.0613317164	0.4828428756	0.99726	1.00198	92	4	3	90	2	0	0.84730	3.45526
5	284549007	Laceration of hand	105	363406005	Malignant tumor of colon	1095	104	6	0	104	6	985	0.00000	-0.02405	0.00000	0.00000	0.00000	1.0000000000	1.0000000000	0.56986	-0.65064	54	4	0	50	2	0	0.00000	0.00000
117	230265002	Familial Alzheimer's disease of early onset (disorder)	79	45816000	Pyelonephritis	1095	6	1	0	6	1	1088	0.00000	-0.00224	0.00000	0.00000	0.00000	1.0000000000	1.0000000000	0.00548	-0.00788	2	1	0	4	0	0	0.00000	0.00000
115	36923009	Major depression  single episode	79	45816000	Pyelonephritis	1095	6	1	0	6	1	1088	0.00000	-0.00224	0.00000	0.00000	0.00000	1.0000000000	1.0000000000	0.00548	-0.00788	3	1	0	3	0	0	0.00000	0.00000
1	444814009	Viral sinusitis (disorder)	105	363406005	Malignant tumor of colon	1095	993	6	5	988	1	101	0.91893	-0.01878	0.51113	4.41785	0.05914	0.4446106905	1.0000000000	5.44110	-0.10234	478	4	3	515	2	2	0.15415	-0.47764
112	49436004	Atrial Fibrillation	79	45816000	Pyelonephritis	1095	35	1	0	35	1	1059	0.00000	-0.00549	0.00000	0.00000	0.00000	1.0000000000	1.0000000000	0.03196	-0.04539	9	1	0	26	0	0	0.00000	0.00000
111	235919008	Cholelithiasis	79	45816000	Pyelonephritis	1095	9	1	0	9	1	1085	0.00000	-0.00275	0.00000	0.00000	0.00000	1.0000000000	1.0000000000	0.00822	-0.01181	7	1	0	2	0	0	0.00000	0.00000
110	65275009	Acute Cholecystitis	79	45816000	Pyelonephritis	1095	9	1	0	9	1	1085	0.00000	-0.00275	0.00000	0.00000	0.00000	1.0000000000	1.0000000000	0.00822	-0.01181	7	1	0	2	0	0	0.00000	0.00000
109	90560007	Gout	79	45816000	Pyelonephritis	1095	4	1	0	4	1	1090	0.00000	-0.00183	0.00000	0.00000	0.00000	1.0000000000	1.0000000000	0.00365	-0.00526	0	1	0	4	0	0	0.00000	0.00000
108	40930008	Hypothyroidism (disorder)	79	45816000	Pyelonephritis	1095	13	1	0	13	1	1081	0.00000	-0.00331	0.00000	0.00000	0.00000	1.0000000000	1.0000000000	0.01187	-0.01703	11	1	0	2	0	0	0.00000	0.00000
107	40275004	Contact dermatitis	79	45816000	Pyelonephritis	1095	18	1	0	18	1	1076	0.00000	-0.00391	0.00000	0.00000	0.00000	1.0000000000	1.0000000000	0.01644	-0.02352	9	1	0	9	0	0	0.00000	0.00000
106	24079001	Atopic dermatitis	79	45816000	Pyelonephritis	1095	20	1	0	20	1	1074	0.00000	-0.00412	0.00000	0.00000	0.00000	1.0000000000	1.0000000000	0.01826	-0.02611	13	1	0	7	0	0	0.00000	0.00000
105	363406005	Malignant tumor of colon	79	45816000	Pyelonephritis	1095	6	1	0	6	1	1088	0.00000	-0.00224	0.00000	0.00000	0.00000	1.0000000000	1.0000000000	0.00548	-0.00788	4	1	0	2	0	0	0.00000	0.00000
104	367498001	Seasonal allergic rhinitis	79	45816000	Pyelonephritis	1095	20	1	0	20	1	1074	0.00000	-0.00412	0.00000	0.00000	0.00000	1.0000000000	1.0000000000	0.01826	-0.02611	9	1	0	11	0	0	0.00000	0.00000
102	90781000119102	Microalbuminuria due to type 2 diabetes mellitus (disorder)	79	45816000	Pyelonephritis	1095	6	1	0	6	1	1088	0.00000	-0.00224	0.00000	0.00000	0.00000	1.0000000000	1.0000000000	0.00548	-0.00788	3	1	0	3	0	0	0.00000	0.00000
101	433144002	Chronic kidney disease stage 3 (disorder)	79	45816000	Pyelonephritis	1095	3	1	0	3	1	1091	0.00000	-0.00158	0.00000	0.00000	0.00000	1.0000000000	1.0000000000	0.00274	-0.00395	1	1	0	2	0	0	0.00000	0.00000
100	161622006	History of lower limb amputation (situation)	79	45816000	Pyelonephritis	1095	1	1	0	1	1	1093	0.00000	-0.00091	0.00000	0.00000	0.00000	1.0000000000	1.0000000000	0.00091	-0.00132	0	1	0	1	0	0	0.00000	0.00000
99	30832001	Rupture of patellar tendon	79	45816000	Pyelonephritis	1095	23	1	0	23	1	1071	0.00000	-0.00443	0.00000	0.00000	0.00000	1.0000000000	1.0000000000	0.02100	-0.02999	14	1	0	9	0	0	0.00000	0.00000
98	1551000119108	Nonproliferative diabetic retinopathy due to type 2 diabetes mellitus (disorder)	79	45816000	Pyelonephritis	1095	12	1	0	12	1	1082	0.00000	-0.00318	0.00000	0.00000	0.00000	1.0000000000	1.0000000000	0.01096	-0.01572	7	1	0	5	0	0	0.00000	0.00000
97	403192003	Third degree burn	79	45816000	Pyelonephritis	1095	8	1	0	8	1	1086	0.00000	-0.00259	0.00000	0.00000	0.00000	1.0000000000	1.0000000000	0.00731	-0.01050	3	1	0	5	0	0	0.00000	0.00000
96	283371005	Laceration of forearm	79	45816000	Pyelonephritis	1095	75	1	0	75	1	1019	0.00000	-0.00820	0.00000	0.00000	0.00000	1.0000000000	1.0000000000	0.06849	-0.09558	39	1	0	36	0	0	0.00000	0.00000
95	84757009	Epilepsy	79	45816000	Pyelonephritis	1095	30	1	0	30	1	1064	0.00000	-0.00507	0.00000	0.00000	0.00000	1.0000000000	1.0000000000	0.02740	-0.03899	13	1	0	17	0	0	0.00000	0.00000
94	703151001	History of single seizure (situation)	79	45816000	Pyelonephritis	1095	39	1	0	39	1	1055	0.00000	-0.00581	0.00000	0.00000	0.00000	1.0000000000	1.0000000000	0.03562	-0.05049	14	1	0	25	0	0	0.00000	0.00000
93	128613002	Seizure disorder	79	45816000	Pyelonephritis	1095	39	1	0	39	1	1055	0.00000	-0.00581	0.00000	0.00000	0.00000	1.0000000000	1.0000000000	0.03562	-0.05049	14	1	0	25	0	0	0.00000	0.00000
89	47693006	Rupture of appendix	79	45816000	Pyelonephritis	1095	20	1	0	20	1	1074	0.00000	-0.00412	0.00000	0.00000	0.00000	1.0000000000	1.0000000000	0.01826	-0.02611	10	1	0	10	0	0	0.00000	0.00000
86	713197008	Recurrent rectal polyp	79	45816000	Pyelonephritis	1095	22	1	0	22	1	1072	0.00000	-0.00433	0.00000	0.00000	0.00000	1.0000000000	1.0000000000	0.02009	-0.02870	12	1	0	10	0	0	0.00000	0.00000
85	241929008	Acute allergic reaction	79	45816000	Pyelonephritis	1095	47	1	0	47	1	1047	0.00000	-0.00640	0.00000	0.00000	0.00000	1.0000000000	1.0000000000	0.04292	-0.06063	25	1	0	22	0	0	0.00000	0.00000
82	94260004	Secondary malignant neoplasm of colon	79	45816000	Pyelonephritis	1095	4	1	0	4	1	1090	0.00000	-0.00183	0.00000	0.00000	0.00000	1.0000000000	1.0000000000	0.00365	-0.00526	2	1	0	2	0	0	0.00000	0.00000
81	236077008	Protracted diarrhea	79	45816000	Pyelonephritis	1095	4	1	0	4	1	1090	0.00000	-0.00183	0.00000	0.00000	0.00000	1.0000000000	1.0000000000	0.00365	-0.00526	2	1	0	2	0	0	0.00000	0.00000
80	6072007	Bleeding from anus	79	45816000	Pyelonephritis	1095	4	1	0	4	1	1090	0.00000	-0.00183	0.00000	0.00000	0.00000	1.0000000000	1.0000000000	0.00365	-0.00526	2	1	0	2	0	0	0.00000	0.00000
78	239872002	Osteoarthritis of hip	79	45816000	Pyelonephritis	1095	21	1	0	21	1	1073	0.00000	-0.00423	0.00000	0.00000	0.00000	1.0000000000	1.0000000000	0.01918	-0.02741	13	1	0	8	0	0	0.00000	0.00000
76	127013003	Diabetic renal disease (disorder)	79	45816000	Pyelonephritis	1095	28	1	0	28	1	1066	0.00000	-0.00490	0.00000	0.00000	0.00000	1.0000000000	1.0000000000	0.02557	-0.03643	10	1	0	18	0	0	0.00000	0.00000
75	431855005	Chronic kidney disease stage 1 (disorder)	79	45816000	Pyelonephritis	1095	28	1	0	28	1	1066	0.00000	-0.00490	0.00000	0.00000	0.00000	1.0000000000	1.0000000000	0.02557	-0.03643	10	1	0	18	0	0	0.00000	0.00000
73	196416002	Impacted molars	79	45816000	Pyelonephritis	1095	49	1	0	49	1	1045	0.00000	-0.00654	0.00000	0.00000	0.00000	1.0000000000	1.0000000000	0.04475	-0.06316	25	1	0	24	0	0	0.00000	0.00000
72	35999006	Blighted ovum	79	45816000	Pyelonephritis	1095	53	1	0	53	1	1041	0.00000	-0.00682	0.00000	0.00000	0.00000	1.0000000000	1.0000000000	0.04840	-0.06819	53	1	0	0	0	0	0.00000	0.00000
71	201834006	Localized  primary osteoarthritis of the hand	79	45816000	Pyelonephritis	1095	28	1	0	28	1	1066	0.00000	-0.00490	0.00000	0.00000	0.00000	1.0000000000	1.0000000000	0.02557	-0.03643	19	1	0	9	0	0	0.00000	0.00000
70	87433001	Pulmonary emphysema (disorder)	79	45816000	Pyelonephritis	1095	17	1	1	16	0	1078	64.41176	0.24076	0.00000	0.00000	0.00000	0.0155251142	0.2122732898	0.01553	0.97777	9	1	1	8	0	0	0.69315	2.30259
69	233604007	Pneumonia	79	45816000	Pyelonephritis	1095	7	1	0	7	1	1087	0.00000	-0.00243	0.00000	0.00000	0.00000	1.0000000000	1.0000000000	0.00639	-0.00919	3	1	0	4	0	0	0.00000	0.00000
68	26929004	Alzheimer's disease (disorder)	79	45816000	Pyelonephritis	1095	23	1	0	23	1	1071	0.00000	-0.00443	0.00000	0.00000	0.00000	1.0000000000	1.0000000000	0.02100	-0.02999	15	1	0	8	0	0	0.00000	0.00000
67	403191005	Second degree burn	79	45816000	Pyelonephritis	1095	49	1	0	49	1	1045	0.00000	-0.00654	0.00000	0.00000	0.00000	1.0000000000	1.0000000000	0.04475	-0.06316	23	1	0	26	0	0	0.00000	0.00000
65	239873007	Osteoarthritis of knee	79	45816000	Pyelonephritis	1095	57	1	0	57	1	1037	0.00000	-0.00708	0.00000	0.00000	0.00000	1.0000000000	1.0000000000	0.05205	-0.07321	30	1	0	27	0	0	0.00000	0.00000
64	444448004	Injury of medial collateral ligament of knee	79	45816000	Pyelonephritis	1095	32	1	0	32	1	1062	0.00000	-0.00525	0.00000	0.00000	0.00000	1.0000000000	1.0000000000	0.02922	-0.04156	17	1	0	15	0	0	0.00000	0.00000
63	68496003	Polyp of colon	79	45816000	Pyelonephritis	1095	91	1	0	91	1	1003	0.00000	-0.00910	0.00000	0.00000	0.00000	1.0000000000	1.0000000000	0.08311	-0.11517	43	1	0	48	0	0	0.00000	0.00000
62	185086009	Chronic obstructive bronchitis (disorder)	79	45816000	Pyelonephritis	1095	6	1	0	6	1	1088	0.00000	-0.00224	0.00000	0.00000	0.00000	1.0000000000	1.0000000000	0.00548	-0.00788	4	1	0	2	0	0	0.00000	0.00000
59	262574004	Bullet wound	79	45816000	Pyelonephritis	1095	20	1	0	20	1	1074	0.00000	-0.00412	0.00000	0.00000	0.00000	1.0000000000	1.0000000000	0.01826	-0.02611	9	1	0	11	0	0	0.00000	0.00000
58	239720000	Tear of meniscus of knee	79	45816000	Pyelonephritis	1095	20	1	0	20	1	1074	0.00000	-0.00412	0.00000	0.00000	0.00000	1.0000000000	1.0000000000	0.01826	-0.02611	10	1	0	10	0	0	0.00000	0.00000
57	192127007	Child attention deficit disorder	79	45816000	Pyelonephritis	1095	76	1	0	76	1	1018	0.00000	-0.00826	0.00000	0.00000	0.00000	1.0000000000	1.0000000000	0.06941	-0.09681	24	1	0	52	0	0	0.00000	0.00000
56	92691004	Carcinoma in situ of prostate (disorder)	79	45816000	Pyelonephritis	1095	23	1	0	23	1	1071	0.00000	-0.00443	0.00000	0.00000	0.00000	1.0000000000	1.0000000000	0.02100	-0.02999	0	1	0	23	0	0	0.00000	0.00000
54	5602001	Opioid abuse (disorder)	79	45816000	Pyelonephritis	1095	7	1	0	7	1	1087	0.00000	-0.00243	0.00000	0.00000	0.00000	1.0000000000	1.0000000000	0.00639	-0.00919	0	1	0	7	0	0	0.00000	0.00000
53	7200002	Alcoholism	79	45816000	Pyelonephritis	1095	5	1	0	5	1	1089	0.00000	-0.00205	0.00000	0.00000	0.00000	1.0000000000	1.0000000000	0.00457	-0.00657	0	1	0	5	0	0	0.00000	0.00000
52	124171000119105	Chronic intractable migraine without aura	79	45816000	Pyelonephritis	1095	51	1	0	51	1	1043	0.00000	-0.00668	0.00000	0.00000	0.00000	1.0000000000	1.0000000000	0.04658	-0.06568	21	1	0	30	0	0	0.00000	0.00000
50	446096008	Perennial allergic rhinitis	79	45816000	Pyelonephritis	1095	26	1	0	26	1	1068	0.00000	-0.00472	0.00000	0.00000	0.00000	1.0000000000	1.0000000000	0.02374	-0.03386	14	1	0	12	0	0	0.00000	0.00000
49	88805009	Chronic congestive heart failure (disorder)	79	45816000	Pyelonephritis	1095	10	1	0	10	1	1084	0.00000	-0.00290	0.00000	0.00000	0.00000	1.0000000000	1.0000000000	0.00913	-0.01312	5	1	0	5	0	0	0.00000	0.00000
47	359817006	Closed fracture of hip	79	45816000	Pyelonephritis	1095	29	1	0	29	1	1065	0.00000	-0.00499	0.00000	0.00000	0.00000	1.0000000000	1.0000000000	0.02648	-0.03771	11	1	0	18	0	0	0.00000	0.00000
46	62564004	Concussion with loss of consciousness	79	45816000	Pyelonephritis	1095	67	1	0	67	1	1027	0.00000	-0.00772	0.00000	0.00000	0.00000	1.0000000000	1.0000000000	0.06119	-0.08568	36	1	0	31	0	0	0.00000	0.00000
45	263102004	Fracture subluxation of wrist	79	45816000	Pyelonephritis	1095	109	1	0	109	1	985	0.00000	-0.01005	0.00000	0.00000	0.00000	1.0000000000	1.0000000000	0.09954	-0.13690	51	1	0	58	0	0	0.00000	0.00000
44	58150001	Fracture of clavicle	79	45816000	Pyelonephritis	1095	112	1	0	112	1	982	0.00000	-0.01021	0.00000	0.00000	0.00000	1.0000000000	1.0000000000	0.10228	-0.14049	55	1	0	57	0	0	0.00000	0.00000
43	307731004	Injury of tendon of the rotator cuff of shoulder	79	45816000	Pyelonephritis	1095	51	1	0	51	1	1043	0.00000	-0.00668	0.00000	0.00000	0.00000	1.0000000000	1.0000000000	0.04658	-0.06568	26	1	0	25	0	0	0.00000	0.00000
42	16114001	Fracture of ankle	79	45816000	Pyelonephritis	1095	108	1	0	108	1	986	0.00000	-0.01000	0.00000	0.00000	0.00000	1.0000000000	1.0000000000	0.09863	-0.13571	48	1	0	60	0	0	0.00000	0.00000
41	283385000	Laceration of thigh	79	45816000	Pyelonephritis	1095	105	1	1	104	0	990	10.42857	0.09284	0.00000	0.00000	0.00000	0.0958904110	0.6155535021	0.09589	0.86790	50	1	1	55	0	0	0.69315	3.93183
40	428251008	History of appendectomy	79	45816000	Pyelonephritis	1095	51	1	0	51	1	1043	0.00000	-0.00668	0.00000	0.00000	0.00000	1.0000000000	1.0000000000	0.04658	-0.06568	27	1	0	24	0	0	0.00000	0.00000
39	74400008	Appendicitis	79	45816000	Pyelonephritis	1095	51	1	0	51	1	1043	0.00000	-0.00668	0.00000	0.00000	0.00000	1.0000000000	1.0000000000	0.04658	-0.06568	27	1	0	24	0	0	0.00000	0.00000
38	398254007	Preeclampsia	79	45816000	Pyelonephritis	1095	101	1	0	101	1	993	0.00000	-0.00964	0.00000	0.00000	0.00000	1.0000000000	1.0000000000	0.09224	-0.12729	101	1	0	0	0	0	0.00000	0.00000
35	19169002	Miscarriage in first trimester	79	45816000	Pyelonephritis	1095	174	1	0	174	1	920	0.00000	-0.01314	0.00000	0.00000	0.00000	1.0000000000	1.0000000000	0.15890	-0.21276	174	1	0	0	0	0	0.00000	0.00000
33	429007001	History of cardiac arrest (situation)	79	45816000	Pyelonephritis	1095	42	1	0	42	1	1052	0.00000	-0.00604	0.00000	0.00000	0.00000	1.0000000000	1.0000000000	0.03836	-0.05430	24	1	0	18	0	0	0.00000	0.00000
32	410429000	Cardiac Arrest	79	45816000	Pyelonephritis	1095	42	1	0	42	1	1052	0.00000	-0.00604	0.00000	0.00000	0.00000	1.0000000000	1.0000000000	0.03836	-0.05430	24	1	0	18	0	0	0.00000	0.00000
30	399211009	History of myocardial infarction (situation)	79	45816000	Pyelonephritis	1095	31	1	0	31	1	1063	0.00000	-0.00516	0.00000	0.00000	0.00000	1.0000000000	1.0000000000	0.02831	-0.04028	2	1	0	29	0	0	0.00000	0.00000
29	22298006	Myocardial Infarction	79	45816000	Pyelonephritis	1095	31	1	0	31	1	1063	0.00000	-0.00516	0.00000	0.00000	0.00000	1.0000000000	1.0000000000	0.02831	-0.04028	2	1	0	29	0	0	0.00000	0.00000
28	53741008	Coronary Heart Disease	79	45816000	Pyelonephritis	1095	80	1	0	80	1	1014	0.00000	-0.00849	0.00000	0.00000	0.00000	1.0000000000	1.0000000000	0.07306	-0.10173	24	1	0	56	0	0	0.00000	0.00000
27	408512008	Body mass index 40+ - severely obese (finding)	79	45816000	Pyelonephritis	1095	97	1	0	97	1	997	0.00000	-0.00943	0.00000	0.00000	0.00000	1.0000000000	1.0000000000	0.08858	-0.12245	67	1	0	30	0	0	0.00000	0.00000
26	33737001	Fracture of rib	79	45816000	Pyelonephritis	1095	54	1	0	54	1	1040	0.00000	-0.00689	0.00000	0.00000	0.00000	1.0000000000	1.0000000000	0.04932	-0.06945	32	1	0	22	0	0	0.00000	0.00000
24	162864005	Body mass index 30+ - obesity (finding)	79	45816000	Pyelonephritis	1095	439	1	0	439	1	655	0.00000	-0.02473	0.00000	0.00000	0.00000	1.0000000000	1.0000000000	0.40091	-0.48637	226	1	0	213	0	0	0.00000	0.00000
23	36971009	Sinusitis (disorder)	79	45816000	Pyelonephritis	1095	190	1	0	190	1	904	0.00000	-0.01385	0.00000	0.00000	0.00000	1.0000000000	1.0000000000	0.17352	-0.23084	84	1	0	106	0	0	0.00000	0.00000
21	15777000	Prediabetes	79	45816000	Pyelonephritis	1095	333	1	0	333	1	761	0.00000	-0.01999	0.00000	0.00000	0.00000	1.0000000000	1.0000000000	0.30411	-0.38307	159	1	0	174	0	0	0.00000	0.00000
20	80394007	Hyperglycemia (disorder)	79	45816000	Pyelonephritis	1095	55	1	0	55	1	1039	0.00000	-0.00695	0.00000	0.00000	0.00000	1.0000000000	1.0000000000	0.05023	-0.07070	23	1	0	32	0	0	0.00000	0.00000
19	237602007	Metabolic syndrome X (disorder)	79	45816000	Pyelonephritis	1095	64	1	0	64	1	1030	0.00000	-0.00753	0.00000	0.00000	0.00000	1.0000000000	1.0000000000	0.05845	-0.08195	28	1	0	36	0	0	0.00000	0.00000
18	302870006	Hypertriglyceridemia (disorder)	79	45816000	Pyelonephritis	1095	64	1	0	64	1	1030	0.00000	-0.00753	0.00000	0.00000	0.00000	1.0000000000	1.0000000000	0.05845	-0.08195	28	1	0	36	0	0	0.00000	0.00000
17	368581000119106	Neuropathy due to type 2 diabetes mellitus (disorder)	79	45816000	Pyelonephritis	1095	28	1	0	28	1	1066	0.00000	-0.00490	0.00000	0.00000	0.00000	1.0000000000	1.0000000000	0.02557	-0.03643	7	1	0	21	0	0	0.00000	0.00000
129	47505003	Posttraumatic stress disorder	53	7200002	Alcoholism	1095	4	5	1	3	4	1087	54.75000	0.22043	90.58333	1067.65884	7.68536	0.0181648506	0.2342772228	0.01826	0.97389	1	0	0	3	5	1	-1.79176	-1.38629
15	40055000	Chronic sinusitis (disorder)	79	45816000	Pyelonephritis	1095	216	1	0	216	1	878	0.00000	-0.01499	0.00000	0.00000	0.00000	1.0000000000	1.0000000000	0.19726	-0.25974	104	1	0	112	0	0	0.00000	0.00000
14	10509002	Acute bronchitis (disorder)	79	45816000	Pyelonephritis	1095	863	1	1	862	0	232	1.26883	0.01568	0.00000	0.00000	0.00000	1.0000000000	1.0000000000	0.78813	0.16155	418	1	1	445	0	0	0.69315	6.03787
13	370247008	Facial laceration	79	45816000	Pyelonephritis	1095	109	1	0	109	1	985	0.00000	-0.01005	0.00000	0.00000	0.00000	1.0000000000	1.0000000000	0.09954	-0.13690	55	1	0	54	0	0	0.00000	0.00000
125	1734006	Fracture of the vertebral column with spinal cord injury	53	7200002	Alcoholism	1095	5	5	0	5	5	1085	0.00000	-0.00459	0.00000	0.00000	0.00000	1.0000000000	1.0000000000	0.02283	-0.03257	3	0	0	2	5	0	0.00000	0.00000
124	1501000119109	Proliferative diabetic retinopathy due to type II diabetes mellitus (disorder)	53	7200002	Alcoholism	1095	1	5	0	1	5	1089	0.00000	-0.00205	0.00000	0.00000	0.00000	1.0000000000	1.0000000000	0.00457	-0.00657	1	0	0	0	5	0	0.00000	0.00000
10	62106007	Concussion with no loss of consciousness	79	45816000	Pyelonephritis	1095	206	1	0	206	1	888	0.00000	-0.01455	0.00000	0.00000	0.00000	1.0000000000	1.0000000000	0.18813	-0.24869	96	1	0	110	0	0	0.00000	0.00000
9	44465007	Sprain of ankle	79	45816000	Pyelonephritis	1095	362	1	0	362	1	732	0.00000	-0.02125	0.00000	0.00000	0.00000	1.0000000000	1.0000000000	0.33059	-0.41207	185	1	0	177	0	0	0.00000	0.00000
8	233678006	Childhood asthma	79	45816000	Pyelonephritis	1095	45	1	0	45	1	1049	0.00000	-0.00626	0.00000	0.00000	0.00000	1.0000000000	1.0000000000	0.04110	-0.05810	25	1	0	20	0	0	0.00000	0.00000
7	75498004	Acute bacterial sinusitis (disorder)	79	45816000	Pyelonephritis	1095	187	1	0	187	1	907	0.00000	-0.01372	0.00000	0.00000	0.00000	1.0000000000	1.0000000000	0.17078	-0.22747	89	1	0	98	0	0	0.00000	0.00000
6	39848009	Whiplash injury to neck	79	45816000	Pyelonephritis	1095	182	1	0	182	1	912	0.00000	-0.01350	0.00000	0.00000	0.00000	1.0000000000	1.0000000000	0.16621	-0.22183	92	1	0	90	0	0	0.00000	0.00000
5	284549007	Laceration of hand	79	45816000	Pyelonephritis	1095	104	1	0	104	1	990	0.00000	-0.00979	0.00000	0.00000	0.00000	1.0000000000	1.0000000000	0.09498	-0.13090	54	1	0	50	0	0	0.00000	0.00000
117	230265002	Familial Alzheimer's disease of early onset (disorder)	53	7200002	Alcoholism	1095	6	5	0	6	5	1084	0.00000	-0.00503	0.00000	0.00000	0.00000	1.0000000000	1.0000000000	0.02740	-0.03899	2	0	0	4	5	0	0.00000	0.00000
115	36923009	Major depression  single episode	53	7200002	Alcoholism	1095	6	5	0	6	5	1084	0.00000	-0.00503	0.00000	0.00000	0.00000	1.0000000000	1.0000000000	0.02740	-0.03899	3	0	0	3	5	0	0.00000	0.00000
1	444814009	Viral sinusitis (disorder)	79	45816000	Pyelonephritis	1095	993	1	1	992	0	102	1.10272	0.00969	0.00000	0.00000	0.00000	1.0000000000	1.0000000000	0.90685	0.06881	478	1	1	515	0	0	0.69315	6.17170
112	49436004	Atrial Fibrillation	53	7200002	Alcoholism	1095	35	5	1	34	4	1056	6.25714	0.06470	7.76471	71.33222	0.84521	0.1501791023	0.7615668168	0.15982	0.78610	9	0	0	26	5	1	-1.79176	-3.29584
111	235919008	Cholelithiasis	53	7200002	Alcoholism	1095	9	5	1	8	4	1082	24.33333	0.14386	33.81250	336.92727	3.39327	0.0404986923	0.3849833570	0.04110	0.94190	7	0	0	2	5	1	-1.79176	-1.09861
110	65275009	Acute Cholecystitis	53	7200002	Alcoholism	1095	9	5	1	8	4	1082	24.33333	0.14386	33.81250	336.92727	3.39327	0.0404986923	0.3849833570	0.04110	0.94190	7	0	0	2	5	1	-1.79176	-1.09861
109	90560007	Gout	53	7200002	Alcoholism	1095	4	5	0	4	5	1086	0.00000	-0.00410	0.00000	0.00000	0.00000	1.0000000000	1.0000000000	0.01826	-0.02611	0	0	0	4	5	0	0.00000	0.00000
108	40930008	Hypothyroidism (disorder)	53	7200002	Alcoholism	1095	13	5	0	13	5	1077	0.00000	-0.00742	0.00000	0.00000	0.00000	1.0000000000	1.0000000000	0.05936	-0.08319	11	0	0	2	5	0	0.00000	0.00000
107	40275004	Contact dermatitis	53	7200002	Alcoholism	1095	18	5	0	18	5	1072	0.00000	-0.00876	0.00000	0.00000	0.00000	1.0000000000	1.0000000000	0.08219	-0.11396	9	0	0	9	5	0	0.00000	0.00000
106	24079001	Atopic dermatitis	53	7200002	Alcoholism	1095	20	5	0	20	5	1070	0.00000	-0.00924	0.00000	0.00000	0.00000	1.0000000000	1.0000000000	0.09132	-0.12608	13	0	0	7	5	0	0.00000	0.00000
105	363406005	Malignant tumor of colon	53	7200002	Alcoholism	1095	6	5	0	6	5	1084	0.00000	-0.00503	0.00000	0.00000	0.00000	1.0000000000	1.0000000000	0.02740	-0.03899	4	0	0	2	5	0	0.00000	0.00000
104	367498001	Seasonal allergic rhinitis	53	7200002	Alcoholism	1095	20	5	0	20	5	1070	0.00000	-0.00924	0.00000	0.00000	0.00000	1.0000000000	1.0000000000	0.09132	-0.12608	9	0	0	11	5	0	0.00000	0.00000
102	90781000119102	Microalbuminuria due to type 2 diabetes mellitus (disorder)	53	7200002	Alcoholism	1095	6	5	1	5	4	1085	36.50000	0.17847	54.25000	575.05459	5.11788	0.0271477435	0.3035705638	0.02740	0.96101	3	0	0	3	5	1	-1.79176	-1.38629
101	433144002	Chronic kidney disease stage 3 (disorder)	53	7200002	Alcoholism	1095	3	5	0	3	5	1087	0.00000	-0.00355	0.00000	0.00000	0.00000	1.0000000000	1.0000000000	0.01370	-0.01963	1	0	0	2	5	0	0.00000	0.00000
100	161622006	History of lower limb amputation (situation)	53	7200002	Alcoholism	1095	1	5	0	1	5	1089	0.00000	-0.00205	0.00000	0.00000	0.00000	1.0000000000	1.0000000000	0.00457	-0.00657	0	0	0	1	5	0	0.00000	0.00000
99	30832001	Rupture of patellar tendon	53	7200002	Alcoholism	1095	23	5	0	23	5	1067	0.00000	-0.00992	0.00000	0.00000	0.00000	1.0000000000	1.0000000000	0.10502	-0.14408	14	0	0	9	5	0	0.00000	0.00000
98	1551000119108	Nonproliferative diabetic retinopathy due to type 2 diabetes mellitus (disorder)	53	7200002	Alcoholism	1095	12	5	0	12	5	1078	0.00000	-0.00713	0.00000	0.00000	0.00000	1.0000000000	1.0000000000	0.05479	-0.07696	7	0	0	5	5	0	0.00000	0.00000
97	403192003	Third degree burn	53	7200002	Alcoholism	1095	8	5	0	8	5	1082	0.00000	-0.00581	0.00000	0.00000	0.00000	1.0000000000	1.0000000000	0.03653	-0.05176	3	0	0	5	5	0	0.00000	0.00000
96	283371005	Laceration of forearm	53	7200002	Alcoholism	1095	75	5	1	74	4	1016	2.92000	0.03526	3.43243	31.10129	0.37881	0.2991294647	0.9871272335	0.34247	0.57511	39	0	0	36	5	1	-1.79176	-3.61092
95	84757009	Epilepsy	53	7200002	Alcoholism	1095	30	5	1	29	4	1061	7.30000	0.07161	9.14655	84.39601	0.99127	0.1299075327	0.7087186589	0.13699	0.81479	13	0	0	17	5	1	-1.79176	-2.89037
94	703151001	History of single seizure (situation)	53	7200002	Alcoholism	1095	39	5	1	38	4	1052	5.61538	0.06007	6.92105	63.41165	0.75540	0.1661227843	0.7915572889	0.17808	0.76356	14	0	0	25	5	1	-1.79176	-3.25810
93	128613002	Seizure disorder	53	7200002	Alcoholism	1095	39	5	1	38	4	1052	5.61538	0.06007	6.92105	63.41165	0.75540	0.1661227843	0.7915572889	0.17808	0.76356	14	0	0	25	5	1	-1.79176	-3.25810
114	449868002	Smokes tobacco daily	34	72892002	Normal pregnancy	1095	9	384	1	8	383	703	0.31684	-0.04570	0.22944	1.84128	0.02859	0.1725791974	0.7996618359	3.15616	-1.05525	2	384	1	7	0	0	5.95324	1.09861
89	47693006	Rupture of appendix	53	7200002	Alcoholism	1095	20	5	0	20	5	1070	0.00000	-0.00924	0.00000	0.00000	0.00000	1.0000000000	1.0000000000	0.09132	-0.12608	10	0	0	10	5	0	0.00000	0.00000
86	713197008	Recurrent rectal polyp	53	7200002	Alcoholism	1095	22	5	0	22	5	1068	0.00000	-0.00970	0.00000	0.00000	0.00000	1.0000000000	1.0000000000	0.10046	-0.13810	12	0	0	10	5	0	0.00000	0.00000
85	241929008	Acute allergic reaction	53	7200002	Alcoholism	1095	47	5	0	47	5	1043	0.00000	-0.01434	0.00000	0.00000	0.00000	1.0000000000	1.0000000000	0.21461	-0.28050	25	0	0	22	5	0	0.00000	0.00000
82	94260004	Secondary malignant neoplasm of colon	53	7200002	Alcoholism	1095	4	5	0	4	5	1086	0.00000	-0.00410	0.00000	0.00000	0.00000	1.0000000000	1.0000000000	0.01826	-0.02611	2	0	0	2	5	0	0.00000	0.00000
81	236077008	Protracted diarrhea	53	7200002	Alcoholism	1095	4	5	0	4	5	1086	0.00000	-0.00410	0.00000	0.00000	0.00000	1.0000000000	1.0000000000	0.01826	-0.02611	2	0	0	2	5	0	0.00000	0.00000
80	6072007	Bleeding from anus	53	7200002	Alcoholism	1095	4	5	0	4	5	1086	0.00000	-0.00410	0.00000	0.00000	0.00000	1.0000000000	1.0000000000	0.01826	-0.02611	2	0	0	2	5	0	0.00000	0.00000
78	239872002	Osteoarthritis of hip	53	7200002	Alcoholism	1095	21	5	1	20	4	1070	10.42857	0.08929	13.37500	125.07279	1.43029	0.0924448091	0.6006517651	0.09589	0.86790	13	0	0	8	5	1	-1.79176	-2.19722
76	127013003	Diabetic renal disease (disorder)	53	7200002	Alcoholism	1095	28	5	2	26	3	1064	15.64286	0.16066	27.28205	170.24438	4.37201	0.0060157679	0.1048123509	0.12785	1.41138	10	0	0	18	5	2	-1.25276	-2.30259
75	431855005	Chronic kidney disease stage 1 (disorder)	53	7200002	Alcoholism	1095	28	5	2	26	3	1064	15.64286	0.16066	27.28205	170.24438	4.37201	0.0060157679	0.1048123509	0.12785	1.41138	10	0	0	18	5	2	-1.25276	-2.30259
73	196416002	Impacted molars	53	7200002	Alcoholism	1095	49	5	1	48	4	1042	4.46939	0.05086	5.42708	49.48801	0.59516	0.2049370625	0.8533859271	0.22374	0.70870	25	0	0	24	5	1	-1.79176	-3.21888
72	35999006	Blighted ovum	53	7200002	Alcoholism	1095	53	5	0	53	5	1037	0.00000	-0.01527	0.00000	0.00000	0.00000	1.0000000000	1.0000000000	0.24201	-0.31268	53	0	0	0	5	0	0.00000	0.00000
71	201834006	Localized  primary osteoarthritis of the hand	53	7200002	Alcoholism	1095	28	5	0	28	5	1062	0.00000	-0.01097	0.00000	0.00000	0.00000	1.0000000000	1.0000000000	0.12785	-0.17358	19	0	0	9	5	0	0.00000	0.00000
70	87433001	Pulmonary emphysema (disorder)	53	7200002	Alcoholism	1095	17	5	0	17	5	1073	0.00000	-0.00851	0.00000	0.00000	0.00000	1.0000000000	1.0000000000	0.07763	-0.10786	9	0	0	8	5	0	0.00000	0.00000
69	233604007	Pneumonia	53	7200002	Alcoholism	1095	7	5	0	7	5	1083	0.00000	-0.00543	0.00000	0.00000	0.00000	1.0000000000	1.0000000000	0.03196	-0.04539	3	0	0	4	5	0	0.00000	0.00000
68	26929004	Alzheimer's disease (disorder)	53	7200002	Alcoholism	1095	23	5	0	23	5	1067	0.00000	-0.00992	0.00000	0.00000	0.00000	1.0000000000	1.0000000000	0.10502	-0.14408	15	0	0	8	5	0	0.00000	0.00000
67	403191005	Second degree burn	53	7200002	Alcoholism	1095	49	5	0	49	5	1041	0.00000	-0.01466	0.00000	0.00000	0.00000	1.0000000000	1.0000000000	0.22374	-0.29130	23	0	0	26	5	0	0.00000	0.00000
65	239873007	Osteoarthritis of knee	53	7200002	Alcoholism	1095	57	5	0	57	5	1033	0.00000	-0.01587	0.00000	0.00000	0.00000	1.0000000000	1.0000000000	0.26027	-0.33374	30	0	0	27	5	0	0.00000	0.00000
64	444448004	Injury of medial collateral ligament of knee	53	7200002	Alcoholism	1095	32	5	0	32	5	1058	0.00000	-0.01175	0.00000	0.00000	0.00000	1.0000000000	1.0000000000	0.14612	-0.19676	17	0	0	15	5	0	0.00000	0.00000
63	68496003	Polyp of colon	53	7200002	Alcoholism	1095	91	5	1	90	4	1000	2.40659	0.02868	2.77778	25.11714	0.30720	0.3525034589	1.0000000000	0.41553	0.49866	43	0	0	48	5	1	-1.79176	-3.89182
62	185086009	Chronic obstructive bronchitis (disorder)	53	7200002	Alcoholism	1095	6	5	0	6	5	1084	0.00000	-0.00503	0.00000	0.00000	0.00000	1.0000000000	1.0000000000	0.02740	-0.03899	4	0	0	2	5	0	0.00000	0.00000
59	262574004	Bullet wound	53	7200002	Alcoholism	1095	20	5	0	20	5	1070	0.00000	-0.00924	0.00000	0.00000	0.00000	1.0000000000	1.0000000000	0.09132	-0.12608	9	0	0	11	5	0	0.00000	0.00000
58	239720000	Tear of meniscus of knee	53	7200002	Alcoholism	1095	20	5	0	20	5	1070	0.00000	-0.00924	0.00000	0.00000	0.00000	1.0000000000	1.0000000000	0.09132	-0.12608	10	0	0	10	5	0	0.00000	0.00000
57	192127007	Child attention deficit disorder	53	7200002	Alcoholism	1095	76	5	0	76	5	1014	0.00000	-0.01850	0.00000	0.00000	0.00000	1.0000000000	1.0000000000	0.34703	-0.42978	24	0	0	52	5	0	0.00000	0.00000
56	92691004	Carcinoma in situ of prostate (disorder)	53	7200002	Alcoholism	1095	23	5	3	20	2	1070	28.56522	0.27346	80.25000	506.84809	12.70610	0.0000789415	0.0027829267	0.10502	1.85592	0	0	0	23	5	3	-0.98083	-2.15948
54	5602001	Opioid abuse (disorder)	53	7200002	Alcoholism	1095	7	5	1	6	4	1084	31.28571	0.16453	45.16667	465.88804	4.37879	0.0316144665	0.3276408342	0.03196	0.95461	0	0	0	7	5	1	-1.79176	-2.07944
52	124171000119105	Chronic intractable migraine without aura	53	7200002	Alcoholism	1095	51	5	2	49	3	1041	8.58824	0.11359	14.16327	86.71636	2.31327	0.0194403188	0.2441303551	0.23288	1.28293	21	0	0	30	5	2	-1.25276	-2.77259
50	446096008	Perennial allergic rhinitis	53	7200002	Alcoholism	1095	26	5	0	26	5	1064	0.00000	-0.01056	0.00000	0.00000	0.00000	1.0000000000	1.0000000000	0.11872	-0.16185	14	0	0	12	5	0	0.00000	0.00000
49	88805009	Chronic congestive heart failure (disorder)	53	7200002	Alcoholism	1095	10	5	0	10	5	1080	0.00000	-0.00650	0.00000	0.00000	0.00000	1.0000000000	1.0000000000	0.04566	-0.06442	5	0	0	5	5	0	0.00000	0.00000
47	359817006	Closed fracture of hip	53	7200002	Alcoholism	1095	29	5	0	29	5	1061	0.00000	-0.01117	0.00000	0.00000	0.00000	1.0000000000	1.0000000000	0.13242	-0.17941	11	0	0	18	5	0	0.00000	0.00000
46	62564004	Concussion with loss of consciousness	53	7200002	Alcoholism	1095	67	5	0	67	5	1023	0.00000	-0.01729	0.00000	0.00000	0.00000	1.0000000000	1.0000000000	0.30594	-0.38508	36	0	0	31	5	0	0.00000	0.00000
45	263102004	Fracture subluxation of wrist	53	7200002	Alcoholism	1095	109	5	1	108	4	982	2.00917	0.02273	2.27315	20.52133	0.25180	0.4086096177	1.0000000000	0.49772	0.41724	51	0	0	58	5	1	-1.79176	-4.07754
44	58150001	Fracture of clavicle	53	7200002	Alcoholism	1095	112	5	1	111	4	979	1.95536	0.02184	2.20495	19.90141	0.24430	0.4175699306	1.0000000000	0.51142	0.40410	55	0	0	57	5	1	-1.79176	-4.06044
43	307731004	Injury of tendon of the rotator cuff of shoulder	53	7200002	Alcoholism	1095	51	5	0	51	5	1039	0.00000	-0.01497	0.00000	0.00000	0.00000	1.0000000000	1.0000000000	0.23288	-0.30203	26	0	0	25	5	0	0.00000	0.00000
42	16114001	Fracture of ankle	53	7200002	Alcoholism	1095	108	5	0	108	5	982	0.00000	-0.02240	0.00000	0.00000	0.00000	1.0000000000	1.0000000000	0.49315	-0.57836	48	0	0	60	5	0	0.00000	0.00000
41	283385000	Laceration of thigh	53	7200002	Alcoholism	1095	105	5	1	104	4	986	2.08571	0.02395	2.37019	21.40399	0.26247	0.3964913401	1.0000000000	0.47945	0.43494	50	0	0	55	5	1	-1.79176	-4.02535
39	74400008	Appendicitis	53	7200002	Alcoholism	1095	51	5	0	51	5	1039	0.00000	-0.01497	0.00000	0.00000	0.00000	1.0000000000	1.0000000000	0.23288	-0.30203	27	0	0	24	5	0	0.00000	0.00000
38	398254007	Preeclampsia	53	7200002	Alcoholism	1095	101	5	0	101	5	989	0.00000	-0.02159	0.00000	0.00000	0.00000	1.0000000000	1.0000000000	0.46119	-0.54714	101	0	0	0	5	0	0.00000	0.00000
35	19169002	Miscarriage in first trimester	53	7200002	Alcoholism	1095	174	5	0	174	5	916	0.00000	-0.02944	0.00000	0.00000	0.00000	1.0000000000	1.0000000000	0.79452	-0.84360	174	0	0	0	5	0	0.00000	0.00000
33	429007001	History of cardiac arrest (situation)	53	7200002	Alcoholism	1095	42	5	0	42	5	1048	0.00000	-0.01353	0.00000	0.00000	0.00000	1.0000000000	1.0000000000	0.19178	-0.25312	24	0	0	18	5	0	0.00000	0.00000
32	410429000	Cardiac Arrest	53	7200002	Alcoholism	1095	42	5	0	42	5	1048	0.00000	-0.01353	0.00000	0.00000	0.00000	1.0000000000	1.0000000000	0.19178	-0.25312	24	0	0	18	5	0	0.00000	0.00000
30	399211009	History of myocardial infarction (situation)	53	7200002	Alcoholism	1095	31	5	0	31	5	1059	0.00000	-0.01156	0.00000	0.00000	0.00000	1.0000000000	1.0000000000	0.14155	-0.19100	2	0	0	29	5	0	0.00000	0.00000
29	22298006	Myocardial Infarction	53	7200002	Alcoholism	1095	31	5	0	31	5	1059	0.00000	-0.01156	0.00000	0.00000	0.00000	1.0000000000	1.0000000000	0.14155	-0.19100	2	0	0	29	5	0	0.00000	0.00000
28	53741008	Coronary Heart Disease	53	7200002	Alcoholism	1095	80	5	0	80	5	1010	0.00000	-0.01901	0.00000	0.00000	0.00000	1.0000000000	1.0000000000	0.36530	-0.44921	24	0	0	56	5	0	0.00000	0.00000
27	408512008	Body mass index 40+ - severely obese (finding)	53	7200002	Alcoholism	1095	97	5	0	97	5	993	0.00000	-0.02112	0.00000	0.00000	0.00000	1.0000000000	1.0000000000	0.44292	-0.52899	67	0	0	30	5	0	0.00000	0.00000
26	33737001	Fracture of rib	53	7200002	Alcoholism	1095	54	5	0	54	5	1036	0.00000	-0.01543	0.00000	0.00000	0.00000	1.0000000000	1.0000000000	0.24658	-0.31797	32	0	0	22	5	0	0.00000	0.00000
24	162864005	Body mass index 30+ - obesity (finding)	53	7200002	Alcoholism	1095	439	5	0	439	5	651	0.00000	-0.05541	0.00000	0.00000	0.00000	0.0869144868	0.5823934082	2.00457	-1.58716	226	0	0	213	5	0	0.00000	0.00000
23	36971009	Sinusitis (disorder)	53	7200002	Alcoholism	1095	190	5	3	187	2	903	3.45789	0.07628	7.24332	43.64949	1.20198	0.0392198424	0.3768817329	0.86758	1.09883	84	0	0	106	5	3	-0.98083	-3.59274
21	15777000	Prediabetes	53	7200002	Alcoholism	1095	333	5	2	331	3	759	1.31532	0.01412	1.52870	9.19138	0.25425	0.6429654520	1.0000000000	1.52055	0.25123	159	0	0	174	5	2	-1.25276	-4.47734
20	80394007	Hyperglycemia (disorder)	53	7200002	Alcoholism	1095	55	5	1	54	4	1036	3.98182	0.04644	4.79630	43.64833	0.52704	0.2275226396	0.8856025459	0.25114	0.67675	23	0	0	32	5	1	-1.79176	-3.49651
19	237602007	Metabolic syndrome X (disorder)	53	7200002	Alcoholism	1095	64	5	2	62	3	1028	6.84375	0.09861	11.05376	67.37224	1.81359	0.0299972108	0.3180139089	0.29224	1.21509	28	0	0	36	5	2	-1.25276	-2.94444
18	302870006	Hypertriglyceridemia (disorder)	53	7200002	Alcoholism	1095	64	5	2	62	3	1028	6.84375	0.09861	11.05376	67.37224	1.81359	0.0299972108	0.3180139089	0.29224	1.21509	28	0	0	36	5	2	-1.25276	-2.94444
17	368581000119106	Neuropathy due to type 2 diabetes mellitus (disorder)	53	7200002	Alcoholism	1095	28	5	0	28	5	1062	0.00000	-0.01097	0.00000	0.00000	0.00000	1.0000000000	1.0000000000	0.12785	-0.17358	7	0	0	21	5	0	0.00000	0.00000
15	40055000	Chronic sinusitis (disorder)	53	7200002	Alcoholism	1095	216	5	1	215	4	875	1.01389	0.00047	1.01744	9.14926	0.11314	1.0000000000	1.0000000000	0.98630	0.00992	104	0	0	112	5	1	-1.79176	-4.72739
14	10509002	Acute bronchitis (disorder)	53	7200002	Alcoholism	1095	863	5	4	859	1	231	1.01506	0.00197	1.07567	9.67032	0.11965	1.0000000000	1.0000000000	3.94064	0.01723	418	0	0	445	5	4	-0.81093	-4.72073
13	370247008	Facial laceration	53	7200002	Alcoholism	1095	109	5	1	108	4	982	2.00917	0.02273	2.27315	20.52133	0.25180	0.4086096177	1.0000000000	0.49772	0.41724	55	0	0	54	5	1	-1.79176	-4.00733
125	1734006	Fracture of the vertebral column with spinal cord injury	27	408512008	Body mass index 40+ - severely obese (finding)	1095	5	97	0	5	97	993	0.00000	-0.02112	0.00000	0.00000	0.00000	1.0000000000	1.0000000000	0.44292	-0.52899	3	67	0	2	30	0	0.00000	0.00000
10	62106007	Concussion with no loss of consciousness	53	7200002	Alcoholism	1095	206	5	0	206	5	884	0.00000	-0.03260	0.00000	0.00000	0.00000	0.5903525073	1.0000000000	0.94064	-0.95653	96	0	0	110	5	0	0.00000	0.00000
9	44465007	Sprain of ankle	53	7200002	Alcoholism	1095	362	5	3	359	2	731	1.81492	0.03879	3.05432	18.36058	0.50809	0.3391869184	1.0000000000	1.65297	0.59239	185	0	0	177	5	3	-0.98083	-4.09434
8	233678006	Childhood asthma	53	7200002	Alcoholism	1095	45	5	0	45	5	1045	0.00000	-0.01402	0.00000	0.00000	0.00000	1.0000000000	1.0000000000	0.20548	-0.26961	25	0	0	20	5	0	0.00000	0.00000
7	75498004	Acute bacterial sinusitis (disorder)	53	7200002	Alcoholism	1095	187	5	0	187	5	903	0.00000	-0.03074	0.00000	0.00000	0.00000	0.5952540318	1.0000000000	0.85388	-0.89055	89	0	0	98	5	0	0.00000	0.00000
6	39848009	Whiplash injury to neck	53	7200002	Alcoholism	1095	182	5	0	182	5	908	0.00000	-0.03024	0.00000	0.00000	0.00000	0.5973128369	1.0000000000	0.83105	-0.87267	92	0	0	90	5	0	0.00000	0.00000
5	284549007	Laceration of hand	53	7200002	Alcoholism	1095	104	5	1	103	4	987	2.10577	0.02426	2.39563	21.63546	0.26526	0.3934309513	1.0000000000	0.47489	0.43940	54	0	0	50	5	1	-1.79176	-3.93183
1	444814009	Viral sinusitis (disorder)	53	7200002	Alcoholism	1095	993	5	5	988	0	102	1.10272	0.02171	0.00000	0.00000	0.00000	1.0000000000	1.0000000000	4.53425	0.11658	478	0	0	515	5	5	-0.69315	-4.64439
96	283371005	Laceration of forearm	27	408512008	Body mass index 40+ - severely obese (finding)	1095	75	97	9	66	88	932	1.35464	0.02998	1.44421	2.99667	0.69602	0.2955119799	0.9835684864	6.64384	0.38763	39	67	6	36	30	3	0.10080	-0.55005
94	703151001	History of single seizure (situation)	27	408512008	Body mass index 40+ - severely obese (finding)	1095	39	97	1	38	96	960	0.28945	-0.04257	0.26316	1.93797	0.03573	0.2471345174	0.9133257124	3.45479	-1.15536	14	67	1	25	30	0	4.21951	2.70805
86	713197008	Recurrent rectal polyp	27	408512008	Body mass index 40+ - severely obese (finding)	1095	22	97	3	19	94	979	1.53936	0.02408	1.64446	5.65939	0.47783	0.4354887544	1.0000000000	1.94886	0.43984	12	67	1	10	30	2	1.44692	0.77319
75	431855005	Chronic kidney disease stage 1 (disorder)	27	408512008	Body mass index 40+ - severely obese (finding)	1095	28	97	2	26	95	972	0.80633	-0.00978	0.78704	3.36727	0.18396	1.0000000000	1.0000000000	2.48037	-0.21428	10	67	1	18	30	1	0.78552	-0.54654
114	449868002	Smokes tobacco daily	36	156073000	Fetus with unknown complication	1095	9	125	0	9	125	961	0.00000	-0.03268	0.00000	0.00000	0.00000	0.6088477644	1.0000000000	1.02740	-1.01963	2	125	0	7	0	0	0.00000	0.00000
44	58150001	Fracture of clavicle	27	408512008	Body mass index 40+ - severely obese (finding)	1095	112	97	20	92	77	906	2.01583	0.10690	2.55788	4.37451	1.49565	0.0012437054	0.0293265925	9.92146	0.94322	55	67	16	57	30	4	-0.49381	-1.23449
42	16114001	Fracture of ankle	27	408512008	Body mass index 40+ - severely obese (finding)	1095	108	97	13	95	84	903	1.35882	0.03700	1.47105	2.73793	0.79038	0.2136501020	0.8672161313	9.56712	0.40584	48	67	8	60	30	5	0.29214	-0.61904
41	283385000	Laceration of thigh	27	408512008	Body mass index 40+ - severely obese (finding)	1095	105	97	14	91	83	907	1.50515	0.05129	1.68119	3.08147	0.91722	0.1023963493	0.6291042150	9.30137	0.54213	50	67	9	55	30	5	0.18760	-0.60459
33	429007001	History of cardiac arrest (situation)	27	408512008	Body mass index 40+ - severely obese (finding)	1095	42	97	5	37	92	961	1.34389	0.02141	1.41157	3.67944	0.54153	0.4113439269	1.0000000000	3.72055	0.34601	24	67	4	18	30	1	-0.55760	-0.99853
130	314994000	Metastasis from malignant tumor of prostate (disorder)	54	5602001	Opioid abuse (disorder)	1095	1	7	0	1	7	1087	0.00000	-0.00243	0.00000	0.00000	0.00000	1.0000000000	1.0000000000	0.00639	-0.00919	0	0	0	1	7	0	0.00000	0.00000
21	15777000	Prediabetes	27	408512008	Body mass index 40+ - severely obese (finding)	1095	333	97	26	307	71	691	0.88140	-0.02444	0.82424	1.31742	0.51569	0.4881341781	1.0000000000	29.49863	-0.17579	159	67	17	174	30	9	0.13127	-0.67499
130	314994000	Metastasis from malignant tumor of prostate (disorder)	1	444814009	Viral sinusitis (disorder)	1095	1	993	1	0	992	102	1.10272	0.00969	0.00000	0.00000	0.00000	1.0000000000	1.0000000000	0.90685	0.06881	0	478	0	1	515	1	-6.24611	-0.69315
129	47505003	Posttraumatic stress disorder	1	444814009	Viral sinusitis (disorder)	1095	4	993	4	0	989	102	1.10272	0.01941	0.00000	0.00000	0.00000	1.0000000000	1.0000000000	3.62740	0.11173	1	478	1	3	515	3	1.02034	0.00000
15	40055000	Chronic sinusitis (disorder)	27	408512008	Body mass index 40+ - severely obese (finding)	1095	216	97	26	190	71	808	1.35882	0.05545	1.55730	2.50733	0.96724	0.0812931454	0.5629813232	19.13425	0.42331	104	67	18	112	30	8	-0.00587	-0.79440
14	10509002	Acute bronchitis (disorder)	27	408512008	Body mass index 40+ - severely obese (finding)	1095	863	97	87	776	10	222	1.13802	0.08299	2.48892	4.86994	1.27203	0.0058405642	0.1027424292	76.44840	0.18427	418	67	61	445	30	26	-0.02610	-0.83593
125	1734006	Fracture of the vertebral column with spinal cord injury	1	444814009	Viral sinusitis (disorder)	1095	5	993	5	0	988	102	1.10272	0.02171	0.00000	0.00000	0.00000	1.0000000000	1.0000000000	4.53425	0.11658	3	478	3	2	515	2	-0.47764	0.00000
118	48333001	Burn injury(morphologic abnormality)	1	444814009	Viral sinusitis (disorder)	1095	1	993	0	1	993	101	0.00000	-0.09433	0.00000	0.00000	0.00000	0.0931506849	0.6037151703	0.90685	-0.93119	0	478	0	1	515	0	0.00000	0.00000
117	230265002	Familial Alzheimer's disease of early onset (disorder)	1	444814009	Viral sinusitis (disorder)	1095	6	993	6	0	987	102	1.10272	0.02379	0.00000	0.00000	0.00000	1.0000000000	1.0000000000	5.44110	0.12005	2	478	2	4	515	4	0.61503	0.00000
115	36923009	Major depression  single episode	1	444814009	Viral sinusitis (disorder)	1095	6	993	6	0	987	102	1.10272	0.02379	0.00000	0.00000	0.00000	1.0000000000	1.0000000000	5.44110	0.12005	3	478	3	3	515	3	-0.07411	0.00000
109	90560007	Gout	1	444814009	Viral sinusitis (disorder)	1095	4	993	4	0	989	102	1.10272	0.01941	0.00000	0.00000	0.00000	1.0000000000	1.0000000000	3.62740	0.11173	0	478	0	4	515	4	-4.86561	-0.69315
106	24079001	Atopic dermatitis	1	444814009	Viral sinusitis (disorder)	1095	20	993	17	3	976	99	0.93731	-0.02668	0.57480	1.99556	0.16556	0.4225700331	1.0000000000	18.13699	-0.08837	13	478	11	7	515	6	-0.66952	0.00697
102	90781000119102	Microalbuminuria due to type 2 diabetes mellitus (disorder)	1	444814009	Viral sinusitis (disorder)	1095	6	993	6	0	987	102	1.10272	0.02379	0.00000	0.00000	0.00000	1.0000000000	1.0000000000	5.44110	0.12005	3	478	3	3	515	3	-0.07411	0.00000
98	1551000119108	Nonproliferative diabetic retinopathy due to type 2 diabetes mellitus (disorder)	1	444814009	Viral sinusitis (disorder)	1095	12	993	12	0	981	102	1.10272	0.03374	0.00000	0.00000	0.00000	0.6168377779	1.0000000000	10.88219	0.12971	7	478	7	5	515	5	-0.40615	0.00000
97	403192003	Third degree burn	1	444814009	Viral sinusitis (disorder)	1095	8	993	8	0	985	102	1.10272	0.02750	0.00000	0.00000	0.00000	1.0000000000	1.0000000000	7.25479	0.12469	3	478	3	5	515	5	0.43286	0.00000
96	283371005	Laceration of forearm	1	444814009	Viral sinusitis (disorder)	1095	75	993	75	0	918	102	1.10272	0.08691	0.00000	0.00000	0.00000	0.0007520928	0.0195901196	68.01370	0.13912	39	478	39	36	515	36	-0.14373	0.00000
94	703151001	History of single seizure (situation)	1	444814009	Viral sinusitis (disorder)	1095	39	993	33	6	960	96	0.93307	-0.04013	0.55000	1.34577	0.22478	0.1676521635	0.7942848378	35.36712	-0.09710	14	478	11	25	515	22	0.59951	0.06188
93	128613002	Seizure disorder	1	444814009	Viral sinusitis (disorder)	1095	39	993	33	6	960	96	0.93307	-0.04013	0.55000	1.34577	0.22478	0.1676521635	0.7942848378	35.36712	-0.09710	14	478	11	25	515	22	0.59951	0.06188
89	47693006	Rupture of appendix	1	444814009	Viral sinusitis (disorder)	1095	20	993	19	1	974	101	1.04758	0.02025	1.97023	14.87143	0.26102	1.0000000000	1.0000000000	18.13699	0.06364	10	478	9	10	515	10	0.03023	0.05407
86	713197008	Recurrent rectal polyp	1	444814009	Viral sinusitis (disorder)	1095	22	993	21	1	972	101	1.05260	0.02350	2.18210	16.39234	0.29047	0.7135922473	1.0000000000	19.95068	0.07051	12	478	11	10	515	10	-0.16635	0.04445
82	94260004	Secondary malignant neoplasm of colon	1	444814009	Viral sinusitis (disorder)	1095	4	993	4	0	989	102	1.10272	0.01941	0.00000	0.00000	0.00000	1.0000000000	1.0000000000	3.62740	0.11173	2	478	2	2	515	2	-0.07426	0.00000
76	127013003	Diabetic renal disease (disorder)	1	444814009	Viral sinusitis (disorder)	1095	28	993	27	1	966	101	1.06334	0.03201	2.82298	20.99369	0.37960	0.5068274534	1.0000000000	25.39178	0.08534	10	478	10	18	515	17	0.44430	-0.02899
75	431855005	Chronic kidney disease stage 1 (disorder)	1	444814009	Viral sinusitis (disorder)	1095	28	993	27	1	966	101	1.06334	0.03201	2.82298	20.99369	0.37960	0.5068274534	1.0000000000	25.39178	0.08534	10	478	10	18	515	17	0.44430	-0.02899
72	35999006	Blighted ovum	1	444814009	Viral sinusitis (disorder)	1095	53	993	52	1	941	101	1.08191	0.05764	5.58130	40.80308	0.76344	0.0533011521	0.4464480091	48.06301	0.11136	53	478	52	0	515	0	2.32163	0.70272
71	201834006	Localized  primary osteoarthritis of the hand	1	444814009	Viral sinusitis (disorder)	1095	28	993	27	1	966	101	1.06334	0.03201	2.82298	20.99369	0.37960	0.5068274534	1.0000000000	25.39178	0.08534	19	478	18	9	515	9	-0.74806	0.02740
69	233604007	Pneumonia	1	444814009	Viral sinusitis (disorder)	1095	7	993	7	0	986	102	1.10272	0.02571	0.00000	0.00000	0.00000	1.0000000000	1.0000000000	6.34795	0.12266	3	478	3	4	515	4	0.21165	0.00000
67	403191005	Second degree burn	1	444814009	Viral sinusitis (disorder)	1095	49	993	46	3	947	99	1.03521	0.02377	1.60296	5.24860	0.48955	0.6150989439	1.0000000000	44.43562	0.04884	23	478	22	26	515	24	0.01190	-0.01835
64	444448004	Injury of medial collateral ligament of knee	1	444814009	Viral sinusitis (disorder)	1095	32	993	29	3	964	99	0.99934	-0.00036	0.99274	3.31764	0.29706	1.0000000000	1.0000000000	29.01918	-0.00092	17	478	16	15	515	13	-0.27420	-0.04334
63	68496003	Polyp of colon	1	444814009	Viral sinusitis (disorder)	1095	91	993	90	1	903	101	1.09060	0.08511	10.06645	73.01991	1.38775	0.0020231254	0.0437413665	82.52329	0.12369	43	478	42	48	515	48	0.05408	0.01183
58	239720000	Tear of meniscus of knee	1	444814009	Viral sinusitis (disorder)	1095	20	993	20	0	973	102	1.10272	0.04372	0.00000	0.00000	0.00000	0.2465034255	0.9133257124	18.13699	0.13403	10	478	10	10	515	10	-0.07308	0.00000
57	192127007	Child attention deficit disorder	1	444814009	Viral sinusitis (disorder)	1095	76	993	73	3	920	99	1.05919	0.05044	2.61848	8.46265	0.81020	0.1036083544	0.6331122908	68.92055	0.08181	24	478	24	52	515	49	0.59731	-0.03015
54	5602001	Opioid abuse (disorder)	1	444814009	Viral sinusitis (disorder)	1095	7	993	7	0	986	102	1.10272	0.02571	0.00000	0.00000	0.00000	1.0000000000	1.0000000000	6.34795	0.12266	0	478	0	7	515	7	-4.31176	-0.69315
50	446096008	Perennial allergic rhinitis	1	444814009	Viral sinusitis (disorder)	1095	26	993	24	2	969	100	1.01789	0.00871	1.23839	5.31708	0.28843	1.0000000000	1.0000000000	23.57808	0.02456	14	478	13	12	515	11	-0.23591	-0.00671
49	88805009	Chronic congestive heart failure (disorder)	1	444814009	Viral sinusitis (disorder)	1095	10	993	9	1	984	101	0.99245	-0.00226	0.92378	7.36567	0.11586	1.0000000000	1.0000000000	9.06849	-0.00985	5	478	4	5	515	5	0.14726	0.11778
47	359817006	Closed fracture of hip	1	444814009	Viral sinusitis (disorder)	1095	29	993	28	1	965	101	1.06469	0.03329	2.93057	21.76623	0.39457	0.5109748310	1.0000000000	26.29863	0.08722	11	478	11	18	515	17	0.35104	-0.02899
44	58150001	Fracture of clavicle	1	444814009	Viral sinusitis (disorder)	1095	112	993	108	4	885	98	1.06334	0.06671	2.98983	8.28762	1.07861	0.0248825372	0.2905941929	101.56712	0.08776	55	478	53	57	515	55	-0.03383	0.00067
43	307731004	Injury of tendon of the rotator cuff of shoulder	1	444814009	Viral sinusitis (disorder)	1095	51	993	49	2	944	100	1.05948	0.04102	2.59534	10.83269	0.62180	0.2215112411	0.8794911525	46.24932	0.08163	26	478	24	25	515	25	-0.03215	0.04082
42	16114001	Fracture of ankle	1	444814009	Viral sinusitis (disorder)	1095	108	993	102	6	891	96	1.04146	0.04279	1.83165	4.28474	0.78300	0.2197858248	0.8771914765	97.93973	0.05802	48	478	46	60	515	56	0.11081	-0.01359
41	283385000	Laceration of thigh	1	444814009	Viral sinusitis (disorder)	1095	105	993	104	1	889	101	1.09222	0.09370	11.81552	85.58459	1.63121	0.0005586955	0.0153737578	95.21918	0.12599	50	478	50	55	515	54	0.00218	-0.00922
39	74400008	Appendicitis	1	444814009	Viral sinusitis (disorder)	1095	51	993	49	2	944	100	1.05948	0.04102	2.59534	10.83269	0.62180	0.2215112411	0.8794911525	46.24932	0.08163	27	478	26	24	515	23	-0.18788	-0.00246
38	398254007	Preeclampsia	1	444814009	Viral sinusitis (disorder)	1095	101	993	100	1	893	101	1.09180	0.09130	11.31019	81.95443	1.56087	0.0008786466	0.0224861813	91.59178	0.12540	101	478	100	0	515	0	1.75440	0.69813
35	19169002	Miscarriage in first trimester	1	444814009	Viral sinusitis (disorder)	1095	174	993	172	2	821	100	1.09004	0.12212	10.47503	42.87577	2.55917	0.0000031277	0.0001468175	157.79178	0.12364	174	478	172	0	515	0	1.32948	0.69894
33	429007001	History of cardiac arrest (situation)	1	444814009	Viral sinusitis (disorder)	1095	42	993	40	2	953	100	1.05021	0.03129	2.09864	8.81350	0.49972	0.4207077914	1.0000000000	38.08767	0.06891	24	478	24	18	515	16	-0.46163	-0.06062
32	410429000	Cardiac Arrest	1	444814009	Viral sinusitis (disorder)	1095	42	993	40	2	953	100	1.05021	0.03129	2.09864	8.81350	0.49972	0.4207077914	1.0000000000	38.08767	0.06891	24	478	24	18	515	16	-0.46163	-0.06062
30	399211009	History of myocardial infarction (situation)	1	444814009	Viral sinusitis (disorder)	1095	31	993	31	0	962	102	1.10272	0.05471	0.00000	0.00000	0.00000	0.1067725795	0.6424490271	28.11233	0.13644	2	478	2	29	515	29	2.54899	0.00000
27	408512008	Body mass index 40+ - severely obese (finding)	1	444814009	Viral sinusitis (disorder)	1095	97	993	97	0	896	102	1.10272	0.09992	0.00000	0.00000	0.00000	0.0000735960	0.0026154901	87.96438	0.13955	67	478	67	30	515	30	-0.80350	0.00000
24	162864005	Body mass index 30+ - obesity (finding)	1	444814009	Viral sinusitis (disorder)	1095	439	993	435	4	558	98	1.09267	0.23654	19.09946	52.31440	6.97302	0.0000000000	0.0000000000	398.10685	0.12755	226	478	223	213	515	212	-0.08700	0.00435
23	36971009	Sinusitis (disorder)	1	444814009	Viral sinusitis (disorder)	1095	190	993	184	6	809	96	1.06790	0.09707	3.63906	8.43083	1.57075	0.0005478711	0.0151233098	172.30137	0.09424	84	478	81	106	515	103	0.13994	0.00389
21	15777000	Prediabetes	1	444814009	Viral sinusitis (disorder)	1095	333	993	330	3	663	99	1.09278	0.19138	16.42534	52.19540	5.16888	0.0000000000	0.0000000000	301.98082	0.12760	159	478	158	174	515	172	0.00776	-0.00264
20	80394007	Hyperglycemia (disorder)	1	444814009	Viral sinusitis (disorder)	1095	55	993	54	1	939	101	1.08267	0.05932	5.80831	42.43357	0.79504	0.0536728323	0.4487524417	49.87671	0.11243	23	478	23	32	515	31	0.21248	-0.01600
18	302870006	Hypertriglyceridemia (disorder)	1	444814009	Viral sinusitis (disorder)	1095	64	993	63	1	930	101	1.08549	0.06646	6.84194	49.85778	0.93891	0.0242893411	0.2869607490	58.03836	0.11642	28	478	28	36	515	35	0.13976	-0.01418
17	368581000119106	Neuropathy due to type 2 diabetes mellitus (disorder)	1	444814009	Viral sinusitis (disorder)	1095	28	993	28	0	965	102	1.10272	0.05192	0.00000	0.00000	0.00000	0.1013878834	0.6291042150	25.39178	0.13596	7	478	7	21	515	21	0.99863	0.00000
15	40055000	Chronic sinusitis (disorder)	1	444814009	Viral sinusitis (disorder)	1095	216	993	212	4	781	98	1.08230	0.12729	6.65045	18.28212	2.41922	0.0000027839	0.0001320946	195.87945	0.11354	104	478	101	112	515	111	0.01636	0.01025
14	10509002	Acute bronchitis (disorder)	1	444814009	Viral sinusitis (disorder)	1095	863	993	826	37	167	65	1.05544	0.33363	8.68911	13.44518	5.61544	0.0000000000	0.0000000000	782.61096	0.07775	418	478	399	445	515	427	-0.00368	0.00267
13	370247008	Facial laceration	1	444814009	Viral sinusitis (disorder)	1095	109	993	107	2	886	100	1.08249	0.08557	6.03837	24.83196	1.46835	0.0025742754	0.0531088071	98.84658	0.11325	55	478	54	54	515	53	-0.08417	-0.00017
10	62106007	Concussion with no loss of consciousness	1	444814009	Viral sinusitis (disorder)	1095	206	993	201	5	792	97	1.07595	0.11408	4.92348	12.25678	1.97774	0.0000464926	0.0017366469	186.81096	0.10507	96	478	93	110	515	108	0.06237	0.00678
7	75498004	Acute bacterial sinusitis (disorder)	1	444814009	Viral sinusitis (disorder)	1095	187	993	182	5	811	97	1.07323	0.10370	4.35364	10.84935	1.74703	0.0002558925	0.0079092403	169.58082	0.10139	89	478	87	98	515	95	0.01134	-0.00424
6	39848009	Whiplash injury to neck	1	444814009	Viral sinusitis (disorder)	1095	182	993	173	9	820	93	1.04819	0.06713	2.18008	4.40589	1.07873	0.0251345596	0.2905941929	165.04658	0.06750	92	478	86	90	515	87	-0.05364	0.01719
5	284549007	Laceration of hand	1	444814009	Viral sinusitis (disorder)	1095	104	993	102	2	891	100	1.08151	0.08239	5.72391	23.55319	1.39103	0.0038237353	0.0732854767	94.31233	0.11191	54	478	53	50	515	49	-0.13876	-0.00076
118	48333001	Burn injury(morphologic abnormality)	11	38341003	Hypertension	1095	1	278	0	1	278	816	0.00000	-0.01764	0.00000	0.00000	0.00000	1.0000000000	1.0000000000	0.25388	-0.32640	0	131	0	1	147	0	0.00000	0.00000
121	254637007	Non-small cell lung cancer (disorder)	11	38341003	Hypertension	1095	8	278	5	3	273	814	2.46178	0.07315	4.96947	20.93077	1.17987	0.0286404444	0.3115313765	2.03105	0.98514	0	131	0	8	147	5	-3.41444	-0.95551
126	698754002	Chronic paralysis due to lesion of spinal cord	11	38341003	Hypertension	1095	2	278	0	2	278	815	0.00000	-0.02495	0.00000	0.00000	0.00000	1.0000000000	1.0000000000	0.50776	-0.59241	2	131	0	0	147	0	0.00000	0.00000
118	48333001	Burn injury(morphologic abnormality)	39	74400008	Appendicitis	1095	1	51	0	1	51	1043	0.00000	-0.00668	0.00000	0.00000	0.00000	1.0000000000	1.0000000000	0.04658	-0.06568	0	27	0	1	24	0	0.00000	0.00000
114	449868002	Smokes tobacco daily	40	428251008	History of appendectomy	1095	9	51	0	9	51	1035	0.00000	-0.02012	0.00000	0.00000	0.00000	1.0000000000	1.0000000000	0.41918	-0.50506	2	27	0	7	24	0	0.00000	0.00000
120	162573006	Suspected lung cancer (situation)	4	195662009	Acute viral pharyngitis (disorder)	1095	8	890	8	0	882	205	1.23034	0.04117	0.00000	0.00000	0.00000	0.3643124531	1.0000000000	6.50228	0.26260	0	430	0	8	460	8	-4.06903	-0.69315
123	195967001	Asthma	4	195662009	Acute viral pharyngitis (disorder)	1095	2	890	2	0	888	205	1.23034	0.02053	0.00000	0.00000	0.00000	1.0000000000	1.0000000000	1.62557	0.19233	1	430	1	1	460	1	-0.06729	0.00000
126	698754002	Chronic paralysis due to lesion of spinal cord	4	195662009	Acute viral pharyngitis (disorder)	1095	2	890	2	0	888	205	1.23034	0.02053	0.00000	0.00000	0.00000	1.0000000000	1.0000000000	1.62557	0.19233	2	430	2	0	460	0	5.37528	0.69315
127	431856006	Chronic kidney disease stage 2 (disorder)	4	195662009	Acute viral pharyngitis (disorder)	1095	5	890	5	0	885	205	1.23034	0.03251	0.00000	0.00000	0.00000	0.5905006408	1.0000000000	4.06393	0.24471	3	430	3	2	460	2	-0.47029	0.00000
130	314994000	Metastasis from malignant tumor of prostate (disorder)	4	195662009	Acute viral pharyngitis (disorder)	1095	1	890	1	0	889	205	1.23034	0.01451	0.00000	0.00000	0.00000	1.0000000000	1.0000000000	0.81279	0.14179	0	430	0	1	460	1	-6.13340	-0.69315
118	48333001	Burn injury(morphologic abnormality)	42	16114001	Fracture of ankle	1095	1	108	0	1	108	986	0.00000	-0.01000	0.00000	0.00000	0.00000	1.0000000000	1.0000000000	0.09863	-0.13571	0	48	0	1	60	0	0.00000	0.00000
130	314994000	Metastasis from malignant tumor of prostate (disorder)	114	449868002	Smokes tobacco daily	1095	1	9	0	1	9	1085	0.00000	-0.00275	0.00000	0.00000	0.00000	1.0000000000	1.0000000000	0.00822	-0.01181	0	2	0	1	7	0	0.00000	0.00000
129	47505003	Posttraumatic stress disorder	114	449868002	Smokes tobacco daily	1095	4	9	1	3	8	1083	30.41667	0.16215	45.12500	481.57879	4.22831	0.0325176279	0.3325947436	0.03288	0.95333	1	2	0	3	7	1	-2.07944	-1.38629
125	1734006	Fracture of the vertebral column with spinal cord injury	114	449868002	Smokes tobacco daily	1095	5	9	0	5	9	1081	0.00000	-0.00617	0.00000	0.00000	0.00000	1.0000000000	1.0000000000	0.04110	-0.05810	3	2	0	2	7	0	0.00000	0.00000
118	48333001	Burn injury(morphologic abnormality)	114	449868002	Smokes tobacco daily	1095	1	9	0	1	9	1085	0.00000	-0.00275	0.00000	0.00000	0.00000	1.0000000000	1.0000000000	0.00822	-0.01181	0	2	0	1	7	0	0.00000	0.00000
117	230265002	Familial Alzheimer's disease of early onset (disorder)	114	449868002	Smokes tobacco daily	1095	6	9	0	6	9	1080	0.00000	-0.00676	0.00000	0.00000	0.00000	1.0000000000	1.0000000000	0.04932	-0.06945	2	2	0	4	7	0	0.00000	0.00000
115	36923009	Major depression  single episode	114	449868002	Smokes tobacco daily	1095	6	9	0	6	9	1080	0.00000	-0.00676	0.00000	0.00000	0.00000	1.0000000000	1.0000000000	0.04932	-0.06945	3	2	0	3	7	0	0.00000	0.00000
109	90560007	Gout	114	449868002	Smokes tobacco daily	1095	4	9	0	4	9	1082	0.00000	-0.00551	0.00000	0.00000	0.00000	1.0000000000	1.0000000000	0.03288	-0.04667	0	2	0	4	7	0	0.00000	0.00000
106	24079001	Atopic dermatitis	114	449868002	Smokes tobacco daily	1095	20	9	0	20	9	1066	0.00000	-0.01242	0.00000	0.00000	0.00000	1.0000000000	1.0000000000	0.16438	-0.21957	13	2	0	7	7	0	0.00000	0.00000
102	90781000119102	Microalbuminuria due to type 2 diabetes mellitus (disorder)	114	449868002	Smokes tobacco daily	1095	6	9	2	4	7	1082	40.55556	0.26729	77.28571	492.97651	12.11636	0.0008862530	0.0226149100	0.04932	1.51551	3	2	1	3	7	1	-0.98083	0.00000
98	1551000119108	Nonproliferative diabetic retinopathy due to type 2 diabetes mellitus (disorder)	114	449868002	Smokes tobacco daily	1095	12	9	0	12	9	1074	0.00000	-0.00958	0.00000	0.00000	0.00000	1.0000000000	1.0000000000	0.09863	-0.13571	7	2	0	5	7	0	0.00000	0.00000
97	403192003	Third degree burn	114	449868002	Smokes tobacco daily	1095	8	9	0	8	9	1078	0.00000	-0.00781	0.00000	0.00000	0.00000	1.0000000000	1.0000000000	0.06575	-0.09187	3	2	0	5	7	0	0.00000	0.00000
96	283371005	Laceration of forearm	114	449868002	Smokes tobacco daily	1095	75	9	2	73	7	1013	3.24444	0.05540	3.96477	19.42900	0.80907	0.1218807241	0.6889733259	0.61644	0.89214	39	2	0	36	7	2	-1.50408	-2.94444
94	703151001	History of single seizure (situation)	114	449868002	Smokes tobacco daily	1095	39	9	1	38	8	1048	3.11966	0.03708	3.44737	28.26189	0.42051	0.2793604780	0.9574808819	0.32055	0.59886	14	2	0	25	7	1	-2.07944	-3.25810
93	128613002	Seizure disorder	114	449868002	Smokes tobacco daily	1095	39	9	1	38	8	1048	3.11966	0.03708	3.44737	28.26189	0.42051	0.2793604780	0.9574808819	0.32055	0.59886	14	2	0	25	7	1	-2.07944	-3.25810
89	47693006	Rupture of appendix	114	449868002	Smokes tobacco daily	1095	20	9	0	20	9	1066	0.00000	-0.01242	0.00000	0.00000	0.00000	1.0000000000	1.0000000000	0.16438	-0.21957	10	2	0	10	7	0	0.00000	0.00000
114	449868002	Smokes tobacco daily	8	233678006	Childhood asthma	1095	9	45	0	9	45	1041	0.00000	-0.01885	0.00000	0.00000	0.00000	1.0000000000	1.0000000000	0.36986	-0.45403	2	25	0	7	20	0	0.00000	0.00000
115	36923009	Major depression  single episode	8	233678006	Childhood asthma	1095	6	45	1	5	44	1045	4.05556	0.04695	4.75000	41.52371	0.54336	0.2230461259	0.8794911525	0.24658	0.68203	3	25	0	3	20	1	-3.04452	-1.38629
86	713197008	Recurrent rectal polyp	114	449868002	Smokes tobacco daily	1095	22	9	2	20	7	1066	11.06061	0.13114	15.22857	77.92252	2.97615	0.0127437787	0.1813045204	0.18082	1.34517	12	2	1	10	7	1	-0.98083	0.16705
117	230265002	Familial Alzheimer's disease of early onset (disorder)	8	233678006	Childhood asthma	1095	6	45	0	6	45	1044	0.00000	-0.01537	0.00000	0.00000	0.00000	1.0000000000	1.0000000000	0.24658	-0.31797	2	25	0	4	20	0	0.00000	0.00000
118	48333001	Burn injury(morphologic abnormality)	8	233678006	Childhood asthma	1095	1	45	0	1	45	1049	0.00000	-0.00626	0.00000	0.00000	0.00000	1.0000000000	1.0000000000	0.04110	-0.05810	0	25	0	1	20	0	0.00000	0.00000
82	94260004	Secondary malignant neoplasm of colon	114	449868002	Smokes tobacco daily	1095	4	9	0	4	9	1082	0.00000	-0.00551	0.00000	0.00000	0.00000	1.0000000000	1.0000000000	0.03288	-0.04667	2	2	0	2	7	0	0.00000	0.00000
124	1501000119109	Proliferative diabetic retinopathy due to type II diabetes mellitus (disorder)	8	233678006	Childhood asthma	1095	1	45	0	1	45	1049	0.00000	-0.00626	0.00000	0.00000	0.00000	1.0000000000	1.0000000000	0.04110	-0.05810	1	25	0	0	20	0	0.00000	0.00000
125	1734006	Fracture of the vertebral column with spinal cord injury	8	233678006	Childhood asthma	1095	5	45	0	5	45	1045	0.00000	-0.01402	0.00000	0.00000	0.00000	1.0000000000	1.0000000000	0.20548	-0.26961	3	25	0	2	20	0	0.00000	0.00000
76	127013003	Diabetic renal disease (disorder)	114	449868002	Smokes tobacco daily	1095	28	9	3	25	6	1061	13.03571	0.17749	21.22000	89.70045	5.01991	0.0011366929	0.0274117856	0.23014	1.70118	10	2	1	18	7	2	-0.40547	0.09531
75	431855005	Chronic kidney disease stage 1 (disorder)	114	449868002	Smokes tobacco daily	1095	28	9	3	25	6	1061	13.03571	0.17749	21.22000	89.70045	5.01991	0.0011366929	0.0274117856	0.23014	1.70118	10	2	1	18	7	2	-0.40547	0.09531
128	86849004	Suicidal deliberate poisoning	8	233678006	Childhood asthma	1095	1	45	0	1	45	1049	0.00000	-0.00626	0.00000	0.00000	0.00000	1.0000000000	1.0000000000	0.04110	-0.05810	0	25	0	1	20	0	0.00000	0.00000
129	47505003	Posttraumatic stress disorder	8	233678006	Childhood asthma	1095	4	45	0	4	45	1046	0.00000	-0.01254	0.00000	0.00000	0.00000	1.0000000000	1.0000000000	0.16438	-0.21957	1	25	0	3	20	0	0.00000	0.00000
72	35999006	Blighted ovum	114	449868002	Smokes tobacco daily	1095	53	9	0	53	9	1033	0.00000	-0.02053	0.00000	0.00000	0.00000	1.0000000000	1.0000000000	0.43562	-0.52167	53	2	0	0	7	0	0.00000	0.00000
71	201834006	Localized  primary osteoarthritis of the hand	114	449868002	Smokes tobacco daily	1095	28	9	0	28	9	1058	0.00000	-0.01475	0.00000	0.00000	0.00000	1.0000000000	1.0000000000	0.23014	-0.29882	19	2	0	9	7	0	0.00000	0.00000
69	233604007	Pneumonia	114	449868002	Smokes tobacco daily	1095	7	9	0	7	9	1079	0.00000	-0.00730	0.00000	0.00000	0.00000	1.0000000000	1.0000000000	0.05753	-0.08070	3	2	0	4	7	0	0.00000	0.00000
67	403191005	Second degree burn	114	449868002	Smokes tobacco daily	1095	49	9	0	49	9	1037	0.00000	-0.01970	0.00000	0.00000	0.00000	1.0000000000	1.0000000000	0.40274	-0.48825	23	2	0	26	7	0	0.00000	0.00000
64	444448004	Injury of medial collateral ligament of knee	114	449868002	Smokes tobacco daily	1095	32	9	1	31	8	1055	3.80208	0.04426	4.25403	35.06427	0.51610	0.2350373794	0.8997636792	0.26301	0.66313	17	2	1	15	7	0	1.09861	2.89037
63	68496003	Polyp of colon	114	449868002	Smokes tobacco daily	1095	91	9	4	87	5	999	5.34799	0.11916	9.18621	34.83482	2.42247	0.0040713760	0.0770227123	0.74795	1.51627	43	2	1	48	7	3	-0.10536	0.95098
59	262574004	Bullet wound	114	449868002	Smokes tobacco daily	1095	20	9	0	20	9	1066	0.00000	-0.01242	0.00000	0.00000	0.00000	1.0000000000	1.0000000000	0.16438	-0.21957	9	2	0	11	7	0	0.00000	0.00000
58	239720000	Tear of meniscus of knee	114	449868002	Smokes tobacco daily	1095	20	9	0	20	9	1066	0.00000	-0.01242	0.00000	0.00000	0.00000	1.0000000000	1.0000000000	0.16438	-0.21957	10	2	0	10	7	0	0.00000	0.00000
57	192127007	Child attention deficit disorder	114	449868002	Smokes tobacco daily	1095	76	9	0	76	9	1010	0.00000	-0.02486	0.00000	0.00000	0.00000	1.0000000000	1.0000000000	0.62466	-0.70014	24	2	0	52	7	0	0.00000	0.00000
54	5602001	Opioid abuse (disorder)	114	449868002	Smokes tobacco daily	1095	7	9	0	7	9	1079	0.00000	-0.00730	0.00000	0.00000	0.00000	1.0000000000	1.0000000000	0.05753	-0.08070	0	2	0	7	7	0	0.00000	0.00000
52	124171000119105	Chronic intractable migraine without aura	114	449868002	Smokes tobacco daily	1095	51	9	1	50	8	1036	2.38562	0.02788	2.59000	21.11106	0.31775	0.3500556115	1.0000000000	0.41918	0.49494	21	2	0	30	7	1	-2.07944	-3.43399
50	446096008	Perennial allergic rhinitis	114	449868002	Smokes tobacco daily	1095	26	9	0	26	9	1060	0.00000	-0.01420	0.00000	0.00000	0.00000	1.0000000000	1.0000000000	0.21370	-0.27941	14	2	0	12	7	0	0.00000	0.00000
49	88805009	Chronic congestive heart failure (disorder)	114	449868002	Smokes tobacco daily	1095	10	9	0	10	9	1076	0.00000	-0.00874	0.00000	0.00000	0.00000	1.0000000000	1.0000000000	0.08219	-0.11396	5	2	0	5	7	0	0.00000	0.00000
47	359817006	Closed fracture of hip	114	449868002	Smokes tobacco daily	1095	29	9	0	29	9	1057	0.00000	-0.01502	0.00000	0.00000	0.00000	1.0000000000	1.0000000000	0.23836	-0.30843	11	2	0	18	7	0	0.00000	0.00000
44	58150001	Fracture of clavicle	114	449868002	Smokes tobacco daily	1095	112	9	2	110	7	976	2.17262	0.03603	2.53506	12.35430	0.52019	0.2327499566	0.8937472100	0.92055	0.64344	55	2	1	57	7	1	-0.98083	-0.03509
43	307731004	Injury of tendon of the rotator cuff of shoulder	114	449868002	Smokes tobacco daily	1095	51	9	0	51	9	1035	0.00000	-0.02012	0.00000	0.00000	0.00000	1.0000000000	1.0000000000	0.41918	-0.50506	26	2	0	25	7	0	0.00000	0.00000
42	16114001	Fracture of ankle	114	449868002	Smokes tobacco daily	1095	108	9	3	105	6	981	3.37963	0.07166	4.67143	18.95194	1.15145	0.0504237802	0.4330919200	0.88767	1.08339	48	2	1	60	7	2	-0.40547	0.45783
41	283385000	Laceration of thigh	114	449868002	Smokes tobacco daily	1095	105	9	0	105	9	981	0.00000	-0.02965	0.00000	0.00000	0.00000	1.0000000000	1.0000000000	0.86301	-0.89764	50	2	0	55	7	0	0.00000	0.00000
39	74400008	Appendicitis	114	449868002	Smokes tobacco daily	1095	51	9	0	51	9	1035	0.00000	-0.02012	0.00000	0.00000	0.00000	1.0000000000	1.0000000000	0.41918	-0.50506	27	2	0	24	7	0	0.00000	0.00000
38	398254007	Preeclampsia	114	449868002	Smokes tobacco daily	1095	101	9	0	101	9	985	0.00000	-0.02902	0.00000	0.00000	0.00000	1.0000000000	1.0000000000	0.83014	-0.87195	101	2	0	0	7	0	0.00000	0.00000
35	19169002	Miscarriage in first trimester	114	449868002	Smokes tobacco daily	1095	174	9	0	174	9	912	0.00000	-0.03957	0.00000	0.00000	0.00000	0.3690178944	1.0000000000	1.43014	-1.28104	174	2	0	0	7	0	0.00000	0.00000
33	429007001	History of cardiac arrest (situation)	114	449868002	Smokes tobacco daily	1095	42	9	0	42	9	1044	0.00000	-0.01818	0.00000	0.00000	0.00000	1.0000000000	1.0000000000	0.34521	-0.42783	24	2	0	18	7	0	0.00000	0.00000
32	410429000	Cardiac Arrest	114	449868002	Smokes tobacco daily	1095	42	9	0	42	9	1044	0.00000	-0.01818	0.00000	0.00000	0.00000	1.0000000000	1.0000000000	0.34521	-0.42783	24	2	0	18	7	0	0.00000	0.00000
30	399211009	History of myocardial infarction (situation)	114	449868002	Smokes tobacco daily	1095	31	9	0	31	9	1055	0.00000	-0.01554	0.00000	0.00000	0.00000	1.0000000000	1.0000000000	0.25479	-0.32745	2	2	0	29	7	0	0.00000	0.00000
27	408512008	Body mass index 40+ - severely obese (finding)	114	449868002	Smokes tobacco daily	1095	97	9	1	96	8	990	1.25430	0.00722	1.28906	10.41560	0.15954	0.5674339172	1.0000000000	0.79726	0.15420	67	2	1	30	7	0	1.09861	4.21951
24	162864005	Body mass index 30+ - obesity (finding)	114	449868002	Smokes tobacco daily	1095	439	9	6	433	3	653	1.66287	0.04936	3.01617	12.12422	0.75034	0.1684564347	0.7953568293	3.60822	0.60315	226	2	2	213	7	4	-0.31845	0.74260
23	36971009	Sinusitis (disorder)	114	449868002	Smokes tobacco daily	1095	190	9	3	187	6	899	1.92105	0.03842	2.40374	9.69739	0.59583	0.1938924316	0.8321439142	1.56164	0.64293	84	2	0	106	7	3	-1.20397	-3.59274
21	15777000	Prediabetes	114	449868002	Smokes tobacco daily	1095	333	9	8	325	1	761	2.92292	0.11572	18.73231	150.37934	2.33343	0.0004556731	0.0128614102	2.73699	1.26805	159	2	2	174	7	6	-0.08004	0.98706
20	80394007	Hyperglycemia (disorder)	114	449868002	Smokes tobacco daily	1095	55	9	3	52	6	1034	6.63636	0.11800	9.94231	40.87096	2.41857	0.0081268902	0.1325982198	0.45205	1.46190	23	2	1	32	7	2	-0.40547	0.34484
132	69896004	Rheumatoid arthritis	88	197927001	Recurrent urinary tract infection	1095	3	8	0	3	8	1084	0.00000	-0.00450	0.00000	0.00000	0.00000	1.0000000000	1.0000000000	0.02192	-0.03128	2	8	0	1	0	0	0.00000	0.00000
18	302870006	Hypertriglyceridemia (disorder)	114	449868002	Smokes tobacco daily	1095	64	9	3	61	6	1025	5.70312	0.10667	8.40164	34.40489	2.05167	0.0124238334	0.1776163030	0.52603	1.39022	28	2	1	36	7	2	-0.40547	0.42286
17	368581000119106	Neuropathy due to type 2 diabetes mellitus (disorder)	114	449868002	Smokes tobacco daily	1095	28	9	1	27	8	1059	4.34524	0.04933	4.90278	40.58755	0.59223	0.2086364532	0.8610424124	0.23014	0.70118	7	2	0	21	7	1	-2.07944	-3.09104
129	47505003	Posttraumatic stress disorder	88	197927001	Recurrent urinary tract infection	1095	4	8	0	4	8	1083	0.00000	-0.00519	0.00000	0.00000	0.00000	1.0000000000	1.0000000000	0.02922	-0.04156	1	8	0	3	0	0	0.00000	0.00000
15	40055000	Chronic sinusitis (disorder)	114	449868002	Smokes tobacco daily	1095	216	9	2	214	7	872	1.12654	0.00571	1.16422	5.64413	0.24014	0.6935767206	1.0000000000	1.77534	0.11230	104	2	0	112	7	2	-1.50408	-4.04305
14	10509002	Acute bronchitis (disorder)	114	449868002	Smokes tobacco daily	1095	863	9	7	856	2	230	0.98687	-0.00231	0.94042	4.55747	0.19405	1.0000000000	1.0000000000	7.09315	-0.01670	418	2	1	445	7	6	0.32542	1.71816
13	370247008	Facial laceration	114	449868002	Smokes tobacco daily	1095	109	9	1	108	8	978	1.11621	0.00352	1.13194	9.13646	0.14024	1.0000000000	1.0000000000	0.89589	0.07712	55	2	0	54	7	1	-2.07944	-4.00733
125	1734006	Fracture of the vertebral column with spinal cord injury	88	197927001	Recurrent urinary tract infection	1095	5	8	0	5	8	1082	0.00000	-0.00581	0.00000	0.00000	0.00000	1.0000000000	1.0000000000	0.03653	-0.05176	3	8	0	2	0	0	0.00000	0.00000
124	1501000119109	Proliferative diabetic retinopathy due to type II diabetes mellitus (disorder)	88	197927001	Recurrent urinary tract infection	1095	1	8	0	1	8	1086	0.00000	-0.00259	0.00000	0.00000	0.00000	1.0000000000	1.0000000000	0.00731	-0.01050	1	8	0	0	0	0	0.00000	0.00000
10	62106007	Concussion with no loss of consciousness	114	449868002	Smokes tobacco daily	1095	206	9	1	205	8	881	0.59061	-0.01794	0.53720	4.31895	0.06682	1.0000000000	1.0000000000	1.69315	-0.42929	96	2	0	110	7	1	-2.07944	-4.70953
121	254637007	Non-small cell lung cancer (disorder)	88	197927001	Recurrent urinary tract infection	1095	8	8	0	8	8	1079	0.00000	-0.00736	0.00000	0.00000	0.00000	1.0000000000	1.0000000000	0.05845	-0.08195	0	8	0	8	0	0	0.00000	0.00000
7	75498004	Acute bacterial sinusitis (disorder)	114	449868002	Smokes tobacco daily	1095	187	9	4	183	5	903	2.60250	0.06620	3.94754	14.84175	1.04995	0.0512338908	0.4379075883	1.53699	0.97881	89	2	1	98	7	3	-0.10536	0.98330
6	39848009	Whiplash injury to neck	114	449868002	Smokes tobacco daily	1095	182	9	3	179	6	907	2.00549	0.04087	2.53352	10.22417	0.62780	0.1764692041	0.8029498763	1.49589	0.68045	92	2	1	90	7	2	-0.40547	0.70396
5	284549007	Laceration of hand	114	449868002	Smokes tobacco daily	1095	104	9	1	103	8	983	1.16987	0.00501	1.19296	9.63289	0.14774	0.5940905237	1.0000000000	0.85479	0.10874	54	2	0	50	7	1	-2.07944	-3.93183
117	230265002	Familial Alzheimer's disease of early onset (disorder)	88	197927001	Recurrent urinary tract infection	1095	6	8	1	5	7	1082	22.81250	0.13890	30.91429	299.83803	3.18736	0.0431395216	0.3985498161	0.04384	0.93811	2	8	1	4	0	0	2.19722	1.09861
116	370143000	Major depression disorder	88	197927001	Recurrent urinary tract infection	1095	8	8	0	8	8	1079	0.00000	-0.00736	0.00000	0.00000	0.00000	1.0000000000	1.0000000000	0.05845	-0.08195	3	8	0	5	0	0	0.00000	0.00000
115	36923009	Major depression  single episode	88	197927001	Recurrent urinary tract infection	1095	6	8	0	6	8	1081	0.00000	-0.00637	0.00000	0.00000	0.00000	1.0000000000	1.0000000000	0.04384	-0.06189	3	8	0	3	0	0	0.00000	0.00000
1	444814009	Viral sinusitis (disorder)	114	449868002	Smokes tobacco daily	1095	993	9	9	984	0	102	1.10272	0.02918	0.00000	0.00000	0.00000	1.0000000000	1.0000000000	8.16164	0.12632	478	2	2	515	7	7	0.00000	1.16888
113	443165006	Pathological fracture due to osteoporosis (disorder)	88	197927001	Recurrent urinary tract infection	1095	10	8	1	9	7	1078	13.68750	0.10449	17.11111	153.74943	1.90433	0.0709862805	0.5245934178	0.07306	0.89827	7	8	1	3	0	0	2.19722	2.07944
112	49436004	Atrial Fibrillation	88	197927001	Recurrent urinary tract infection	1095	35	8	0	35	8	1052	0.00000	-0.01559	0.00000	0.00000	0.00000	1.0000000000	1.0000000000	0.25571	-0.32850	9	8	0	26	0	0	0.00000	0.00000
111	235919008	Cholelithiasis	88	197927001	Recurrent urinary tract infection	1095	9	8	0	9	8	1078	0.00000	-0.00781	0.00000	0.00000	0.00000	1.0000000000	1.0000000000	0.06575	-0.09187	7	8	0	2	0	0	0.00000	0.00000
110	65275009	Acute Cholecystitis	88	197927001	Recurrent urinary tract infection	1095	9	8	0	9	8	1078	0.00000	-0.00781	0.00000	0.00000	0.00000	1.0000000000	1.0000000000	0.06575	-0.09187	7	8	0	2	0	0	0.00000	0.00000
109	90560007	Gout	88	197927001	Recurrent urinary tract infection	1095	4	8	0	4	8	1083	0.00000	-0.00519	0.00000	0.00000	0.00000	1.0000000000	1.0000000000	0.02922	-0.04156	0	8	0	4	0	0	0.00000	0.00000
108	40930008	Hypothyroidism (disorder)	88	197927001	Recurrent urinary tract infection	1095	13	8	1	12	7	1075	10.52885	0.08960	12.79762	112.21552	1.45950	0.0914034373	0.5996557347	0.09498	0.86910	11	8	1	2	0	0	2.19722	2.48491
107	40275004	Contact dermatitis	88	197927001	Recurrent urinary tract infection	1095	18	8	0	18	8	1069	0.00000	-0.01109	0.00000	0.00000	0.00000	1.0000000000	1.0000000000	0.13151	-0.17825	9	8	0	9	0	0	0.00000	0.00000
106	24079001	Atopic dermatitis	88	197927001	Recurrent urinary tract infection	1095	20	8	0	20	8	1067	0.00000	-0.01170	0.00000	0.00000	0.00000	1.0000000000	1.0000000000	0.14612	-0.19676	13	8	0	7	0	0	0.00000	0.00000
105	363406005	Malignant tumor of colon	88	197927001	Recurrent urinary tract infection	1095	6	8	0	6	8	1081	0.00000	-0.00637	0.00000	0.00000	0.00000	1.0000000000	1.0000000000	0.04384	-0.06189	4	8	0	2	0	0	0.00000	0.00000
104	367498001	Seasonal allergic rhinitis	88	197927001	Recurrent urinary tract infection	1095	20	8	0	20	8	1067	0.00000	-0.01170	0.00000	0.00000	0.00000	1.0000000000	1.0000000000	0.14612	-0.19676	9	8	0	11	0	0	0.00000	0.00000
102	90781000119102	Microalbuminuria due to type 2 diabetes mellitus (disorder)	88	197927001	Recurrent urinary tract infection	1095	6	8	0	6	8	1081	0.00000	-0.00637	0.00000	0.00000	0.00000	1.0000000000	1.0000000000	0.04384	-0.06189	3	8	0	3	0	0	0.00000	0.00000
101	433144002	Chronic kidney disease stage 3 (disorder)	88	197927001	Recurrent urinary tract infection	1095	3	8	0	3	8	1084	0.00000	-0.00450	0.00000	0.00000	0.00000	1.0000000000	1.0000000000	0.02192	-0.03128	1	8	0	2	0	0	0.00000	0.00000
100	161622006	History of lower limb amputation (situation)	88	197927001	Recurrent urinary tract infection	1095	1	8	0	1	8	1086	0.00000	-0.00259	0.00000	0.00000	0.00000	1.0000000000	1.0000000000	0.00731	-0.01050	0	8	0	1	0	0	0.00000	0.00000
99	30832001	Rupture of patellar tendon	88	197927001	Recurrent urinary tract infection	1095	23	8	0	23	8	1064	0.00000	-0.01257	0.00000	0.00000	0.00000	1.0000000000	1.0000000000	0.16804	-0.22409	14	8	0	9	0	0	0.00000	0.00000
98	1551000119108	Nonproliferative diabetic retinopathy due to type 2 diabetes mellitus (disorder)	88	197927001	Recurrent urinary tract infection	1095	12	8	0	12	8	1075	0.00000	-0.00903	0.00000	0.00000	0.00000	1.0000000000	1.0000000000	0.08767	-0.12124	7	8	0	5	0	0	0.00000	0.00000
97	403192003	Third degree burn	88	197927001	Recurrent urinary tract infection	1095	8	8	0	8	8	1079	0.00000	-0.00736	0.00000	0.00000	0.00000	1.0000000000	1.0000000000	0.05845	-0.08195	3	8	0	5	0	0	0.00000	0.00000
96	283371005	Laceration of forearm	88	197927001	Recurrent urinary tract infection	1095	75	8	0	75	8	1012	0.00000	-0.02326	0.00000	0.00000	0.00000	1.0000000000	1.0000000000	0.54795	-0.63035	39	8	0	36	0	0	0.00000	0.00000
95	84757009	Epilepsy	88	197927001	Recurrent urinary tract infection	1095	30	8	0	30	8	1057	0.00000	-0.01440	0.00000	0.00000	0.00000	1.0000000000	1.0000000000	0.21918	-0.28591	13	8	0	17	0	0	0.00000	0.00000
94	703151001	History of single seizure (situation)	88	197927001	Recurrent urinary tract infection	1095	39	8	0	39	8	1048	0.00000	-0.01649	0.00000	0.00000	0.00000	1.0000000000	1.0000000000	0.28493	-0.36169	14	8	0	25	0	0	0.00000	0.00000
93	128613002	Seizure disorder	88	197927001	Recurrent urinary tract infection	1095	39	8	0	39	8	1048	0.00000	-0.01649	0.00000	0.00000	0.00000	1.0000000000	1.0000000000	0.28493	-0.36169	14	8	0	25	0	0	0.00000	0.00000
91	64859006	Osteoporosis (disorder)	88	197927001	Recurrent urinary tract infection	1095	37	8	3	34	5	1053	11.09797	0.16200	18.58235	80.94318	4.26600	0.0017721119	0.0387920165	0.27032	1.65481	24	8	3	13	0	0	1.29928	2.19722
89	47693006	Rupture of appendix	88	197927001	Recurrent urinary tract infection	1095	20	8	0	20	8	1067	0.00000	-0.01170	0.00000	0.00000	0.00000	1.0000000000	1.0000000000	0.14612	-0.19676	10	8	0	10	0	0	0.00000	0.00000
86	713197008	Recurrent rectal polyp	88	197927001	Recurrent urinary tract infection	1095	22	8	0	22	8	1065	0.00000	-0.01228	0.00000	0.00000	0.00000	1.0000000000	1.0000000000	0.16073	-0.21503	12	8	0	10	0	0	0.00000	0.00000
85	241929008	Acute allergic reaction	88	197927001	Recurrent urinary tract infection	1095	47	8	0	47	8	1040	0.00000	-0.01817	0.00000	0.00000	0.00000	1.0000000000	1.0000000000	0.34338	-0.42587	25	8	0	22	0	0	0.00000	0.00000
83	110030002	Concussion injury of brain	88	197927001	Recurrent urinary tract infection	1095	7	8	0	7	8	1080	0.00000	-0.00688	0.00000	0.00000	0.00000	1.0000000000	1.0000000000	0.05114	-0.07196	1	8	0	6	0	0	0.00000	0.00000
82	94260004	Secondary malignant neoplasm of colon	88	197927001	Recurrent urinary tract infection	1095	4	8	0	4	8	1083	0.00000	-0.00519	0.00000	0.00000	0.00000	1.0000000000	1.0000000000	0.02922	-0.04156	2	8	0	2	0	0	0.00000	0.00000
81	236077008	Protracted diarrhea	88	197927001	Recurrent urinary tract infection	1095	4	8	0	4	8	1083	0.00000	-0.00519	0.00000	0.00000	0.00000	1.0000000000	1.0000000000	0.02922	-0.04156	2	8	0	2	0	0	0.00000	0.00000
80	6072007	Bleeding from anus	88	197927001	Recurrent urinary tract infection	1095	4	8	0	4	8	1083	0.00000	-0.00519	0.00000	0.00000	0.00000	1.0000000000	1.0000000000	0.02922	-0.04156	2	8	0	2	0	0	0.00000	0.00000
79	45816000	Pyelonephritis	88	197927001	Recurrent urinary tract infection	1095	1	8	0	1	8	1086	0.00000	-0.00259	0.00000	0.00000	0.00000	1.0000000000	1.0000000000	0.00731	-0.01050	1	8	0	0	0	0	0.00000	0.00000
78	239872002	Osteoarthritis of hip	88	197927001	Recurrent urinary tract infection	1095	21	8	1	20	7	1067	6.51786	0.06619	7.62143	64.87359	0.89537	0.1439420804	0.7404942507	0.15342	0.79408	13	8	1	8	0	0	2.19722	2.63906
76	127013003	Diabetic renal disease (disorder)	88	197927001	Recurrent urinary tract infection	1095	28	8	1	27	7	1060	4.88839	0.05404	5.60847	47.18618	0.66661	0.1877127711	0.8181443419	0.20457	0.73149	10	8	1	18	0	0	2.19722	2.39790
75	431855005	Chronic kidney disease stage 1 (disorder)	88	197927001	Recurrent urinary tract infection	1095	28	8	1	27	7	1060	4.88839	0.05404	5.60847	47.18618	0.66661	0.1877127711	0.8181443419	0.20457	0.73149	10	8	1	18	0	0	2.19722	2.39790
73	196416002	Impacted molars	88	197927001	Recurrent urinary tract infection	1095	49	8	0	49	8	1038	0.00000	-0.01857	0.00000	0.00000	0.00000	1.0000000000	1.0000000000	0.35799	-0.44147	25	8	0	24	0	0	0.00000	0.00000
72	35999006	Blighted ovum	88	197927001	Recurrent urinary tract infection	1095	53	8	1	52	7	1035	2.58255	0.03062	2.84341	23.54064	0.34345	0.3284763920	1.0000000000	0.38721	0.52781	53	8	1	0	0	0	2.19722	3.98898
71	201834006	Localized  primary osteoarthritis of the hand	88	197927001	Recurrent urinary tract infection	1095	28	8	1	27	7	1060	4.88839	0.05404	5.60847	47.18618	0.66661	0.1877127711	0.8181443419	0.20457	0.73149	19	8	1	9	0	0	2.19722	2.99573
70	87433001	Pulmonary emphysema (disorder)	88	197927001	Recurrent urinary tract infection	1095	17	8	0	17	8	1070	0.00000	-0.01077	0.00000	0.00000	0.00000	1.0000000000	1.0000000000	0.12420	-0.16890	9	8	0	8	0	0	0.00000	0.00000
69	233604007	Pneumonia	88	197927001	Recurrent urinary tract infection	1095	7	8	0	7	8	1080	0.00000	-0.00688	0.00000	0.00000	0.00000	1.0000000000	1.0000000000	0.05114	-0.07196	3	8	0	4	0	0	0.00000	0.00000
68	26929004	Alzheimer's disease (disorder)	88	197927001	Recurrent urinary tract infection	1095	23	8	0	23	8	1064	0.00000	-0.01257	0.00000	0.00000	0.00000	1.0000000000	1.0000000000	0.16804	-0.22409	15	8	0	8	0	0	0.00000	0.00000
67	403191005	Second degree burn	88	197927001	Recurrent urinary tract infection	1095	49	8	0	49	8	1038	0.00000	-0.01857	0.00000	0.00000	0.00000	1.0000000000	1.0000000000	0.35799	-0.44147	23	8	0	26	0	0	0.00000	0.00000
65	239873007	Osteoarthritis of knee	88	197927001	Recurrent urinary tract infection	1095	57	8	0	57	8	1030	0.00000	-0.02010	0.00000	0.00000	0.00000	1.0000000000	1.0000000000	0.41644	-0.50227	30	8	0	27	0	0	0.00000	0.00000
64	444448004	Injury of medial collateral ligament of knee	88	197927001	Recurrent urinary tract infection	1095	32	8	0	32	8	1055	0.00000	-0.01488	0.00000	0.00000	0.00000	1.0000000000	1.0000000000	0.23379	-0.30310	17	8	0	15	0	0	0.00000	0.00000
63	68496003	Polyp of colon	88	197927001	Recurrent urinary tract infection	1095	91	8	0	91	8	996	0.00000	-0.02583	0.00000	0.00000	0.00000	1.0000000000	1.0000000000	0.66484	-0.73538	43	8	0	48	0	0	0.00000	0.00000
62	185086009	Chronic obstructive bronchitis (disorder)	88	197927001	Recurrent urinary tract infection	1095	6	8	0	6	8	1081	0.00000	-0.00637	0.00000	0.00000	0.00000	1.0000000000	1.0000000000	0.04384	-0.06189	4	8	0	2	0	0	0.00000	0.00000
60	301011002	Escherichia coli urinary tract infection	88	197927001	Recurrent urinary tract infection	1095	92	8	6	86	2	1001	8.92663	0.20595	34.91860	175.63530	6.94228	0.0000073492	0.0003209513	0.67215	2.06565	85	8	6	7	0	0	0.84730	2.71910
59	262574004	Bullet wound	88	197927001	Recurrent urinary tract infection	1095	20	8	0	20	8	1067	0.00000	-0.01170	0.00000	0.00000	0.00000	1.0000000000	1.0000000000	0.14612	-0.19676	9	8	0	11	0	0	0.00000	0.00000
58	239720000	Tear of meniscus of knee	88	197927001	Recurrent urinary tract infection	1095	20	8	0	20	8	1067	0.00000	-0.01170	0.00000	0.00000	0.00000	1.0000000000	1.0000000000	0.14612	-0.19676	10	8	0	10	0	0	0.00000	0.00000
57	192127007	Child attention deficit disorder	88	197927001	Recurrent urinary tract infection	1095	76	8	1	75	7	1012	1.80099	0.01877	1.92762	15.87373	0.23408	0.4386311466	1.0000000000	0.55525	0.36285	24	8	1	52	0	0	2.19722	3.21888
56	92691004	Carcinoma in situ of prostate (disorder)	88	197927001	Recurrent urinary tract infection	1095	23	8	0	23	8	1064	0.00000	-0.01257	0.00000	0.00000	0.00000	1.0000000000	1.0000000000	0.16804	-0.22409	0	8	0	23	0	0	0.00000	0.00000
54	5602001	Opioid abuse (disorder)	88	197927001	Recurrent urinary tract infection	1095	7	8	0	7	8	1080	0.00000	-0.00688	0.00000	0.00000	0.00000	1.0000000000	1.0000000000	0.05114	-0.07196	0	8	0	7	0	0	0.00000	0.00000
53	7200002	Alcoholism	88	197927001	Recurrent urinary tract infection	1095	5	8	0	5	8	1082	0.00000	-0.00581	0.00000	0.00000	0.00000	1.0000000000	1.0000000000	0.03653	-0.05176	0	8	0	5	0	0	0.00000	0.00000
52	124171000119105	Chronic intractable migraine without aura	88	197927001	Recurrent urinary tract infection	1095	51	8	0	51	8	1036	0.00000	-0.01896	0.00000	0.00000	0.00000	1.0000000000	1.0000000000	0.37260	-0.45691	21	8	0	30	0	0	0.00000	0.00000
50	446096008	Perennial allergic rhinitis	88	197927001	Recurrent urinary tract infection	1095	26	8	1	25	7	1062	5.26442	0.05705	6.06857	51.19367	0.71938	0.1754113857	0.8019589290	0.18995	0.74909	14	8	1	12	0	0	2.19722	2.70805
49	88805009	Chronic congestive heart failure (disorder)	88	197927001	Recurrent urinary tract infection	1095	10	8	0	10	8	1077	0.00000	-0.00824	0.00000	0.00000	0.00000	1.0000000000	1.0000000000	0.07306	-0.10173	5	8	0	5	0	0	0.00000	0.00000
47	359817006	Closed fracture of hip	88	197927001	Recurrent urinary tract infection	1095	29	8	0	29	8	1058	0.00000	-0.01415	0.00000	0.00000	0.00000	1.0000000000	1.0000000000	0.21187	-0.27724	11	8	0	18	0	0	0.00000	0.00000
46	62564004	Concussion with loss of consciousness	88	197927001	Recurrent urinary tract infection	1095	67	8	0	67	8	1020	0.00000	-0.02190	0.00000	0.00000	0.00000	1.0000000000	1.0000000000	0.48950	-0.57483	36	8	0	31	0	0	0.00000	0.00000
45	263102004	Fracture subluxation of wrist	88	197927001	Recurrent urinary tract infection	1095	109	8	0	109	8	978	0.00000	-0.02852	0.00000	0.00000	0.00000	1.0000000000	1.0000000000	0.79635	-0.84507	51	8	0	58	0	0	0.00000	0.00000
44	58150001	Fracture of clavicle	88	197927001	Recurrent urinary tract infection	1095	112	8	2	110	6	977	2.44420	0.04182	2.96061	14.84694	0.59037	0.1933228073	0.8313283060	0.81826	0.72240	55	8	2	57	0	0	1.60944	3.34990
43	307731004	Injury of tendon of the rotator cuff of shoulder	88	197927001	Recurrent urinary tract infection	1095	51	8	0	51	8	1036	0.00000	-0.01896	0.00000	0.00000	0.00000	1.0000000000	1.0000000000	0.37260	-0.45691	26	8	0	25	0	0	0.00000	0.00000
42	16114001	Fracture of ankle	88	197927001	Recurrent urinary tract infection	1095	108	8	1	107	7	980	1.26736	0.00759	1.30841	10.73583	0.15946	0.5654865541	1.0000000000	0.78904	0.16081	48	8	1	60	0	0	2.19722	3.89182
41	283385000	Laceration of thigh	88	197927001	Recurrent urinary tract infection	1095	105	8	1	104	7	983	1.30357	0.00848	1.35027	11.08203	0.16452	0.5547693232	1.0000000000	0.76712	0.17860	50	8	1	55	0	0	2.19722	3.93183
40	428251008	History of appendectomy	88	197927001	Recurrent urinary tract infection	1095	51	8	0	51	8	1036	0.00000	-0.01896	0.00000	0.00000	0.00000	1.0000000000	1.0000000000	0.37260	-0.45691	27	8	0	24	0	0	0.00000	0.00000
39	74400008	Appendicitis	88	197927001	Recurrent urinary tract infection	1095	51	8	0	51	8	1036	0.00000	-0.01896	0.00000	0.00000	0.00000	1.0000000000	1.0000000000	0.37260	-0.45691	27	8	0	24	0	0	0.00000	0.00000
38	398254007	Preeclampsia	88	197927001	Recurrent urinary tract infection	1095	101	8	3	98	5	989	4.06559	0.08383	6.05510	25.71899	1.42557	0.0302758577	0.3205807951	0.73790	1.20266	101	8	3	0	0	0	1.29928	3.54578
37	38822007	Cystitis	88	197927001	Recurrent urinary tract infection	1095	71	8	5	66	3	1021	9.63908	0.19515	25.78283	110.22796	6.03072	0.0000480255	0.0017863027	0.51872	1.98211	68	8	5	3	0	0	0.95551	2.68102
35	19169002	Miscarriage in first trimester	88	197927001	Recurrent urinary tract infection	1095	174	8	6	168	2	919	4.71983	0.13871	16.41071	81.99582	3.28445	0.0003155398	0.0094532704	1.27123	1.62388	174	8	6	0	0	0	0.84730	3.40120
33	429007001	History of cardiac arrest (situation)	88	197927001	Recurrent urinary tract infection	1095	42	8	1	41	7	1046	3.25893	0.03870	3.64460	30.31510	0.43817	0.2694179494	0.9388450812	0.30685	0.61391	24	8	1	18	0	0	2.19722	3.21888
32	410429000	Cardiac Arrest	88	197927001	Recurrent urinary tract infection	1095	42	8	1	41	7	1046	3.25893	0.03870	3.64460	30.31510	0.43817	0.2694179494	0.9388450812	0.30685	0.61391	24	8	1	18	0	0	2.19722	3.21888
30	399211009	History of myocardial infarction (situation)	88	197927001	Recurrent urinary tract infection	1095	31	8	0	31	8	1056	0.00000	-0.01464	0.00000	0.00000	0.00000	1.0000000000	1.0000000000	0.22648	-0.29453	2	8	0	29	0	0	0.00000	0.00000
29	22298006	Myocardial Infarction	88	197927001	Recurrent urinary tract infection	1095	31	8	0	31	8	1056	0.00000	-0.01464	0.00000	0.00000	0.00000	1.0000000000	1.0000000000	0.22648	-0.29453	2	8	0	29	0	0	0.00000	0.00000
28	53741008	Coronary Heart Disease	88	197927001	Recurrent urinary tract infection	1095	80	8	1	79	7	1008	1.71094	0.01712	1.82278	15.00125	0.22148	0.4560788859	1.0000000000	0.58447	0.33600	24	8	1	56	0	0	2.19722	3.21888
27	408512008	Body mass index 40+ - severely obese (finding)	88	197927001	Recurrent urinary tract infection	1095	97	8	2	95	6	992	2.82216	0.04873	3.48070	17.48467	0.69291	0.1531437283	0.7711941449	0.70868	0.81208	67	8	2	30	0	0	1.60944	3.54096
26	33737001	Fracture of rib	88	197927001	Recurrent urinary tract infection	1095	54	8	1	53	7	1034	2.53472	0.02999	2.78706	23.06657	0.33675	0.3336320435	1.0000000000	0.39452	0.52023	32	8	1	22	0	0	2.19722	3.49651
24	162864005	Body mass index 30+ - obesity (finding)	88	197927001	Recurrent urinary tract infection	1095	439	8	6	433	2	654	1.87073	0.06111	4.53118	22.55345	0.91035	0.0660586864	0.5033534282	3.20731	0.73446	226	8	6	213	0	0	0.84730	3.65498
23	36971009	Sinusitis (disorder)	88	197927001	Recurrent urinary tract infection	1095	190	8	3	187	5	900	2.16118	0.04564	2.88770	12.18808	0.68418	0.1472481858	0.7510427515	1.38813	0.74412	84	8	3	106	0	0	1.29928	3.36730
21	15777000	Prediabetes	88	197927001	Recurrent urinary tract infection	1095	333	8	6	327	2	760	2.46622	0.08315	6.97248	34.72700	1.39993	0.0118613104	0.1721476562	2.43288	1.02794	159	8	6	174	0	0	0.84730	3.31419
20	80394007	Hyperglycemia (disorder)	88	197927001	Recurrent urinary tract infection	1095	55	8	2	53	6	1034	4.97727	0.07847	6.50314	32.99064	1.28191	0.0570989434	0.4662460696	0.40183	1.09765	23	8	2	32	0	0	1.60944	2.52573
19	237602007	Metabolic syndrome X (disorder)	88	197927001	Recurrent urinary tract infection	1095	64	8	2	62	6	1025	4.27734	0.07005	5.51075	27.86598	1.08980	0.0749717423	0.5403135912	0.46758	1.03152	28	8	2	36	0	0	1.60944	2.70805
18	302870006	Hypertriglyceridemia (disorder)	88	197927001	Recurrent urinary tract infection	1095	64	8	2	62	6	1025	4.27734	0.07005	5.51075	27.86598	1.08980	0.0749717423	0.5403135912	0.46758	1.03152	28	8	2	36	0	0	1.60944	2.70805
17	368581000119106	Neuropathy due to type 2 diabetes mellitus (disorder)	88	197927001	Recurrent urinary tract infection	1095	28	8	0	28	8	1059	0.00000	-0.01390	0.00000	0.00000	0.00000	1.0000000000	1.0000000000	0.20457	-0.26851	7	8	0	21	0	0	0.00000	0.00000
129	47505003	Posttraumatic stress disorder	62	185086009	Chronic obstructive bronchitis (disorder)	1095	4	6	0	4	6	1085	0.00000	-0.00449	0.00000	0.00000	0.00000	1.0000000000	1.0000000000	0.02192	-0.03128	1	4	0	3	2	0	0.00000	0.00000
15	40055000	Chronic sinusitis (disorder)	88	197927001	Recurrent urinary tract infection	1095	216	8	5	211	3	876	3.16840	0.09222	6.91943	29.18225	1.64067	0.0095304276	0.1493894528	1.57808	1.21866	104	8	5	112	0	0	0.95551	3.08191
14	10509002	Acute bronchitis (disorder)	88	197927001	Recurrent urinary tract infection	1095	863	8	8	855	0	232	1.26883	0.04448	0.00000	0.00000	0.00000	0.2149446036	0.8672161313	6.30502	0.30104	418	8	8	445	0	0	0.69315	3.97500
13	370247008	Facial laceration	88	197927001	Recurrent urinary tract infection	1095	109	8	1	108	7	979	1.25573	0.00729	1.29497	10.62474	0.15784	0.5690084463	1.0000000000	0.79635	0.15493	55	8	1	54	0	0	2.19722	4.02535
125	1734006	Fracture of the vertebral column with spinal cord injury	62	185086009	Chronic obstructive bronchitis (disorder)	1095	5	6	0	5	6	1084	0.00000	-0.00503	0.00000	0.00000	0.00000	1.0000000000	1.0000000000	0.02740	-0.03899	3	4	0	2	2	0	0.00000	0.00000
124	1501000119109	Proliferative diabetic retinopathy due to type II diabetes mellitus (disorder)	62	185086009	Chronic obstructive bronchitis (disorder)	1095	1	6	0	1	6	1088	0.00000	-0.00224	0.00000	0.00000	0.00000	1.0000000000	1.0000000000	0.00548	-0.00788	1	4	0	0	2	0	0.00000	0.00000
10	62106007	Concussion with no loss of consciousness	88	197927001	Recurrent urinary tract infection	1095	206	8	2	204	6	883	1.32888	0.01358	1.44281	7.20032	0.28911	0.6494069925	1.0000000000	1.50502	0.26014	96	8	2	110	0	0	1.60944	3.89182
9	44465007	Sprain of ankle	88	197927001	Recurrent urinary tract infection	1095	362	8	4	358	4	729	1.51243	0.03089	2.03631	8.18912	0.50635	0.4510371927	1.0000000000	2.64475	0.45611	185	8	4	177	0	0	1.09861	3.85545
8	233678006	Childhood asthma	88	197927001	Recurrent urinary tract infection	1095	45	8	0	45	8	1042	0.00000	-0.01776	0.00000	0.00000	0.00000	1.0000000000	1.0000000000	0.32877	-0.41009	25	8	0	20	0	0	0.00000	0.00000
7	75498004	Acute bacterial sinusitis (disorder)	88	197927001	Recurrent urinary tract infection	1095	187	8	3	184	5	903	2.19586	0.04656	2.94457	12.42947	0.69757	0.1419383399	0.7403058513	1.36621	0.75742	89	8	3	98	0	0	1.29928	3.42318
6	39848009	Whiplash injury to neck	88	197927001	Recurrent urinary tract infection	1095	182	8	1	181	7	906	0.75206	-0.00950	0.71507	5.84737	0.08745	1.0000000000	1.0000000000	1.32968	-0.22013	92	8	1	90	0	0	2.19722	4.53260
5	284549007	Laceration of hand	88	197927001	Recurrent urinary tract infection	1095	104	8	3	101	5	986	3.94832	0.08194	5.85743	24.86945	1.37958	0.0327268719	0.3332673798	0.75982	1.18457	54	8	3	50	0	0	1.29928	2.94444
4	195662009	Acute viral pharyngitis (disorder)	88	197927001	Recurrent urinary tract infection	1095	890	8	8	882	0	205	1.23034	0.04117	0.00000	0.00000	0.00000	0.3643124531	1.0000000000	6.50228	0.26260	430	8	8	460	0	0	0.69315	4.00278
3	65363002	Otitis media	88	197927001	Recurrent urinary tract infection	1095	580	8	1	579	7	508	0.23599	-0.06956	0.12534	1.02219	0.01537	0.0296239891	0.3171211904	4.23744	-1.38886	277	8	1	303	0	0	2.19722	5.62762
115	36923009	Major depression  single episode	62	185086009	Chronic obstructive bronchitis (disorder)	1095	6	6	0	6	6	1083	0.00000	-0.00551	0.00000	0.00000	0.00000	1.0000000000	1.0000000000	0.03288	-0.04667	3	4	0	3	2	0	0.00000	0.00000
1	444814009	Viral sinusitis (disorder)	88	197927001	Recurrent urinary tract infection	1095	993	8	8	985	0	102	1.10272	0.02750	0.00000	0.00000	0.00000	1.0000000000	1.0000000000	7.25479	0.12469	478	8	8	515	0	0	0.69315	4.10677
111	235919008	Cholelithiasis	62	185086009	Chronic obstructive bronchitis (disorder)	1095	9	6	0	9	6	1080	0.00000	-0.00676	0.00000	0.00000	0.00000	1.0000000000	1.0000000000	0.04932	-0.06945	7	4	0	2	2	0	0.00000	0.00000
128	86849004	Suicidal deliberate poisoning	46	62564004	Concussion with loss of consciousness	1095	1	67	0	1	67	1027	0.00000	-0.00772	0.00000	0.00000	0.00000	1.0000000000	1.0000000000	0.06119	-0.08568	0	36	0	1	31	0	0.00000	0.00000
109	90560007	Gout	62	185086009	Chronic obstructive bronchitis (disorder)	1095	4	6	0	4	6	1085	0.00000	-0.00449	0.00000	0.00000	0.00000	1.0000000000	1.0000000000	0.02192	-0.03128	0	4	0	4	2	0	0.00000	0.00000
108	40930008	Hypothyroidism (disorder)	62	185086009	Chronic obstructive bronchitis (disorder)	1095	13	6	0	13	6	1076	0.00000	-0.00814	0.00000	0.00000	0.00000	1.0000000000	1.0000000000	0.07123	-0.09927	11	4	0	2	2	0	0.00000	0.00000
107	40275004	Contact dermatitis	62	185086009	Chronic obstructive bronchitis (disorder)	1095	18	6	0	18	6	1071	0.00000	-0.00960	0.00000	0.00000	0.00000	1.0000000000	1.0000000000	0.09863	-0.13571	9	4	0	9	2	0	0.00000	0.00000
106	24079001	Atopic dermatitis	62	185086009	Chronic obstructive bronchitis (disorder)	1095	20	6	0	20	6	1069	0.00000	-0.01012	0.00000	0.00000	0.00000	1.0000000000	1.0000000000	0.10959	-0.15003	13	4	0	7	2	0	0.00000	0.00000
105	363406005	Malignant tumor of colon	62	185086009	Chronic obstructive bronchitis (disorder)	1095	6	6	0	6	6	1083	0.00000	-0.00551	0.00000	0.00000	0.00000	1.0000000000	1.0000000000	0.03288	-0.04667	4	4	0	2	2	0	0.00000	0.00000
104	367498001	Seasonal allergic rhinitis	62	185086009	Chronic obstructive bronchitis (disorder)	1095	20	6	0	20	6	1069	0.00000	-0.01012	0.00000	0.00000	0.00000	1.0000000000	1.0000000000	0.10959	-0.15003	9	4	0	11	2	0	0.00000	0.00000
119	275272006	Brain damage - traumatic	22	70704007	Sprain of wrist	1095	4	195	1	3	194	897	1.40385	0.01138	1.54124	14.89572	0.15947	0.5441764707	1.0000000000	0.71233	0.22404	0	90	0	4	105	1	-4.66344	-1.60944
102	90781000119102	Microalbuminuria due to type 2 diabetes mellitus (disorder)	62	185086009	Chronic obstructive bronchitis (disorder)	1095	6	6	0	6	6	1083	0.00000	-0.00551	0.00000	0.00000	0.00000	1.0000000000	1.0000000000	0.03288	-0.04667	3	4	0	3	2	0	0.00000	0.00000
101	433144002	Chronic kidney disease stage 3 (disorder)	62	185086009	Chronic obstructive bronchitis (disorder)	1095	3	6	0	3	6	1086	0.00000	-0.00389	0.00000	0.00000	0.00000	1.0000000000	1.0000000000	0.01644	-0.02352	1	4	0	2	2	0	0.00000	0.00000
100	161622006	History of lower limb amputation (situation)	62	185086009	Chronic obstructive bronchitis (disorder)	1095	1	6	0	1	6	1088	0.00000	-0.00224	0.00000	0.00000	0.00000	1.0000000000	1.0000000000	0.00548	-0.00788	0	4	0	1	2	0	0.00000	0.00000
121	254637007	Non-small cell lung cancer (disorder)	22	70704007	Sprain of wrist	1095	8	195	2	6	193	894	1.40385	0.01613	1.54404	7.70795	0.30930	0.6381889071	1.0000000000	1.42466	0.30718	0	90	0	8	105	2	-3.97968	-1.60944
98	1551000119108	Nonproliferative diabetic retinopathy due to type 2 diabetes mellitus (disorder)	62	185086009	Chronic obstructive bronchitis (disorder)	1095	12	6	0	12	6	1077	0.00000	-0.00781	0.00000	0.00000	0.00000	1.0000000000	1.0000000000	0.06575	-0.09187	7	4	0	5	2	0	0.00000	0.00000
97	403192003	Third degree burn	62	185086009	Chronic obstructive bronchitis (disorder)	1095	8	6	0	8	6	1081	0.00000	-0.00637	0.00000	0.00000	0.00000	1.0000000000	1.0000000000	0.04384	-0.06189	3	4	0	5	2	0	0.00000	0.00000
96	283371005	Laceration of forearm	62	185086009	Chronic obstructive bronchitis (disorder)	1095	75	6	0	75	6	1014	0.00000	-0.02013	0.00000	0.00000	0.00000	1.0000000000	1.0000000000	0.41096	-0.49668	39	4	0	36	2	0	0.00000	0.00000
95	84757009	Epilepsy	62	185086009	Chronic obstructive bronchitis (disorder)	1095	30	6	0	30	6	1059	0.00000	-0.01246	0.00000	0.00000	0.00000	1.0000000000	1.0000000000	0.16438	-0.21957	13	4	0	17	2	0	0.00000	0.00000
94	703151001	History of single seizure (situation)	62	185086009	Chronic obstructive bronchitis (disorder)	1095	39	6	0	39	6	1050	0.00000	-0.01426	0.00000	0.00000	0.00000	1.0000000000	1.0000000000	0.21370	-0.27941	14	4	0	25	2	0	0.00000	0.00000
93	128613002	Seizure disorder	62	185086009	Chronic obstructive bronchitis (disorder)	1095	39	6	0	39	6	1050	0.00000	-0.01426	0.00000	0.00000	0.00000	1.0000000000	1.0000000000	0.21370	-0.27941	14	4	0	25	2	0	0.00000	0.00000
125	1734006	Fracture of the vertebral column with spinal cord injury	22	70704007	Sprain of wrist	1095	5	195	0	5	195	895	0.00000	-0.03153	0.00000	0.00000	0.00000	0.5926416672	1.0000000000	0.89041	-0.91870	3	90	0	2	105	0	0.00000	0.00000
89	47693006	Rupture of appendix	62	185086009	Chronic obstructive bronchitis (disorder)	1095	20	6	0	20	6	1069	0.00000	-0.01012	0.00000	0.00000	0.00000	1.0000000000	1.0000000000	0.10959	-0.15003	10	4	0	10	2	0	0.00000	0.00000
127	431856006	Chronic kidney disease stage 2 (disorder)	22	70704007	Sprain of wrist	1095	5	195	2	3	193	897	2.24615	0.03929	3.09845	18.66860	0.51425	0.2182898045	0.8741550657	0.89041	0.66626	3	90	1	2	105	1	-0.15258	0.28768
86	713197008	Recurrent rectal polyp	62	185086009	Chronic obstructive bronchitis (disorder)	1095	22	6	0	22	6	1067	0.00000	-0.01063	0.00000	0.00000	0.00000	1.0000000000	1.0000000000	0.12055	-0.16420	12	4	0	10	2	0	0.00000	0.00000
128	86849004	Suicidal deliberate poisoning	22	70704007	Sprain of wrist	1095	1	195	0	1	195	899	0.00000	-0.01407	0.00000	0.00000	0.00000	1.0000000000	1.0000000000	0.17808	-0.23644	0	90	0	1	105	0	0.00000	0.00000
129	47505003	Posttraumatic stress disorder	22	70704007	Sprain of wrist	1095	4	195	0	4	195	896	0.00000	-0.02818	0.00000	0.00000	0.00000	1.0000000000	1.0000000000	0.71233	-0.77596	1	90	0	3	105	0	0.00000	0.00000
82	94260004	Secondary malignant neoplasm of colon	62	185086009	Chronic obstructive bronchitis (disorder)	1095	4	6	0	4	6	1085	0.00000	-0.00449	0.00000	0.00000	0.00000	1.0000000000	1.0000000000	0.02192	-0.03128	2	4	0	2	2	0	0.00000	0.00000
130	314994000	Metastasis from malignant tumor of prostate (disorder)	22	70704007	Sprain of wrist	1095	1	195	0	1	195	899	0.00000	-0.01407	0.00000	0.00000	0.00000	1.0000000000	1.0000000000	0.17808	-0.23644	0	90	0	1	105	0	0.00000	0.00000
80	6072007	Bleeding from anus	62	185086009	Chronic obstructive bronchitis (disorder)	1095	4	6	0	4	6	1085	0.00000	-0.00449	0.00000	0.00000	0.00000	1.0000000000	1.0000000000	0.02192	-0.03128	2	4	0	2	2	0	0.00000	0.00000
131	93761005	Primary malignant neoplasm of colon	22	70704007	Sprain of wrist	1095	5	195	1	4	194	896	1.12308	0.00388	1.15464	10.38733	0.12835	1.0000000000	1.0000000000	0.89041	0.08130	3	90	0	2	105	1	-4.66344	-1.09861
78	239872002	Osteoarthritis of hip	62	185086009	Chronic obstructive bronchitis (disorder)	1095	21	6	0	21	6	1068	0.00000	-0.01038	0.00000	0.00000	0.00000	1.0000000000	1.0000000000	0.11507	-0.15713	13	4	0	8	2	0	0.00000	0.00000
132	69896004	Rheumatoid arthritis	22	70704007	Sprain of wrist	1095	3	195	0	3	195	897	0.00000	-0.02440	0.00000	0.00000	0.00000	1.0000000000	1.0000000000	0.53425	-0.61753	2	90	0	1	105	0	0.00000	0.00000
76	127013003	Diabetic renal disease (disorder)	62	185086009	Chronic obstructive bronchitis (disorder)	1095	28	6	0	28	6	1061	0.00000	-0.01202	0.00000	0.00000	0.00000	1.0000000000	1.0000000000	0.15342	-0.20592	10	4	0	18	2	0	0.00000	0.00000
75	431855005	Chronic kidney disease stage 1 (disorder)	62	185086009	Chronic obstructive bronchitis (disorder)	1095	28	6	0	28	6	1061	0.00000	-0.01202	0.00000	0.00000	0.00000	1.0000000000	1.0000000000	0.15342	-0.20592	10	4	0	18	2	0	0.00000	0.00000
73	196416002	Impacted molars	62	185086009	Chronic obstructive bronchitis (disorder)	1095	49	6	0	49	6	1040	0.00000	-0.01607	0.00000	0.00000	0.00000	1.0000000000	1.0000000000	0.26849	-0.34312	25	4	0	24	2	0	0.00000	0.00000
72	35999006	Blighted ovum	62	185086009	Chronic obstructive bronchitis (disorder)	1095	53	6	1	52	5	1037	3.44340	0.04090	3.98846	34.75878	0.45766	0.2579759950	0.9227845495	0.29041	0.63217	53	4	1	0	2	0	1.60944	3.98898
71	201834006	Localized  primary osteoarthritis of the hand	62	185086009	Chronic obstructive bronchitis (disorder)	1095	28	6	0	28	6	1061	0.00000	-0.01202	0.00000	0.00000	0.00000	1.0000000000	1.0000000000	0.15342	-0.20592	19	4	0	9	2	0	0.00000	0.00000
70	87433001	Pulmonary emphysema (disorder)	62	185086009	Chronic obstructive bronchitis (disorder)	1095	17	6	0	17	6	1072	0.00000	-0.00932	0.00000	0.00000	0.00000	1.0000000000	1.0000000000	0.09315	-0.12849	9	4	0	8	2	0	0.00000	0.00000
69	233604007	Pneumonia	62	185086009	Chronic obstructive bronchitis (disorder)	1095	7	6	1	6	5	1083	26.07143	0.14927	36.10000	357.22149	3.64818	0.0378334561	0.3669636219	0.03836	0.94570	3	4	1	4	2	0	1.60944	1.38629
68	26929004	Alzheimer's disease (disorder)	62	185086009	Chronic obstructive bronchitis (disorder)	1095	23	6	2	21	4	1068	15.86957	0.16167	25.42857	146.54566	4.41236	0.0060179340	0.1048123509	0.12603	1.41372	15	4	2	8	2	0	1.09861	2.14007
67	403191005	Second degree burn	62	185086009	Chronic obstructive bronchitis (disorder)	1095	49	6	0	49	6	1040	0.00000	-0.01607	0.00000	0.00000	0.00000	1.0000000000	1.0000000000	0.26849	-0.34312	23	4	0	26	2	0	0.00000	0.00000
65	239873007	Osteoarthritis of knee	62	185086009	Chronic obstructive bronchitis (disorder)	1095	57	6	2	55	4	1034	6.40351	0.09399	9.40000	52.43752	1.68505	0.0348963414	0.3512845005	0.31233	1.19283	30	4	2	27	2	0	1.09861	2.77259
64	444448004	Injury of medial collateral ligament of knee	62	185086009	Chronic obstructive bronchitis (disorder)	1095	32	6	1	31	5	1058	5.70312	0.06057	6.82581	60.17440	0.77428	0.1633666582	0.7879650300	0.17534	0.76692	17	4	1	15	2	0	1.60944	2.89037
63	68496003	Polyp of colon	62	185086009	Chronic obstructive bronchitis (disorder)	1095	91	6	1	90	5	999	2.00549	0.02247	2.22000	19.20846	0.25657	0.4065605096	1.0000000000	0.49863	0.41636	43	4	1	48	2	0	1.60944	3.78419
59	262574004	Bullet wound	62	185086009	Chronic obstructive bronchitis (disorder)	1095	20	6	0	20	6	1069	0.00000	-0.01012	0.00000	0.00000	0.00000	1.0000000000	1.0000000000	0.10959	-0.15003	9	4	0	11	2	0	0.00000	0.00000
58	239720000	Tear of meniscus of knee	62	185086009	Chronic obstructive bronchitis (disorder)	1095	20	6	0	20	6	1069	0.00000	-0.01012	0.00000	0.00000	0.00000	1.0000000000	1.0000000000	0.10959	-0.15003	10	4	0	10	2	0	0.00000	0.00000
57	192127007	Child attention deficit disorder	62	185086009	Chronic obstructive bronchitis (disorder)	1095	76	6	0	76	6	1013	0.00000	-0.02027	0.00000	0.00000	0.00000	1.0000000000	1.0000000000	0.41644	-0.50227	24	4	0	52	2	0	0.00000	0.00000
56	92691004	Carcinoma in situ of prostate (disorder)	62	185086009	Chronic obstructive bronchitis (disorder)	1095	23	6	0	23	6	1066	0.00000	-0.01087	0.00000	0.00000	0.00000	1.0000000000	1.0000000000	0.12603	-0.17124	0	4	0	23	2	0	0.00000	0.00000
54	5602001	Opioid abuse (disorder)	62	185086009	Chronic obstructive bronchitis (disorder)	1095	7	6	0	7	6	1082	0.00000	-0.00595	0.00000	0.00000	0.00000	1.0000000000	1.0000000000	0.03836	-0.05430	0	4	0	7	2	0	0.00000	0.00000
52	124171000119105	Chronic intractable migraine without aura	62	185086009	Chronic obstructive bronchitis (disorder)	1095	51	6	0	51	6	1038	0.00000	-0.01641	0.00000	0.00000	0.00000	1.0000000000	1.0000000000	0.27945	-0.35553	21	4	0	30	2	0	0.00000	0.00000
50	446096008	Perennial allergic rhinitis	62	185086009	Chronic obstructive bronchitis (disorder)	1095	26	6	0	26	6	1063	0.00000	-0.01158	0.00000	0.00000	0.00000	1.0000000000	1.0000000000	0.14247	-0.19215	14	4	0	12	2	0	0.00000	0.00000
49	88805009	Chronic congestive heart failure (disorder)	62	185086009	Chronic obstructive bronchitis (disorder)	1095	10	6	0	10	6	1079	0.00000	-0.00713	0.00000	0.00000	0.00000	1.0000000000	1.0000000000	0.05479	-0.07696	5	4	0	5	2	0	0.00000	0.00000
47	359817006	Closed fracture of hip	62	185086009	Chronic obstructive bronchitis (disorder)	1095	29	6	1	28	5	1061	6.29310	0.06480	7.57857	67.01435	0.85705	0.1490655320	0.7572321990	0.15890	0.78724	11	4	1	18	2	0	1.60944	2.48491
46	62564004	Concussion with loss of consciousness	62	185086009	Chronic obstructive bronchitis (disorder)	1095	67	6	2	65	4	1024	5.44776	0.08428	7.87692	43.80431	1.41643	0.0471509279	0.4168085046	0.36712	1.13382	36	4	2	31	2	0	1.09861	2.94444
45	263102004	Fracture subluxation of wrist	62	185086009	Chronic obstructive bronchitis (disorder)	1095	109	6	1	108	5	981	1.67431	0.01664	1.81667	15.69300	0.21030	0.4677486559	1.0000000000	0.59726	0.32440	51	4	1	58	2	0	1.60944	3.95124
44	58150001	Fracture of clavicle	62	185086009	Chronic obstructive bronchitis (disorder)	1095	112	6	1	111	5	978	1.62946	0.01577	1.76216	15.21882	0.20404	0.4774159561	1.0000000000	0.61370	0.30963	55	4	0	57	2	1	-1.09861	-4.06044
43	307731004	Injury of tendon of the rotator cuff of shoulder	62	185086009	Chronic obstructive bronchitis (disorder)	1095	51	6	0	51	6	1038	0.00000	-0.01641	0.00000	0.00000	0.00000	1.0000000000	1.0000000000	0.27945	-0.35553	26	4	0	25	2	0	0.00000	0.00000
42	16114001	Fracture of ankle	62	185086009	Chronic obstructive bronchitis (disorder)	1095	108	6	1	107	5	982	1.68981	0.01694	1.83551	15.85701	0.21247	0.4644932960	1.0000000000	0.59178	0.32936	48	4	0	60	2	1	-1.09861	-4.11087
41	283385000	Laceration of thigh	62	185086009	Chronic obstructive bronchitis (disorder)	1095	105	6	1	104	5	985	1.73810	0.01784	1.89423	16.36815	0.21921	0.4546274954	1.0000000000	0.57534	0.34433	50	4	1	55	2	0	1.60944	3.93183
39	74400008	Appendicitis	62	185086009	Chronic obstructive bronchitis (disorder)	1095	51	6	0	51	6	1038	0.00000	-0.01641	0.00000	0.00000	0.00000	1.0000000000	1.0000000000	0.27945	-0.35553	27	4	0	24	2	0	0.00000	0.00000
38	398254007	Preeclampsia	62	185086009	Chronic obstructive bronchitis (disorder)	1095	101	6	1	100	5	989	1.80693	0.01909	1.97800	17.09780	0.22883	0.4412378809	1.0000000000	0.55342	0.36455	101	4	1	0	2	0	1.60944	4.62497
35	19169002	Miscarriage in first trimester	62	185086009	Chronic obstructive bronchitis (disorder)	1095	174	6	2	172	4	917	2.09770	0.03542	2.66570	14.66761	0.48447	0.2443763068	0.9133257124	0.95342	0.61896	174	4	2	0	2	0	1.09861	4.47734
33	429007001	History of cardiac arrest (situation)	62	185086009	Chronic obstructive bronchitis (disorder)	1095	42	6	0	42	6	1047	0.00000	-0.01482	0.00000	0.00000	0.00000	1.0000000000	1.0000000000	0.23014	-0.29882	24	4	0	18	2	0	0.00000	0.00000
32	410429000	Cardiac Arrest	62	185086009	Chronic obstructive bronchitis (disorder)	1095	42	6	0	42	6	1047	0.00000	-0.01482	0.00000	0.00000	0.00000	1.0000000000	1.0000000000	0.23014	-0.29882	24	4	0	18	2	0	0.00000	0.00000
30	399211009	History of myocardial infarction (situation)	62	185086009	Chronic obstructive bronchitis (disorder)	1095	31	6	0	31	6	1058	0.00000	-0.01267	0.00000	0.00000	0.00000	1.0000000000	1.0000000000	0.16986	-0.22634	2	4	0	29	2	0	0.00000	0.00000
29	22298006	Myocardial Infarction	62	185086009	Chronic obstructive bronchitis (disorder)	1095	31	6	0	31	6	1058	0.00000	-0.01267	0.00000	0.00000	0.00000	1.0000000000	1.0000000000	0.16986	-0.22634	2	4	0	29	2	0	0.00000	0.00000
27	408512008	Body mass index 40+ - severely obese (finding)	62	185086009	Chronic obstructive bronchitis (disorder)	1095	97	6	1	96	5	993	1.88144	0.02040	2.06875	17.88881	0.23924	0.4275754365	1.0000000000	0.53151	0.38505	67	4	0	30	2	1	-1.09861	-3.43399
24	162864005	Body mass index 30+ - obesity (finding)	62	185086009	Chronic obstructive bronchitis (disorder)	1095	439	6	5	434	1	655	2.07859	0.06549	7.54608	64.81186	0.87859	0.0409592279	0.3866022603	2.40548	0.81710	226	4	3	213	2	2	0.15415	-0.34238
23	36971009	Sinusitis (disorder)	62	185086009	Chronic obstructive bronchitis (disorder)	1095	190	6	2	188	4	901	1.92105	0.03133	2.39628	13.17810	0.43573	0.2796546353	0.9574808819	1.04110	0.55562	84	4	2	106	2	0	1.09861	3.76120
21	15777000	Prediabetes	62	185086009	Chronic obstructive bronchitis (disorder)	1095	333	6	2	331	4	758	1.09610	0.00472	1.14502	6.28209	0.20870	1.0000000000	1.0000000000	1.82466	0.08689	159	4	2	174	2	0	1.09861	4.38826
20	80394007	Hyperglycemia (disorder)	62	185086009	Chronic obstructive bronchitis (disorder)	1095	55	6	0	55	6	1034	0.00000	-0.01707	0.00000	0.00000	0.00000	1.0000000000	1.0000000000	0.30137	-0.38003	23	4	0	32	2	0	0.00000	0.00000
19	237602007	Metabolic syndrome X (disorder)	62	185086009	Chronic obstructive bronchitis (disorder)	1095	64	6	0	64	6	1025	0.00000	-0.01849	0.00000	0.00000	0.00000	1.0000000000	1.0000000000	0.35068	-0.43369	28	4	0	36	2	0	0.00000	0.00000
18	302870006	Hypertriglyceridemia (disorder)	62	185086009	Chronic obstructive bronchitis (disorder)	1095	64	6	0	64	6	1025	0.00000	-0.01849	0.00000	0.00000	0.00000	1.0000000000	1.0000000000	0.35068	-0.43369	28	4	0	36	2	0	0.00000	0.00000
17	368581000119106	Neuropathy due to type 2 diabetes mellitus (disorder)	62	185086009	Chronic obstructive bronchitis (disorder)	1095	28	6	0	28	6	1061	0.00000	-0.01202	0.00000	0.00000	0.00000	1.0000000000	1.0000000000	0.15342	-0.20592	7	4	0	21	2	0	0.00000	0.00000
129	47505003	Posttraumatic stress disorder	36	156073000	Fetus with unknown complication	1095	4	125	1	3	124	967	2.19000	0.02587	2.59946	25.18347	0.26832	0.3846487301	1.0000000000	0.45662	0.45737	1	125	1	3	0	0	4.83628	0.69315
15	40055000	Chronic sinusitis (disorder)	62	185086009	Chronic obstructive bronchitis (disorder)	1095	216	6	4	212	2	877	3.37963	0.08756	8.27358	45.47049	1.50542	0.0158600283	0.2148446428	1.18356	1.19524	104	4	3	112	2	1	-0.25131	-1.15317
14	10509002	Acute bronchitis (disorder)	62	185086009	Chronic obstructive bronchitis (disorder)	1095	863	6	6	857	0	232	1.26883	0.03849	0.00000	0.00000	0.00000	0.3522028398	1.0000000000	4.72877	0.28913	418	4	4	445	2	2	0.00000	-0.75070
13	370247008	Facial laceration	62	185086009	Chronic obstructive bronchitis (disorder)	1095	109	6	0	109	6	980	0.00000	-0.02468	0.00000	0.00000	0.00000	1.0000000000	1.0000000000	0.59726	-0.67560	55	4	0	54	2	0	0.00000	0.00000
125	1734006	Fracture of the vertebral column with spinal cord injury	36	156073000	Fetus with unknown complication	1095	5	125	1	4	124	966	1.75200	0.01828	1.94758	17.56413	0.21596	0.4551518545	1.0000000000	0.57078	0.34852	3	125	1	2	0	0	4.83628	1.38629
124	1501000119109	Proliferative diabetic retinopathy due to type II diabetes mellitus (disorder)	36	156073000	Fetus with unknown complication	1095	1	125	0	1	125	969	0.00000	-0.01085	0.00000	0.00000	0.00000	1.0000000000	1.0000000000	0.11416	-0.15595	1	125	0	0	0	0	0.00000	0.00000
10	62106007	Concussion with no loss of consciousness	62	185086009	Chronic obstructive bronchitis (disorder)	1095	206	6	0	206	6	883	0.00000	-0.03573	0.00000	0.00000	0.00000	0.6008755621	1.0000000000	1.12877	-1.09002	96	4	0	110	2	0	0.00000	0.00000
8	233678006	Childhood asthma	62	185086009	Chronic obstructive bronchitis (disorder)	1095	45	6	0	45	6	1044	0.00000	-0.01537	0.00000	0.00000	0.00000	1.0000000000	1.0000000000	0.24658	-0.31797	25	4	0	20	2	0	0.00000	0.00000
7	75498004	Acute bacterial sinusitis (disorder)	62	185086009	Chronic obstructive bronchitis (disorder)	1095	187	6	4	183	2	906	3.90374	0.09781	9.90164	54.46168	1.80021	0.0093194983	0.1468699392	1.02466	1.30425	89	4	2	98	2	2	0.40547	-0.09431
6	39848009	Whiplash injury to neck	62	185086009	Chronic obstructive bronchitis (disorder)	1095	182	6	1	181	5	908	1.00275	0.00009	1.00331	8.63881	0.11653	1.0000000000	1.0000000000	0.99726	0.00198	92	4	1	90	2	0	1.60944	4.53260
5	284549007	Laceration of hand	62	185086009	Chronic obstructive bronchitis (disorder)	1095	104	6	0	104	6	985	0.00000	-0.02405	0.00000	0.00000	0.00000	1.0000000000	1.0000000000	0.56986	-0.65064	54	4	0	50	2	0	0.00000	0.00000
117	230265002	Familial Alzheimer's disease of early onset (disorder)	36	156073000	Fetus with unknown complication	1095	6	125	2	4	123	966	2.92000	0.05116	3.92683	21.66185	0.71185	0.1427389270	0.7404942507	0.68493	0.83227	2	125	2	4	0	0	4.15104	0.69315
116	370143000	Major depression disorder	36	156073000	Fetus with unknown complication	1095	8	125	0	8	125	962	0.00000	-0.03080	0.00000	0.00000	0.00000	0.6075389592	1.0000000000	0.91324	-0.93602	3	125	0	5	0	0	0.00000	0.00000
115	36923009	Major depression  single episode	36	156073000	Fetus with unknown complication	1095	6	125	0	6	125	964	0.00000	-0.02665	0.00000	0.00000	0.00000	1.0000000000	1.0000000000	0.68493	-0.75269	3	125	0	3	0	0	0.00000	0.00000
1	444814009	Viral sinusitis (disorder)	62	185086009	Chronic obstructive bronchitis (disorder)	1095	993	6	6	987	0	102	1.10272	0.02379	0.00000	0.00000	0.00000	1.0000000000	1.0000000000	5.44110	0.12005	478	4	4	515	2	2	0.00000	-0.76325
113	443165006	Pathological fracture due to osteoporosis (disorder)	36	156073000	Fetus with unknown complication	1095	10	125	1	9	124	961	0.87600	-0.00427	0.86111	6.85448	0.10818	1.0000000000	1.0000000000	1.14155	-0.09866	7	125	1	3	0	0	4.83628	2.07944
112	49436004	Atrial Fibrillation	36	156073000	Fetus with unknown complication	1095	35	125	1	34	124	936	0.25029	-0.04890	0.22201	1.63617	0.03012	0.1698041802	0.7972493423	3.99543	-1.32061	9	125	1	26	0	0	4.83628	2.30259
111	235919008	Cholelithiasis	36	156073000	Fetus with unknown complication	1095	9	125	1	8	124	962	0.97333	-0.00087	0.96976	7.81890	0.12028	1.0000000000	1.0000000000	1.02740	-0.01963	7	125	1	2	0	0	4.83628	2.07944
110	65275009	Acute Cholecystitis	36	156073000	Fetus with unknown complication	1095	9	125	1	8	124	962	0.97333	-0.00087	0.96976	7.81890	0.12028	1.0000000000	1.0000000000	1.02740	-0.01963	7	125	1	2	0	0	4.83628	2.07944
109	90560007	Gout	36	156073000	Fetus with unknown complication	1095	4	125	0	4	125	966	0.00000	-0.02174	0.00000	0.00000	0.00000	1.0000000000	1.0000000000	0.45662	-0.54263	0	125	0	4	0	0	0.00000	0.00000
108	40930008	Hypothyroidism (disorder)	36	156073000	Fetus with unknown complication	1095	13	125	4	9	121	961	2.69538	0.06671	3.52984	11.63625	1.07077	0.0510335909	0.4366207221	1.48402	1.00925	11	125	4	2	0	0	3.47352	1.32176
107	40275004	Contact dermatitis	36	156073000	Fetus with unknown complication	1095	18	125	2	16	123	954	0.97333	-0.00124	0.96951	4.26720	0.22027	1.0000000000	1.0000000000	2.05479	-0.02611	9	125	2	9	0	0	4.15104	1.70475
106	24079001	Atopic dermatitis	36	156073000	Fetus with unknown complication	1095	20	125	2	18	123	952	0.87600	-0.00607	0.85998	3.75110	0.19716	1.0000000000	1.0000000000	2.28311	-0.13010	13	125	2	7	0	0	4.15104	2.01490
105	363406005	Malignant tumor of colon	36	156073000	Fetus with unknown complication	1095	6	125	1	5	124	965	1.46000	0.01226	1.55645	13.43107	0.18037	0.5176344400	1.0000000000	0.68493	0.24731	4	125	1	2	0	0	4.83628	1.60944
104	367498001	Seasonal allergic rhinitis	36	156073000	Fetus with unknown complication	1095	20	125	2	18	123	952	0.87600	-0.00607	0.85998	3.75110	0.19716	1.0000000000	1.0000000000	2.28311	-0.13010	9	125	2	11	0	0	4.15104	1.70475
103	157141000119108	Proteinuria due to type 2 diabetes mellitus (disorder)	36	156073000	Fetus with unknown complication	1095	3	125	1	2	124	968	2.92000	0.03613	3.90323	43.35970	0.35137	0.3051048741	0.9953175875	0.34247	0.57511	1	125	1	2	0	0	4.83628	0.69315
102	90781000119102	Microalbuminuria due to type 2 diabetes mellitus (disorder)	36	156073000	Fetus with unknown complication	1095	6	125	1	5	124	965	1.46000	0.01226	1.55645	13.43107	0.18037	0.5176344400	1.0000000000	0.68493	0.24731	3	125	1	3	0	0	4.83628	1.38629
101	433144002	Chronic kidney disease stage 3 (disorder)	36	156073000	Fetus with unknown complication	1095	3	125	1	2	124	968	2.92000	0.03613	3.90323	43.35970	0.35137	0.3051048741	0.9953175875	0.34247	0.57511	1	125	1	2	0	0	4.83628	0.69315
100	161622006	History of lower limb amputation (situation)	36	156073000	Fetus with unknown complication	1095	1	125	0	1	125	969	0.00000	-0.01085	0.00000	0.00000	0.00000	1.0000000000	1.0000000000	0.11416	-0.15595	0	125	0	1	0	0	0.00000	0.00000
99	30832001	Rupture of patellar tendon	36	156073000	Fetus with unknown complication	1095	23	125	5	18	120	952	1.90435	0.04755	2.20370	6.04347	0.80356	0.1713489851	0.7972585288	2.62557	0.72675	14	125	5	9	0	0	3.25810	1.33500
98	1551000119108	Nonproliferative diabetic retinopathy due to type 2 diabetes mellitus (disorder)	36	156073000	Fetus with unknown complication	1095	12	125	3	9	122	961	2.19000	0.04497	2.62568	9.83054	0.70131	0.1484952819	0.7560856057	1.36986	0.75520	7	125	3	5	0	0	3.75342	1.20397
97	403192003	Third degree burn	36	156073000	Fetus with unknown complication	1095	8	125	1	7	124	963	1.09500	0.00293	1.10945	9.09279	0.13537	1.0000000000	1.0000000000	0.91324	0.06398	3	125	1	5	0	0	4.83628	1.38629
96	283371005	Laceration of forearm	36	156073000	Fetus with unknown complication	1095	75	125	12	63	113	907	1.40160	0.03909	1.52887	2.92146	0.80009	0.1899165205	0.8236596920	8.56164	0.44318	39	125	12	36	0	0	2.43507	1.44692
95	84757009	Epilepsy	36	156073000	Fetus with unknown complication	1095	30	125	1	29	124	941	0.29200	-0.04266	0.26168	1.93792	0.03533	0.2417171882	0.9105752038	3.42466	-1.14557	13	125	1	17	0	0	4.83628	2.63906
94	703151001	History of single seizure (situation)	36	156073000	Fetus with unknown complication	1095	39	125	1	38	124	932	0.22462	-0.05349	0.19779	1.45335	0.02692	0.1171331284	0.6784590683	4.45205	-1.44680	14	125	1	25	0	0	4.83628	2.70805
93	128613002	Seizure disorder	36	156073000	Fetus with unknown complication	1095	39	125	1	38	124	932	0.22462	-0.05349	0.19779	1.45335	0.02692	0.1171331284	0.6784590683	4.45205	-1.44680	14	125	1	25	0	0	4.83628	2.70805
92	82423001	Chronic pain	36	156073000	Fetus with unknown complication	1095	52	125	8	44	117	926	1.34769	0.02787	1.43901	3.13124	0.66131	0.3686698854	1.0000000000	5.93607	0.37581	24	125	8	28	0	0	2.81091	1.38629
91	64859006	Osteoporosis (disorder)	36	156073000	Fetus with unknown complication	1095	37	125	6	31	119	939	1.42054	0.02823	1.52724	3.73665	0.62421	0.3018713406	0.9939334687	4.22374	0.42227	24	125	6	13	0	0	3.08344	1.60944
89	47693006	Rupture of appendix	36	156073000	Fetus with unknown complication	1095	20	125	2	18	123	952	0.87600	-0.00607	0.85998	3.75110	0.19716	1.0000000000	1.0000000000	2.28311	-0.13010	10	125	2	10	0	0	4.15104	1.79176
88	197927001	Recurrent urinary tract infection	36	156073000	Fetus with unknown complication	1095	8	125	4	4	121	966	4.38000	0.10409	7.98347	32.33363	1.97119	0.0078681500	0.1293382417	0.91324	1.38591	8	125	4	0	0	0	3.47352	1.09861
86	713197008	Recurrent rectal polyp	36	156073000	Fetus with unknown complication	1095	22	125	4	18	121	952	1.59273	0.03047	1.74839	5.25142	0.58210	0.3042302905	0.9949826713	2.51142	0.50988	12	125	4	10	0	0	3.47352	1.38629
85	241929008	Acute allergic reaction	36	156073000	Fetus with unknown complication	1095	47	125	8	39	117	931	1.49106	0.03733	1.63226	3.57725	0.74478	0.2367621031	0.9032150112	5.36530	0.49970	25	125	8	22	0	0	2.81091	1.41707
84	232353008	Perennial allergic rhinitis with seasonal variation	36	156073000	Fetus with unknown complication	1095	29	125	5	24	120	946	1.51034	0.03022	1.64236	4.38499	0.61513	0.3664808882	1.0000000000	3.31050	0.47711	14	125	5	15	0	0	3.25810	1.33500
83	110030002	Concussion injury of brain	36	156073000	Fetus with unknown complication	1095	7	125	1	6	124	964	1.25143	0.00724	1.29570	10.85144	0.15471	0.5730023876	1.0000000000	0.79909	0.15274	1	125	1	6	0	0	4.83628	0.69315
82	94260004	Secondary malignant neoplasm of colon	36	156073000	Fetus with unknown complication	1095	4	125	1	3	124	967	2.19000	0.02587	2.59946	25.18347	0.26832	0.3846487301	1.0000000000	0.45662	0.45737	2	125	1	2	0	0	4.83628	1.09861
81	236077008	Protracted diarrhea	36	156073000	Fetus with unknown complication	1095	4	125	1	3	124	967	2.19000	0.02587	2.59946	25.18347	0.26832	0.3846487301	1.0000000000	0.45662	0.45737	2	125	1	2	0	0	4.83628	1.09861
80	6072007	Bleeding from anus	36	156073000	Fetus with unknown complication	1095	4	125	1	3	124	967	2.19000	0.02587	2.59946	25.18347	0.26832	0.3846487301	1.0000000000	0.45662	0.45737	2	125	1	2	0	0	4.83628	1.09861
79	45816000	Pyelonephritis	36	156073000	Fetus with unknown complication	1095	1	125	0	1	125	969	0.00000	-0.01085	0.00000	0.00000	0.00000	1.0000000000	1.0000000000	0.11416	-0.15595	1	125	0	0	0	0	0.00000	0.00000
78	239872002	Osteoarthritis of hip	36	156073000	Fetus with unknown complication	1095	21	125	5	16	120	954	2.08571	0.05450	2.48437	6.90325	0.89409	0.0811062550	0.5629813232	2.39726	0.82059	13	125	5	8	0	0	3.25810	1.28093
77	422034002	Diabetic retinopathy associated with type II diabetes mellitus (disorder)	36	156073000	Fetus with unknown complication	1095	20	125	3	17	122	953	1.31400	0.01537	1.37850	4.77196	0.39821	0.4908813578	1.0000000000	2.28311	0.28494	8	125	3	12	0	0	3.75342	1.29928
76	127013003	Diabetic renal disease (disorder)	36	156073000	Fetus with unknown complication	1095	28	125	5	23	120	947	1.56429	0.03281	1.71558	4.59670	0.64029	0.2394492034	0.9095097439	3.19635	0.51583	10	125	5	18	0	0	3.25810	1.09861
75	431855005	Chronic kidney disease stage 1 (disorder)	36	156073000	Fetus with unknown complication	1095	28	125	5	23	120	947	1.56429	0.03281	1.71558	4.59670	0.64029	0.2394492034	0.9095097439	3.19635	0.51583	10	125	5	18	0	0	3.25810	1.09861
73	196416002	Impacted molars	36	156073000	Fetus with unknown complication	1095	49	125	10	39	115	931	1.78776	0.06121	2.07581	4.26987	1.00916	0.0612185379	0.4826962916	5.59361	0.73836	25	125	10	24	0	0	2.60269	1.25276
72	35999006	Blighted ovum	36	156073000	Fetus with unknown complication	1095	53	125	24	29	101	941	3.96679	0.24019	7.71048	13.75034	4.32364	0.0000000001	0.0000000117	6.05023	1.82619	53	125	24	0	0	0	1.82589	1.16575
71	201834006	Localized  primary osteoarthritis of the hand	36	156073000	Fetus with unknown complication	1095	28	125	13	15	112	955	4.06714	0.17836	7.38988	15.92949	3.42825	0.0000025804	0.0001237767	3.19635	1.73822	19	125	13	9	0	0	2.36230	0.90079
70	87433001	Pulmonary emphysema (disorder)	36	156073000	Fetus with unknown complication	1095	17	125	2	15	123	955	1.03059	0.00138	1.03523	4.58107	0.23394	1.0000000000	1.0000000000	1.94064	0.02883	9	125	2	8	0	0	4.15104	1.70475
69	233604007	Pneumonia	36	156073000	Fetus with unknown complication	1095	7	125	2	5	123	965	2.50286	0.04327	3.13821	16.34922	0.60238	0.1854267540	0.8181443419	0.79909	0.73770	3	125	2	4	0	0	4.15104	0.91629
68	26929004	Alzheimer's disease (disorder)	36	156073000	Fetus with unknown complication	1095	23	125	6	17	119	953	2.28522	0.06758	2.82650	7.30859	1.09311	0.0385441972	0.3726222061	2.62557	0.94915	15	125	6	8	0	0	3.08344	1.25276
67	403191005	Second degree burn	36	156073000	Fetus with unknown complication	1095	49	125	6	43	119	927	1.07265	0.00564	1.08697	2.60806	0.45302	0.8181104622	1.0000000000	5.59361	0.08629	23	125	6	26	0	0	3.08344	1.57554
66	55822004	Hyperlipidemia	36	156073000	Fetus with unknown complication	1095	119	125	21	98	104	872	1.54588	0.06843	1.79670	3.00190	1.07537	0.0315316735	0.3275952503	13.58447	0.59307	64	125	21	55	0	0	1.93908	1.39813
65	239873007	Osteoarthritis of knee	36	156073000	Fetus with unknown complication	1095	57	125	9	48	116	922	1.38316	0.03223	1.49030	3.11628	0.71271	0.2841190688	0.9659403678	6.50685	0.41372	30	125	9	27	0	0	2.70062	1.46634
64	444448004	Injury of medial collateral ligament of knee	36	156073000	Fetus with unknown complication	1095	32	125	5	27	120	943	1.36875	0.02297	1.45525	3.85025	0.55003	0.4003395231	1.0000000000	3.65297	0.36681	17	125	5	15	0	0	3.25810	1.48160
63	68496003	Polyp of colon	36	156073000	Fetus with unknown complication	1095	91	125	16	75	109	895	1.54022	0.05838	1.75168	3.11357	0.98549	0.0588885080	0.4704967154	10.38813	0.57800	43	125	16	48	0	0	2.17617	1.30495
62	185086009	Chronic obstructive bronchitis (disorder)	36	156073000	Fetus with unknown complication	1095	6	125	2	4	123	966	2.92000	0.05116	3.92683	21.66185	0.71185	0.1427389270	0.7404942507	0.68493	0.83227	4	125	2	2	0	0	4.15104	1.09861
61	198992004	Antepartum eclampsia	36	156073000	Fetus with unknown complication	1095	96	125	36	60	89	910	3.28500	0.25428	6.13483	9.78657	3.84569	0.0000000000	0.0000000001	10.95890	1.62944	96	125	36	0	0	0	1.49789	1.29928
60	301011002	Escherichia coli urinary tract infection	36	156073000	Fetus with unknown complication	1095	92	125	32	60	93	910	3.04696	0.22255	5.21864	8.42666	3.23191	0.0000000003	0.0000000270	10.50228	1.52055	85	125	32	7	0	0	1.59051	1.29644
59	262574004	Bullet wound	36	156073000	Fetus with unknown complication	1095	20	125	1	19	124	951	0.43800	-0.02752	0.40365	3.04154	0.05357	0.7184310984	1.0000000000	2.28311	-0.71506	9	125	1	11	0	0	4.83628	2.30259
58	239720000	Tear of meniscus of knee	36	156073000	Fetus with unknown complication	1095	20	125	2	18	123	952	0.87600	-0.00607	0.85998	3.75110	0.19716	1.0000000000	1.0000000000	2.28311	-0.13010	10	125	2	10	0	0	4.15104	1.79176
57	192127007	Child attention deficit disorder	36	156073000	Fetus with unknown complication	1095	76	125	6	70	119	900	0.69158	-0.03024	0.64826	1.52488	0.27559	0.4526270976	1.0000000000	8.67580	-0.46703	24	125	6	52	0	0	3.08344	1.60944
56	92691004	Carcinoma in situ of prostate (disorder)	36	156073000	Fetus with unknown complication	1095	23	125	0	23	125	947	0.00000	-0.05258	0.00000	0.00000	0.00000	0.0982618240	0.6237397336	2.62557	-1.85821	0	125	0	23	0	0	0.00000	0.00000
55	126906006	Neoplasm of prostate	36	156073000	Fetus with unknown complication	1095	24	125	0	24	125	946	0.00000	-0.05374	0.00000	0.00000	0.00000	0.0994798800	0.6255159994	2.73973	-1.90293	0	125	0	24	0	0	0.00000	0.00000
54	5602001	Opioid abuse (disorder)	36	156073000	Fetus with unknown complication	1095	7	125	0	7	125	963	0.00000	-0.02879	0.00000	0.00000	0.00000	1.0000000000	1.0000000000	0.79909	-0.84726	0	125	0	7	0	0	0.00000	0.00000
53	7200002	Alcoholism	36	156073000	Fetus with unknown complication	1095	5	125	0	5	125	965	0.00000	-0.02431	0.00000	0.00000	0.00000	1.0000000000	1.0000000000	0.57078	-0.65148	0	125	0	5	0	0	0.00000	0.00000
52	124171000119105	Chronic intractable migraine without aura	36	156073000	Fetus with unknown complication	1095	51	125	10	41	115	929	1.71765	0.05694	1.97031	4.03937	0.96107	0.0698234696	0.5202347010	5.82192	0.68925	21	125	10	30	0	0	2.60269	1.13140
51	403190006	First degree burn	36	156073000	Fetus with unknown complication	1095	79	125	16	63	109	907	1.77418	0.07750	2.11330	3.78790	1.17902	0.0159582734	0.2155103438	9.01826	0.76290	43	125	16	36	0	0	2.17617	1.30495
50	446096008	Perennial allergic rhinitis	36	156073000	Fetus with unknown complication	1095	26	125	2	24	123	946	0.67385	-0.01826	0.64092	2.74513	0.14964	0.7590401611	1.0000000000	2.96804	-0.40346	14	125	2	12	0	0	4.15104	2.07944
49	88805009	Chronic congestive heart failure (disorder)	36	156073000	Fetus with unknown complication	1095	10	125	2	8	123	962	1.75200	0.02592	1.95528	9.31243	0.41054	0.3190310912	1.0000000000	1.14155	0.48631	5	125	2	5	0	0	4.15104	1.25276
48	55680006	Drug overdose	36	156073000	Fetus with unknown complication	1095	50	125	12	38	113	932	2.10240	0.08656	2.60456	5.12948	1.32250	0.0097754875	0.1523745890	5.70776	0.95461	24	125	12	26	0	0	2.43507	1.09861
47	359817006	Closed fracture of hip	36	156073000	Fetus with unknown complication	1095	29	125	3	26	122	944	0.90621	-0.00555	0.89281	2.99365	0.26627	1.0000000000	1.0000000000	3.31050	-0.10786	11	125	3	18	0	0	3.75342	1.54045
46	62564004	Concussion with loss of consciousness	36	156073000	Fetus with unknown complication	1095	67	125	9	58	116	912	1.17672	0.01620	1.21998	2.52720	0.58893	0.5535865432	1.0000000000	7.64840	0.20949	36	125	9	31	0	0	2.70062	1.60944
45	263102004	Fracture subluxation of wrist	36	156073000	Fetus with unknown complication	1095	109	125	17	92	108	878	1.36624	0.04371	1.50221	2.61593	0.86266	0.1533672366	0.7711941449	12.44292	0.42115	51	125	17	58	0	0	2.12261	1.38629
44	58150001	Fracture of clavicle	36	156073000	Fetus with unknown complication	1095	112	125	18	94	107	876	1.40786	0.04942	1.56771	2.69758	0.91108	0.1156163562	0.6739067685	12.78539	0.46286	55	125	18	57	0	0	2.07247	1.40009
43	307731004	Injury of tendon of the rotator cuff of shoulder	36	156073000	Fetus with unknown complication	1095	51	125	6	45	119	925	1.03059	0.00243	1.03641	2.48114	0.43293	0.8244170672	1.0000000000	5.82192	0.03718	26	125	6	25	0	0	3.08344	1.67398
42	16114001	Fracture of ankle	36	156073000	Fetus with unknown complication	1095	108	125	13	95	112	875	1.05444	0.00647	1.06908	1.97163	0.57969	0.8731168689	1.0000000000	12.32877	0.07088	48	125	13	60	0	0	2.36230	1.54592
41	283385000	Laceration of thigh	36	156073000	Fetus with unknown complication	1095	105	125	18	87	107	883	1.50171	0.05865	1.70738	2.94671	0.98929	0.0736002245	0.5374898259	11.98630	0.54901	50	125	18	55	0	0	2.07247	1.32914
40	428251008	History of appendectomy	36	156073000	Fetus with unknown complication	1095	51	125	7	44	118	926	1.20235	0.01606	1.24846	2.83530	0.54973	0.6497832314	1.0000000000	5.82192	0.22982	27	125	7	24	0	0	2.93689	1.58045
39	74400008	Appendicitis	36	156073000	Fetus with unknown complication	1095	51	125	7	44	118	926	1.20235	0.01606	1.24846	2.83530	0.54973	0.6497832314	1.0000000000	5.82192	0.22982	27	125	7	24	0	0	2.93689	1.58045
38	398254007	Preeclampsia	36	156073000	Fetus with unknown complication	1095	101	125	46	55	79	915	3.98970	0.34211	9.68700	15.25419	6.15161	0.0000000000	0.0000000000	11.52968	1.90731	101	125	46	0	0	0	1.31302	1.16179
37	38822007	Cystitis	36	156073000	Fetus with unknown complication	1095	71	125	30	41	95	929	3.70141	0.25535	7.15533	11.98810	4.27080	0.0000000000	0.0000000004	8.10502	1.76753	68	125	30	3	0	0	1.64223	1.18377
35	19169002	Miscarriage in first trimester	36	156073000	Fetus with unknown complication	1095	174	125	125	49	0	921	6.29310	0.82589	0.00000	0.00000	0.00000	0.0000000000	0.0000000000	19.86301	2.59440	174	125	125	0	0	0	0.69315	0.87213
33	429007001	History of cardiac arrest (situation)	36	156073000	Fetus with unknown complication	1095	42	125	7	35	118	935	1.46000	0.03298	1.58475	3.64812	0.68842	0.3165458380	1.0000000000	4.79452	0.46531	24	125	7	18	0	0	2.93689	1.48808
32	410429000	Cardiac Arrest	36	156073000	Fetus with unknown complication	1095	42	125	7	35	118	935	1.46000	0.03298	1.58475	3.64812	0.68842	0.3165458380	1.0000000000	4.79452	0.46531	24	125	7	18	0	0	2.93689	1.48808
31	230690007	Stroke	36	156073000	Fetus with unknown complication	1095	62	125	8	54	117	916	1.13032	0.01146	1.15986	2.49762	0.53862	0.6808939421	1.0000000000	7.07763	0.15599	32	125	8	30	0	0	2.81091	1.60944
30	399211009	History of myocardial infarction (situation)	36	156073000	Fetus with unknown complication	1095	31	125	2	29	123	941	0.56516	-0.02664	0.52761	2.23844	0.12436	0.5674126476	1.0000000000	3.53881	-0.59735	2	125	2	29	0	0	4.15104	0.69315
29	22298006	Myocardial Infarction	36	156073000	Fetus with unknown complication	1095	31	125	2	29	123	941	0.56516	-0.02664	0.52761	2.23844	0.12436	0.5674126476	1.0000000000	3.53881	-0.59735	2	125	2	29	0	0	4.15104	0.69315
28	53741008	Coronary Heart Disease	36	156073000	Fetus with unknown complication	1095	80	125	13	67	112	903	1.42350	0.04268	1.56437	2.92440	0.83684	0.1980036903	0.8392449993	9.13242	0.46645	24	125	13	56	0	0	2.36230	1.04597
27	408512008	Body mass index 40+ - severely obese (finding)	36	156073000	Fetus with unknown complication	1095	97	125	25	72	100	898	2.25773	0.14076	3.11806	5.13929	1.89175	0.0000306451	0.0011695763	11.07306	1.10672	67	125	25	30	0	0	1.79176	1.30291
26	33737001	Fracture of rib	36	156073000	Fetus with unknown complication	1095	54	125	6	48	119	922	0.97333	-0.00218	0.96849	2.31146	0.40579	1.0000000000	1.0000000000	6.16438	-0.03349	32	125	6	22	0	0	3.08344	1.84583
25	284551006	Laceration of foot	36	156073000	Fetus with unknown complication	1095	118	125	18	100	107	870	1.33627	0.04195	1.46355	2.51274	0.85245	0.1684037454	0.7953568293	13.47032	0.39290	53	125	18	65	0	0	2.07247	1.37231
24	162864005	Body mass index 30+ - obesity (finding)	36	156073000	Fetus with unknown complication	1095	439	125	79	360	46	610	1.57640	0.16927	2.91002	4.28149	1.97787	0.0000000359	0.0000022221	50.11416	0.64628	226	125	79	213	0	0	0.94867	1.35086
23	36971009	Sinusitis (disorder)	36	156073000	Fetus with unknown complication	1095	190	125	23	167	102	803	1.06042	0.00994	1.08424	1.75599	0.66947	0.7081705985	1.0000000000	21.68950	0.08101	84	125	23	106	0	0	1.86172	1.53733
22	70704007	Sprain of wrist	36	156073000	Fetus with unknown complication	1095	195	125	25	170	100	800	1.12308	0.02057	1.17647	1.87948	0.73642	0.5342723602	1.0000000000	22.26027	0.16064	90	125	25	105	0	0	1.79176	1.52606
21	15777000	Prediabetes	36	156073000	Fetus with unknown complication	1095	333	125	64	269	61	701	1.68360	0.16223	2.73411	3.98939	1.87381	0.0000002700	0.0000151950	38.01370	0.73646	159	125	64	174	0	0	1.08286	1.24829
20	80394007	Hyperglycemia (disorder)	36	156073000	Fetus with unknown complication	1095	55	125	13	42	112	928	2.07055	0.08838	2.56463	4.92360	1.33587	0.0075084338	0.1248277125	6.27854	0.94371	23	125	13	32	0	0	2.36230	1.01857
19	237602007	Metabolic syndrome X (disorder)	36	156073000	Fetus with unknown complication	1095	64	125	13	51	112	919	1.77937	0.06971	2.09156	3.96567	1.10312	0.0393849687	0.3770133649	7.30594	0.75321	28	125	13	36	0	0	2.36230	1.14862
18	302870006	Hypertriglyceridemia (disorder)	36	156073000	Fetus with unknown complication	1095	64	125	13	51	112	919	1.77937	0.06971	2.09156	3.96567	1.10312	0.0393849687	0.3770133649	7.30594	0.75321	28	125	13	36	0	0	2.36230	1.14862
17	368581000119106	Neuropathy due to type 2 diabetes mellitus (disorder)	36	156073000	Fetus with unknown complication	1095	28	125	4	24	121	946	1.25143	0.01462	1.30303	3.81896	0.44459	0.5505698200	1.0000000000	3.19635	0.25279	7	125	4	21	0	0	3.47352	1.01160
16	44054006	Diabetes	36	156073000	Fetus with unknown complication	1095	68	125	13	55	112	915	1.67471	0.06232	1.93101	3.64562	1.02281	0.0480357422	0.4214740129	7.76256	0.67600	29	125	13	39	0	0	2.36230	1.17272
15	40055000	Chronic sinusitis (disorder)	36	156073000	Fetus with unknown complication	1095	216	125	31	185	94	785	1.25722	0.04577	1.39937	2.16500	0.90450	0.1510931218	0.7644354026	24.65753	0.31869	104	125	31	112	0	0	1.61587	1.47129
14	10509002	Acute bronchitis (disorder)	36	156073000	Fetus with unknown complication	1095	863	125	116	747	9	223	1.17747	0.12288	3.84769	7.70571	1.92126	0.0000126773	0.0005299125	98.51598	0.23351	418	125	116	445	0	0	0.73121	1.52681
13	370247008	Facial laceration	36	156073000	Fetus with unknown complication	1095	109	125	14	95	111	875	1.12514	0.01494	1.16169	2.10582	0.64085	0.6335527725	1.0000000000	12.44292	0.15812	55	125	14	54	0	0	2.29542	1.59505
12	65966004	Fracture of forearm	36	156073000	Fetus with unknown complication	1095	123	125	12	111	113	859	0.85463	-0.01856	0.82181	1.53851	0.43898	0.6518976912	1.0000000000	14.04110	-0.21040	55	125	12	68	0	0	2.43507	1.71979
11	38341003	Hypertension	36	156073000	Fetus with unknown complication	1095	278	125	41	237	84	733	1.29194	0.06113	1.50959	2.25451	1.01081	0.0492332574	0.4274673922	31.73516	0.35955	131	125	41	147	0	0	1.39842	1.43392
10	62106007	Concussion with no loss of consciousness	36	156073000	Fetus with unknown complication	1095	206	125	29	177	96	793	1.23320	0.04030	1.35340	2.11435	0.86632	0.1824523204	0.8154465118	23.51598	0.29124	96	125	29	110	0	0	1.66966	1.46102
9	44465007	Sprain of ankle	36	156073000	Fetus with unknown complication	1095	362	125	51	311	74	659	1.23414	0.05907	1.46037	2.13833	0.99736	0.0551335206	0.4548515449	41.32420	0.29703	185	125	51	177	0	0	1.23866	1.53201
8	233678006	Childhood asthma	36	156073000	Fetus with unknown complication	1095	45	125	4	41	121	929	0.77867	-0.01645	0.74904	2.12771	0.26369	0.8104973139	1.0000000000	5.13699	-0.29560	25	125	4	20	0	0	3.47352	1.98100
7	75498004	Acute bacterial sinusitis (disorder)	36	156073000	Fetus with unknown complication	1095	187	125	27	160	98	810	1.26481	0.04314	1.39477	2.20612	0.88181	0.1646632247	0.7911405508	21.34703	0.32534	89	125	27	98	0	0	1.72804	1.45775
6	39848009	Whiplash injury to neck	36	156073000	Fetus with unknown complication	1095	182	125	30	152	95	818	1.44396	0.07116	1.69945	2.65325	1.08852	0.0217613034	0.2655079578	20.77626	0.50951	92	125	30	90	0	0	1.64223	1.40282
5	284549007	Laceration of hand	36	156073000	Fetus with unknown complication	1095	104	125	23	81	102	889	1.93731	0.10900	2.47482	4.10644	1.49150	0.0009457821	0.0238565392	11.87215	0.89878	54	125	23	50	0	0	1.86172	1.20831
4	195662009	Acute viral pharyngitis (disorder)	36	156073000	Fetus with unknown complication	1095	890	125	120	770	5	200	1.18112	0.13548	6.23377	15.45607	2.51421	0.0000006106	0.0000319027	101.59817	0.23800	430	125	120	460	0	0	0.71377	1.52243
3	65363002	Otitis media	36	156073000	Fetus with unknown complication	1095	580	125	48	532	77	438	0.72497	-0.10478	0.51323	0.75198	0.35028	0.0005839346	0.0160180568	66.21005	-0.45590	277	125	48	303	0	0	1.28209	1.91262
2	43878008	Streptococcal sore throat (disorder)	36	156073000	Fetus with unknown complication	1095	523	125	69	454	56	516	1.15572	0.05345	1.40041	2.03637	0.96306	0.0867594644	0.5823623432	59.70320	0.20558	246	125	69	277	0	0	1.03375	1.51847
1	444814009	Viral sinusitis (disorder)	36	156073000	Fetus with unknown complication	1095	993	125	123	870	2	100	1.08508	0.09529	7.06897	29.02294	1.72175	0.0004673748	0.0131494102	113.35616	0.11681	478	125	123	515	0	0	0.70124	1.58641
109	90560007	Gout	10	62106007	Concussion with no loss of consciousness	1095	4	206	1	3	205	886	1.32888	0.00959	1.44065	13.92048	0.14909	0.5660918305	1.0000000000	0.75251	0.19058	0	96	0	4	110	1	-4.70953	-1.60944
102	90781000119102	Microalbuminuria due to type 2 diabetes mellitus (disorder)	10	62106007	Concussion with no loss of consciousness	1095	6	206	1	5	205	884	0.88592	-0.00408	0.86244	7.42174	0.10022	1.0000000000	1.0000000000	1.12877	-0.09002	3	96	0	3	110	1	-4.70953	-1.38629
97	403192003	Third degree burn	10	62106007	Concussion with no loss of consciousness	1095	8	206	1	7	205	882	0.66444	-0.01386	0.61463	5.02320	0.07521	1.0000000000	1.0000000000	1.50502	-0.32482	3	96	1	5	110	0	4.57471	1.38629
96	283371005	Laceration of forearm	10	62106007	Concussion with no loss of consciousness	1095	75	206	15	60	191	829	1.06311	0.00824	1.08508	1.95210	0.60314	0.7605254916	1.0000000000	14.10959	0.08261	39	96	7	36	110	8	-0.00242	0.17798
94	703151001	History of single seizure (situation)	10	62106007	Concussion with no loss of consciousness	1095	39	206	4	35	202	854	0.54518	-0.04207	0.48317	1.37490	0.16980	0.2110846308	0.8654371270	7.33699	-0.73760	14	96	1	25	110	3	0.94594	0.47446
93	128613002	Seizure disorder	10	62106007	Concussion with no loss of consciousness	1095	39	206	4	35	202	854	0.54518	-0.04207	0.48317	1.37490	0.16980	0.2110846308	0.8654371270	7.33699	-0.73760	14	96	1	25	110	3	0.94594	0.47446
89	47693006	Rupture of appendix	10	62106007	Concussion with no loss of consciousness	1095	20	206	5	15	201	874	1.32888	0.02159	1.44942	4.03430	0.52074	0.5608313587	1.0000000000	3.76256	0.33323	10	96	2	10	110	3	0.26304	0.32542
86	713197008	Recurrent rectal polyp	10	62106007	Concussion with no loss of consciousness	1095	22	206	3	19	203	870	0.72485	-0.01897	0.67669	2.30864	0.19835	0.7826960363	1.0000000000	4.13881	-0.36144	12	96	2	10	110	1	-0.81771	-0.45199
75	431855005	Chronic kidney disease stage 1 (disorder)	10	62106007	Concussion with no loss of consciousness	1095	28	206	6	22	200	867	1.13904	0.01084	1.18227	2.95392	0.47319	0.6323500003	1.0000000000	5.26758	0.15945	10	96	2	18	110	4	0.54192	0.08701
69	233604007	Pneumonia	10	62106007	Concussion with no loss of consciousness	1095	7	206	2	5	204	884	1.51872	0.02003	1.73333	8.99729	0.33393	0.6220107099	1.0000000000	1.31689	0.37277	3	96	1	4	110	1	-0.13482	-0.22314
64	444448004	Injury of medial collateral ligament of knee	10	62106007	Concussion with no loss of consciousness	1095	32	206	8	24	198	865	1.32888	0.02747	1.45623	3.28960	0.64464	0.3600339312	1.0000000000	6.02009	0.35844	17	96	4	15	110	4	-0.13103	0.10008
49	88805009	Chronic congestive heart failure (disorder)	10	62106007	Concussion with no loss of consciousness	1095	10	206	2	8	204	881	1.06311	0.00292	1.07966	5.12227	0.22757	1.0000000000	1.0000000000	1.88128	0.05825	5	96	1	5	110	1	-0.13482	0.00000
47	359817006	Closed fracture of hip	10	62106007	Concussion with no loss of consciousness	1095	29	206	3	26	203	863	0.54988	-0.03574	0.49053	1.63649	0.14703	0.3355970206	1.0000000000	5.45571	-0.69058	11	96	0	18	110	3	-3.62878	-1.94591
44	58150001	Fracture of clavicle	10	62106007	Concussion with no loss of consciousness	1095	112	206	22	90	184	799	1.04412	0.00717	1.06147	1.73775	0.64838	0.7991455697	1.0000000000	21.07032	0.05953	55	96	12	57	110	10	-0.28768	-0.18232
43	307731004	Injury of tendon of the rotator cuff of shoulder	10	62106007	Concussion with no loss of consciousness	1095	51	206	10	41	196	848	1.04226	0.00450	1.05525	2.14315	0.51959	0.8550807304	1.0000000000	9.59452	0.05419	26	96	4	25	110	6	0.25705	0.37268
42	16114001	Fracture of ankle	10	62106007	Concussion with no loss of consciousness	1095	108	206	14	94	192	795	0.68905	-0.04951	0.61669	1.10494	0.34419	0.1192001049	0.6843537581	20.31781	-0.50710	48	96	4	60	110	10	0.73397	0.61904
41	283385000	Laceration of thigh	10	62106007	Concussion with no loss of consciousness	1095	105	206	25	80	181	809	1.26560	0.04164	1.39675	2.25078	0.86678	0.1883631261	0.8196068864	19.75342	0.32516	50	96	15	55	110	10	-0.48343	-0.40547
39	74400008	Appendicitis	10	62106007	Concussion with no loss of consciousness	1095	51	206	9	42	197	847	0.93804	-0.00659	0.92132	1.92414	0.44115	1.0000000000	1.0000000000	9.59452	-0.08332	27	96	5	24	110	4	-0.34422	-0.08961
38	398254007	Preeclampsia	10	62106007	Concussion with no loss of consciousness	1095	101	206	26	75	180	814	1.36836	0.05652	1.56770	2.51931	0.97554	0.0811166241	0.5629813232	19.00091	0.43289	101	96	26	0	110	0	1.54592	1.58609
35	19169002	Miscarriage in first trimester	10	62106007	Concussion with no loss of consciousness	1095	174	206	41	133	165	756	1.25251	0.05283	1.41244	2.08304	0.95773	0.0903454228	0.5966770779	32.73425	0.31618	174	96	41	0	110	0	1.20641	1.65707
33	429007001	History of cardiac arrest (situation)	10	62106007	Concussion with no loss of consciousness	1095	42	206	6	36	200	853	0.75936	-0.02313	0.71083	1.71011	0.29547	0.5486703684	1.0000000000	7.90137	-0.34667	24	96	5	18	110	1	-1.70385	-1.18658
32	410429000	Cardiac Arrest	10	62106007	Concussion with no loss of consciousness	1095	42	206	6	36	200	853	0.75936	-0.02313	0.71083	1.71011	0.29547	0.5486703684	1.0000000000	7.90137	-0.34667	24	96	5	18	110	1	-1.70385	-1.18658
27	408512008	Body mass index 40+ - severely obese (finding)	10	62106007	Concussion with no loss of consciousness	1095	97	206	22	75	184	814	1.20559	0.03085	1.29768	2.14257	0.78596	0.3400783068	1.0000000000	18.24840	0.25690	67	96	16	30	110	6	-1.01592	-0.14551
118	48333001	Burn injury(morphologic abnormality)	50	446096008	Perennial allergic rhinitis	1095	1	26	0	1	26	1068	0.00000	-0.00472	0.00000	0.00000	0.00000	1.0000000000	1.0000000000	0.02374	-0.03386	0	14	0	1	12	0	0.00000	0.00000
21	15777000	Prediabetes	10	62106007	Concussion with no loss of consciousness	1095	333	206	85	248	121	641	1.35682	0.11355	1.81568	2.48479	1.32675	0.0002835400	0.0086420618	62.64658	0.43425	159	96	45	174	110	40	-0.17966	-0.16564
18	302870006	Hypertriglyceridemia (disorder)	10	62106007	Concussion with no loss of consciousness	1095	64	206	19	45	187	844	1.57805	0.06933	1.90564	3.33331	1.08945	0.0307671173	0.3242181937	12.04018	0.61704	28	96	8	36	110	11	0.16705	0.05183
15	40055000	Chronic sinusitis (disorder)	10	62106007	Concussion with no loss of consciousness	1095	216	206	48	168	158	721	1.18123	0.04325	1.30380	1.87637	0.90595	0.1733715464	0.7996618359	40.63562	0.23496	104	96	23	112	110	25	-0.04277	0.00759
14	10509002	Acute bronchitis (disorder)	10	62106007	Concussion with no loss of consciousness	1095	863	206	184	679	22	210	1.13332	0.12378	2.58669	4.13226	1.61921	0.0000183966	0.0007241512	162.35434	0.17952	418	96	84	445	110	100	0.02020	0.09217
6	39848009	Whiplash injury to neck	10	62106007	Concussion with no loss of consciousness	1095	182	206	37	145	169	744	1.08063	0.01733	1.12336	1.67210	0.75470	0.6034846817	1.0000000000	34.23927	0.10882	92	96	18	90	110	19	-0.06955	0.06320
114	449868002	Smokes tobacco daily	51	403190006	First degree burn	1095	9	79	0	9	79	1007	0.00000	-0.02538	0.00000	0.00000	0.00000	1.0000000000	1.0000000000	0.64932	-0.72187	2	43	0	7	36	0	0.00000	0.00000
118	48333001	Burn injury(morphologic abnormality)	52	124171000119105	Chronic intractable migraine without aura	1095	1	51	0	1	51	1043	0.00000	-0.00668	0.00000	0.00000	0.00000	1.0000000000	1.0000000000	0.04658	-0.06568	0	21	0	1	30	0	0.00000	0.00000
114	449868002	Smokes tobacco daily	53	7200002	Alcoholism	1095	9	5	0	9	5	1081	0.00000	-0.00617	0.00000	0.00000	0.00000	1.0000000000	1.0000000000	0.04110	-0.05810	2	0	0	7	5	0	0.00000	0.00000
118	48333001	Burn injury(morphologic abnormality)	81	236077008	Protracted diarrhea	1095	1	4	0	1	4	1090	0.00000	-0.00183	0.00000	0.00000	0.00000	1.0000000000	1.0000000000	0.00365	-0.00526	0	2	0	1	2	0	0.00000	0.00000
120	162573006	Suspected lung cancer (situation)	81	236077008	Protracted diarrhea	1095	8	4	0	8	4	1083	0.00000	-0.00519	0.00000	0.00000	0.00000	1.0000000000	1.0000000000	0.02922	-0.04156	0	2	0	8	2	0	0.00000	0.00000
127	431856006	Chronic kidney disease stage 2 (disorder)	81	236077008	Protracted diarrhea	1095	5	4	0	5	4	1086	0.00000	-0.00410	0.00000	0.00000	0.00000	1.0000000000	1.0000000000	0.01826	-0.02611	3	2	0	2	2	0	0.00000	0.00000
128	86849004	Suicidal deliberate poisoning	81	236077008	Protracted diarrhea	1095	1	4	0	1	4	1090	0.00000	-0.00183	0.00000	0.00000	0.00000	1.0000000000	1.0000000000	0.00365	-0.00526	0	2	0	1	2	0	0.00000	0.00000
130	314994000	Metastasis from malignant tumor of prostate (disorder)	81	236077008	Protracted diarrhea	1095	1	4	0	1	4	1090	0.00000	-0.00183	0.00000	0.00000	0.00000	1.0000000000	1.0000000000	0.00365	-0.00526	0	2	0	1	2	0	0.00000	0.00000
118	48333001	Burn injury(morphologic abnormality)	54	5602001	Opioid abuse (disorder)	1095	1	7	0	1	7	1087	0.00000	-0.00243	0.00000	0.00000	0.00000	1.0000000000	1.0000000000	0.00639	-0.00919	0	0	0	1	7	0	0.00000	0.00000
114	449868002	Smokes tobacco daily	55	126906006	Neoplasm of prostate	1095	9	24	6	3	18	1068	30.41667	0.40088	118.66667	512.04969	27.50080	0.0000000046	0.0000003248	0.19726	2.54762	2	0	0	7	24	6	-1.60944	-0.77319
120	162573006	Suspected lung cancer (situation)	26	33737001	Fracture of rib	1095	8	54	0	8	54	1033	0.00000	-0.01954	0.00000	0.00000	0.00000	1.0000000000	1.0000000000	0.39452	-0.47977	0	32	0	8	22	0	0.00000	0.00000
131	93761005	Primary malignant neoplasm of colon	123	195967001	Asthma	1095	5	2	0	5	2	1088	0.00000	-0.00290	0.00000	0.00000	0.00000	1.0000000000	1.0000000000	0.00913	-0.01312	3	1	0	2	1	0	0.00000	0.00000
130	314994000	Metastasis from malignant tumor of prostate (disorder)	123	195967001	Asthma	1095	1	2	0	1	2	1092	0.00000	-0.00129	0.00000	0.00000	0.00000	1.0000000000	1.0000000000	0.00183	-0.00263	0	1	0	1	1	0	0.00000	0.00000
129	47505003	Posttraumatic stress disorder	123	195967001	Asthma	1095	4	2	0	4	2	1089	0.00000	-0.00259	0.00000	0.00000	0.00000	1.0000000000	1.0000000000	0.00731	-0.01050	1	1	0	3	1	0	0.00000	0.00000
128	86849004	Suicidal deliberate poisoning	123	195967001	Asthma	1095	1	2	0	1	2	1092	0.00000	-0.00129	0.00000	0.00000	0.00000	1.0000000000	1.0000000000	0.00183	-0.00263	0	1	0	1	1	0	0.00000	0.00000
127	431856006	Chronic kidney disease stage 2 (disorder)	123	195967001	Asthma	1095	5	2	0	5	2	1088	0.00000	-0.00290	0.00000	0.00000	0.00000	1.0000000000	1.0000000000	0.00913	-0.01312	3	1	0	2	1	0	0.00000	0.00000
125	1734006	Fracture of the vertebral column with spinal cord injury	123	195967001	Asthma	1095	5	2	0	5	2	1088	0.00000	-0.00290	0.00000	0.00000	0.00000	1.0000000000	1.0000000000	0.00913	-0.01312	3	1	0	2	1	0	0.00000	0.00000
124	1501000119109	Proliferative diabetic retinopathy due to type II diabetes mellitus (disorder)	123	195967001	Asthma	1095	1	2	0	1	2	1092	0.00000	-0.00129	0.00000	0.00000	0.00000	1.0000000000	1.0000000000	0.00183	-0.00263	1	1	0	0	1	0	0.00000	0.00000
130	314994000	Metastasis from malignant tumor of prostate (disorder)	26	33737001	Fracture of rib	1095	1	54	0	1	54	1040	0.00000	-0.00689	0.00000	0.00000	0.00000	1.0000000000	1.0000000000	0.04932	-0.06945	0	32	0	1	22	0	0.00000	0.00000
121	254637007	Non-small cell lung cancer (disorder)	123	195967001	Asthma	1095	8	2	0	8	2	1085	0.00000	-0.00367	0.00000	0.00000	0.00000	1.0000000000	1.0000000000	0.01461	-0.02093	0	1	0	8	1	0	0.00000	0.00000
120	162573006	Suspected lung cancer (situation)	123	195967001	Asthma	1095	8	2	0	8	2	1085	0.00000	-0.00367	0.00000	0.00000	0.00000	1.0000000000	1.0000000000	0.01461	-0.02093	0	1	0	8	1	0	0.00000	0.00000
118	48333001	Burn injury(morphologic abnormality)	123	195967001	Asthma	1095	1	2	0	1	2	1092	0.00000	-0.00129	0.00000	0.00000	0.00000	1.0000000000	1.0000000000	0.00183	-0.00263	0	1	0	1	1	0	0.00000	0.00000
117	230265002	Familial Alzheimer's disease of early onset (disorder)	123	195967001	Asthma	1095	6	2	0	6	2	1087	0.00000	-0.00318	0.00000	0.00000	0.00000	1.0000000000	1.0000000000	0.01096	-0.01572	2	1	0	4	1	0	0.00000	0.00000
115	36923009	Major depression  single episode	123	195967001	Asthma	1095	6	2	0	6	2	1087	0.00000	-0.00318	0.00000	0.00000	0.00000	1.0000000000	1.0000000000	0.01096	-0.01572	3	1	0	3	1	0	0.00000	0.00000
114	449868002	Smokes tobacco daily	123	195967001	Asthma	1095	9	2	0	9	2	1084	0.00000	-0.00389	0.00000	0.00000	0.00000	1.0000000000	1.0000000000	0.01644	-0.02352	2	1	0	7	1	0	0.00000	0.00000
112	49436004	Atrial Fibrillation	123	195967001	Asthma	1095	35	2	0	35	2	1058	0.00000	-0.00777	0.00000	0.00000	0.00000	1.0000000000	1.0000000000	0.06393	-0.08940	9	1	0	26	1	0	0.00000	0.00000
111	235919008	Cholelithiasis	123	195967001	Asthma	1095	9	2	0	9	2	1084	0.00000	-0.00389	0.00000	0.00000	0.00000	1.0000000000	1.0000000000	0.01644	-0.02352	7	1	0	2	1	0	0.00000	0.00000
110	65275009	Acute Cholecystitis	123	195967001	Asthma	1095	9	2	0	9	2	1084	0.00000	-0.00389	0.00000	0.00000	0.00000	1.0000000000	1.0000000000	0.01644	-0.02352	7	1	0	2	1	0	0.00000	0.00000
109	90560007	Gout	123	195967001	Asthma	1095	4	2	0	4	2	1089	0.00000	-0.00259	0.00000	0.00000	0.00000	1.0000000000	1.0000000000	0.00731	-0.01050	0	1	0	4	1	0	0.00000	0.00000
108	40930008	Hypothyroidism (disorder)	123	195967001	Asthma	1095	13	2	0	13	2	1080	0.00000	-0.00469	0.00000	0.00000	0.00000	1.0000000000	1.0000000000	0.02374	-0.03386	11	1	0	2	1	0	0.00000	0.00000
107	40275004	Contact dermatitis	123	195967001	Asthma	1095	18	2	0	18	2	1075	0.00000	-0.00553	0.00000	0.00000	0.00000	1.0000000000	1.0000000000	0.03288	-0.04667	9	1	0	9	1	0	0.00000	0.00000
106	24079001	Atopic dermatitis	123	195967001	Asthma	1095	20	2	0	20	2	1073	0.00000	-0.00583	0.00000	0.00000	0.00000	1.0000000000	1.0000000000	0.03653	-0.05176	13	1	0	7	1	0	0.00000	0.00000
105	363406005	Malignant tumor of colon	123	195967001	Asthma	1095	6	2	0	6	2	1087	0.00000	-0.00318	0.00000	0.00000	0.00000	1.0000000000	1.0000000000	0.01096	-0.01572	4	1	0	2	1	0	0.00000	0.00000
104	367498001	Seasonal allergic rhinitis	123	195967001	Asthma	1095	20	2	0	20	2	1073	0.00000	-0.00583	0.00000	0.00000	0.00000	1.0000000000	1.0000000000	0.03653	-0.05176	9	1	0	11	1	0	0.00000	0.00000
102	90781000119102	Microalbuminuria due to type 2 diabetes mellitus (disorder)	123	195967001	Asthma	1095	6	2	0	6	2	1087	0.00000	-0.00318	0.00000	0.00000	0.00000	1.0000000000	1.0000000000	0.01096	-0.01572	3	1	0	3	1	0	0.00000	0.00000
101	433144002	Chronic kidney disease stage 3 (disorder)	123	195967001	Asthma	1095	3	2	0	3	2	1090	0.00000	-0.00224	0.00000	0.00000	0.00000	1.0000000000	1.0000000000	0.00548	-0.00788	1	1	0	2	1	0	0.00000	0.00000
100	161622006	History of lower limb amputation (situation)	123	195967001	Asthma	1095	1	2	0	1	2	1092	0.00000	-0.00129	0.00000	0.00000	0.00000	1.0000000000	1.0000000000	0.00183	-0.00263	0	1	0	1	1	0	0.00000	0.00000
99	30832001	Rupture of patellar tendon	123	195967001	Asthma	1095	23	2	0	23	2	1070	0.00000	-0.00627	0.00000	0.00000	0.00000	1.0000000000	1.0000000000	0.04201	-0.05937	14	1	0	9	1	0	0.00000	0.00000
98	1551000119108	Nonproliferative diabetic retinopathy due to type 2 diabetes mellitus (disorder)	123	195967001	Asthma	1095	12	2	0	12	2	1081	0.00000	-0.00450	0.00000	0.00000	0.00000	1.0000000000	1.0000000000	0.02192	-0.03128	7	1	0	5	1	0	0.00000	0.00000
97	403192003	Third degree burn	123	195967001	Asthma	1095	8	2	0	8	2	1085	0.00000	-0.00367	0.00000	0.00000	0.00000	1.0000000000	1.0000000000	0.01461	-0.02093	3	1	0	5	1	0	0.00000	0.00000
96	283371005	Laceration of forearm	123	195967001	Asthma	1095	75	2	1	74	1	1019	7.30000	0.07308	13.77027	222.37142	0.85272	0.1323533095	0.7140816678	0.13699	0.81479	39	1	0	36	1	1	-0.69315	-3.61092
95	84757009	Epilepsy	123	195967001	Asthma	1095	30	2	0	30	2	1063	0.00000	-0.00718	0.00000	0.00000	0.00000	1.0000000000	1.0000000000	0.05479	-0.07696	13	1	0	17	1	0	0.00000	0.00000
94	703151001	History of single seizure (situation)	123	195967001	Asthma	1095	39	2	0	39	2	1054	0.00000	-0.00822	0.00000	0.00000	0.00000	1.0000000000	1.0000000000	0.07123	-0.09927	14	1	0	25	1	0	0.00000	0.00000
93	128613002	Seizure disorder	123	195967001	Asthma	1095	39	2	0	39	2	1054	0.00000	-0.00822	0.00000	0.00000	0.00000	1.0000000000	1.0000000000	0.07123	-0.09927	14	1	0	25	1	0	0.00000	0.00000
89	47693006	Rupture of appendix	123	195967001	Asthma	1095	20	2	0	20	2	1073	0.00000	-0.00583	0.00000	0.00000	0.00000	1.0000000000	1.0000000000	0.03653	-0.05176	10	1	0	10	1	0	0.00000	0.00000
86	713197008	Recurrent rectal polyp	123	195967001	Asthma	1095	22	2	0	22	2	1071	0.00000	-0.00613	0.00000	0.00000	0.00000	1.0000000000	1.0000000000	0.04018	-0.05684	12	1	0	10	1	0	0.00000	0.00000
85	241929008	Acute allergic reaction	123	195967001	Asthma	1095	47	2	0	47	2	1046	0.00000	-0.00906	0.00000	0.00000	0.00000	1.0000000000	1.0000000000	0.08584	-0.11882	25	1	0	22	1	0	0.00000	0.00000
82	94260004	Secondary malignant neoplasm of colon	123	195967001	Asthma	1095	4	2	0	4	2	1089	0.00000	-0.00259	0.00000	0.00000	0.00000	1.0000000000	1.0000000000	0.00731	-0.01050	2	1	0	2	1	0	0.00000	0.00000
81	236077008	Protracted diarrhea	123	195967001	Asthma	1095	4	2	0	4	2	1089	0.00000	-0.00259	0.00000	0.00000	0.00000	1.0000000000	1.0000000000	0.00731	-0.01050	2	1	0	2	1	0	0.00000	0.00000
80	6072007	Bleeding from anus	123	195967001	Asthma	1095	4	2	0	4	2	1089	0.00000	-0.00259	0.00000	0.00000	0.00000	1.0000000000	1.0000000000	0.00731	-0.01050	2	1	0	2	1	0	0.00000	0.00000
79	45816000	Pyelonephritis	123	195967001	Asthma	1095	1	2	0	1	2	1092	0.00000	-0.00129	0.00000	0.00000	0.00000	1.0000000000	1.0000000000	0.00183	-0.00263	1	1	0	0	1	0	0.00000	0.00000
78	239872002	Osteoarthritis of hip	123	195967001	Asthma	1095	21	2	0	21	2	1072	0.00000	-0.00598	0.00000	0.00000	0.00000	1.0000000000	1.0000000000	0.03836	-0.05430	13	1	0	8	1	0	0.00000	0.00000
76	127013003	Diabetic renal disease (disorder)	123	195967001	Asthma	1095	28	2	0	28	2	1065	0.00000	-0.00693	0.00000	0.00000	0.00000	1.0000000000	1.0000000000	0.05114	-0.07196	10	1	0	18	1	0	0.00000	0.00000
75	431855005	Chronic kidney disease stage 1 (disorder)	123	195967001	Asthma	1095	28	2	0	28	2	1065	0.00000	-0.00693	0.00000	0.00000	0.00000	1.0000000000	1.0000000000	0.05114	-0.07196	10	1	0	18	1	0	0.00000	0.00000
73	196416002	Impacted molars	123	195967001	Asthma	1095	49	2	0	49	2	1044	0.00000	-0.00926	0.00000	0.00000	0.00000	1.0000000000	1.0000000000	0.08950	-0.12366	25	1	0	24	1	0	0.00000	0.00000
72	35999006	Blighted ovum	123	195967001	Asthma	1095	53	2	0	53	2	1040	0.00000	-0.00965	0.00000	0.00000	0.00000	1.0000000000	1.0000000000	0.09680	-0.13331	53	1	0	0	1	0	0.00000	0.00000
71	201834006	Localized  primary osteoarthritis of the hand	123	195967001	Asthma	1095	28	2	0	28	2	1065	0.00000	-0.00693	0.00000	0.00000	0.00000	1.0000000000	1.0000000000	0.05114	-0.07196	19	1	0	9	1	0	0.00000	0.00000
70	87433001	Pulmonary emphysema (disorder)	123	195967001	Asthma	1095	17	2	0	17	2	1076	0.00000	-0.00537	0.00000	0.00000	0.00000	1.0000000000	1.0000000000	0.03105	-0.04411	9	1	0	8	1	0	0.00000	0.00000
69	233604007	Pneumonia	123	195967001	Asthma	1095	7	2	0	7	2	1086	0.00000	-0.00343	0.00000	0.00000	0.00000	1.0000000000	1.0000000000	0.01279	-0.01833	3	1	0	4	1	0	0.00000	0.00000
68	26929004	Alzheimer's disease (disorder)	123	195967001	Asthma	1095	23	2	0	23	2	1070	0.00000	-0.00627	0.00000	0.00000	0.00000	1.0000000000	1.0000000000	0.04201	-0.05937	15	1	0	8	1	0	0.00000	0.00000
67	403191005	Second degree burn	123	195967001	Asthma	1095	49	2	0	49	2	1044	0.00000	-0.00926	0.00000	0.00000	0.00000	1.0000000000	1.0000000000	0.08950	-0.12366	23	1	0	26	1	0	0.00000	0.00000
65	239873007	Osteoarthritis of knee	123	195967001	Asthma	1095	57	2	0	57	2	1036	0.00000	-0.01002	0.00000	0.00000	0.00000	1.0000000000	1.0000000000	0.10411	-0.14288	30	1	0	27	1	0	0.00000	0.00000
64	444448004	Injury of medial collateral ligament of knee	123	195967001	Asthma	1095	32	2	0	32	2	1061	0.00000	-0.00742	0.00000	0.00000	0.00000	1.0000000000	1.0000000000	0.05845	-0.08195	17	1	0	15	1	0	0.00000	0.00000
63	68496003	Polyp of colon	123	195967001	Asthma	1095	91	2	0	91	2	1002	0.00000	-0.01288	0.00000	0.00000	0.00000	1.0000000000	1.0000000000	0.16621	-0.22183	43	1	0	48	1	0	0.00000	0.00000
62	185086009	Chronic obstructive bronchitis (disorder)	123	195967001	Asthma	1095	6	2	0	6	2	1087	0.00000	-0.00318	0.00000	0.00000	0.00000	1.0000000000	1.0000000000	0.01096	-0.01572	4	1	0	2	1	0	0.00000	0.00000
59	262574004	Bullet wound	123	195967001	Asthma	1095	20	2	0	20	2	1073	0.00000	-0.00583	0.00000	0.00000	0.00000	1.0000000000	1.0000000000	0.03653	-0.05176	9	1	0	11	1	0	0.00000	0.00000
58	239720000	Tear of meniscus of knee	123	195967001	Asthma	1095	20	2	0	20	2	1073	0.00000	-0.00583	0.00000	0.00000	0.00000	1.0000000000	1.0000000000	0.03653	-0.05176	10	1	0	10	1	0	0.00000	0.00000
57	192127007	Child attention deficit disorder	123	195967001	Asthma	1095	76	2	1	75	1	1018	7.20395	0.07248	13.57333	219.16404	0.84063	0.1340545775	0.7192732770	0.13881	0.81247	24	1	0	52	1	1	-0.69315	-3.97029
56	92691004	Carcinoma in situ of prostate (disorder)	123	195967001	Asthma	1095	23	2	0	23	2	1070	0.00000	-0.00627	0.00000	0.00000	0.00000	1.0000000000	1.0000000000	0.04201	-0.05937	0	1	0	23	1	0	0.00000	0.00000
54	5602001	Opioid abuse (disorder)	123	195967001	Asthma	1095	7	2	0	7	2	1086	0.00000	-0.00343	0.00000	0.00000	0.00000	1.0000000000	1.0000000000	0.01279	-0.01833	0	1	0	7	1	0	0.00000	0.00000
53	7200002	Alcoholism	123	195967001	Asthma	1095	5	2	0	5	2	1088	0.00000	-0.00290	0.00000	0.00000	0.00000	1.0000000000	1.0000000000	0.00913	-0.01312	0	1	0	5	1	0	0.00000	0.00000
52	124171000119105	Chronic intractable migraine without aura	123	195967001	Asthma	1095	51	2	0	51	2	1042	0.00000	-0.00945	0.00000	0.00000	0.00000	1.0000000000	1.0000000000	0.09315	-0.12849	21	1	0	30	1	0	0.00000	0.00000
50	446096008	Perennial allergic rhinitis	123	195967001	Asthma	1095	26	2	0	26	2	1067	0.00000	-0.00667	0.00000	0.00000	0.00000	1.0000000000	1.0000000000	0.04749	-0.06693	14	1	0	12	1	0	0.00000	0.00000
49	88805009	Chronic congestive heart failure (disorder)	123	195967001	Asthma	1095	10	2	0	10	2	1083	0.00000	-0.00411	0.00000	0.00000	0.00000	1.0000000000	1.0000000000	0.01826	-0.02611	5	1	0	5	1	0	0.00000	0.00000
47	359817006	Closed fracture of hip	123	195967001	Asthma	1095	29	2	0	29	2	1064	0.00000	-0.00706	0.00000	0.00000	0.00000	1.0000000000	1.0000000000	0.05297	-0.07446	11	1	0	18	1	0	0.00000	0.00000
46	62564004	Concussion with loss of consciousness	123	195967001	Asthma	1095	67	2	1	66	1	1027	8.17164	0.07832	15.56061	251.56592	0.96250	0.1186830616	0.6835957447	0.12237	0.83345	36	1	0	31	1	1	-0.69315	-3.46574
45	263102004	Fracture subluxation of wrist	123	195967001	Asthma	1095	109	2	0	109	2	984	0.00000	-0.01422	0.00000	0.00000	0.00000	1.0000000000	1.0000000000	0.19909	-0.26194	51	1	0	58	1	0	0.00000	0.00000
44	58150001	Fracture of clavicle	123	195967001	Asthma	1095	112	2	0	112	2	981	0.00000	-0.01444	0.00000	0.00000	0.00000	1.0000000000	1.0000000000	0.20457	-0.26851	55	1	0	57	1	0	0.00000	0.00000
43	307731004	Injury of tendon of the rotator cuff of shoulder	123	195967001	Asthma	1095	51	2	0	51	2	1042	0.00000	-0.00945	0.00000	0.00000	0.00000	1.0000000000	1.0000000000	0.09315	-0.12849	26	1	0	25	1	0	0.00000	0.00000
42	16114001	Fracture of ankle	123	195967001	Asthma	1095	108	2	0	108	2	985	0.00000	-0.01415	0.00000	0.00000	0.00000	1.0000000000	1.0000000000	0.19726	-0.25974	48	1	0	60	1	0	0.00000	0.00000
41	283385000	Laceration of thigh	123	195967001	Asthma	1095	105	2	0	105	2	988	0.00000	-0.01393	0.00000	0.00000	0.00000	1.0000000000	1.0000000000	0.19178	-0.25312	50	1	0	55	1	0	0.00000	0.00000
40	428251008	History of appendectomy	123	195967001	Asthma	1095	51	2	0	51	2	1042	0.00000	-0.00945	0.00000	0.00000	0.00000	1.0000000000	1.0000000000	0.09315	-0.12849	27	1	0	24	1	0	0.00000	0.00000
39	74400008	Appendicitis	123	195967001	Asthma	1095	51	2	0	51	2	1042	0.00000	-0.00945	0.00000	0.00000	0.00000	1.0000000000	1.0000000000	0.09315	-0.12849	27	1	0	24	1	0	0.00000	0.00000
38	398254007	Preeclampsia	123	195967001	Asthma	1095	101	2	1	100	1	993	5.42079	0.06028	9.93000	159.97033	0.61639	0.1760436753	0.8029498763	0.18447	0.75575	101	1	1	0	1	0	0.69315	4.62497
35	19169002	Miscarriage in first trimester	123	195967001	Asthma	1095	174	2	1	173	1	920	3.14655	0.03991	5.31792	85.42576	0.33105	0.2926798728	0.9786512274	0.31781	0.60186	174	1	1	0	1	0	0.69315	5.16479
33	429007001	History of cardiac arrest (situation)	123	195967001	Asthma	1095	42	2	0	42	2	1051	0.00000	-0.00854	0.00000	0.00000	0.00000	1.0000000000	1.0000000000	0.07671	-0.10663	24	1	0	18	1	0	0.00000	0.00000
32	410429000	Cardiac Arrest	123	195967001	Asthma	1095	42	2	0	42	2	1051	0.00000	-0.00854	0.00000	0.00000	0.00000	1.0000000000	1.0000000000	0.07671	-0.10663	24	1	0	18	1	0	0.00000	0.00000
30	399211009	History of myocardial infarction (situation)	123	195967001	Asthma	1095	31	2	0	31	2	1062	0.00000	-0.00730	0.00000	0.00000	0.00000	1.0000000000	1.0000000000	0.05662	-0.07946	2	1	0	29	1	0	0.00000	0.00000
29	22298006	Myocardial Infarction	123	195967001	Asthma	1095	31	2	0	31	2	1062	0.00000	-0.00730	0.00000	0.00000	0.00000	1.0000000000	1.0000000000	0.05662	-0.07946	2	1	0	29	1	0	0.00000	0.00000
28	53741008	Coronary Heart Disease	123	195967001	Asthma	1095	80	2	0	80	2	1013	0.00000	-0.01201	0.00000	0.00000	0.00000	1.0000000000	1.0000000000	0.14612	-0.19676	24	1	0	56	1	0	0.00000	0.00000
27	408512008	Body mass index 40+ - severely obese (finding)	123	195967001	Asthma	1095	97	2	0	97	2	996	0.00000	-0.01334	0.00000	0.00000	0.00000	1.0000000000	1.0000000000	0.17717	-0.23532	67	1	0	30	1	0	0.00000	0.00000
26	33737001	Fracture of rib	123	195967001	Asthma	1095	54	2	0	54	2	1039	0.00000	-0.00974	0.00000	0.00000	0.00000	1.0000000000	1.0000000000	0.09863	-0.13571	32	1	0	22	1	0	0.00000	0.00000
24	162864005	Body mass index 30+ - obesity (finding)	123	195967001	Asthma	1095	439	2	1	438	1	655	1.24715	0.00865	1.49543	23.97151	0.09329	1.0000000000	1.0000000000	0.80183	0.15054	226	1	1	213	1	0	0.69315	5.42495
23	36971009	Sinusitis (disorder)	123	195967001	Asthma	1095	190	2	1	189	1	904	2.88158	0.03688	4.78307	76.80907	0.29785	0.3170552536	1.0000000000	0.34703	0.57022	84	1	1	106	1	0	0.69315	4.44265
21	15777000	Prediabetes	123	195967001	Asthma	1095	333	2	0	333	2	760	0.00000	-0.02828	0.00000	0.00000	0.00000	1.0000000000	1.0000000000	0.60822	-0.68546	159	1	0	174	1	0	0.00000	0.00000
20	80394007	Hyperglycemia (disorder)	123	195967001	Asthma	1095	55	2	0	55	2	1038	0.00000	-0.00984	0.00000	0.00000	0.00000	1.0000000000	1.0000000000	0.10046	-0.13810	23	1	0	32	1	0	0.00000	0.00000
19	237602007	Metabolic syndrome X (disorder)	123	195967001	Asthma	1095	64	2	0	64	2	1029	0.00000	-0.01066	0.00000	0.00000	0.00000	1.0000000000	1.0000000000	0.11689	-0.15949	28	1	0	36	1	0	0.00000	0.00000
18	302870006	Hypertriglyceridemia (disorder)	123	195967001	Asthma	1095	64	2	0	64	2	1029	0.00000	-0.01066	0.00000	0.00000	0.00000	1.0000000000	1.0000000000	0.11689	-0.15949	28	1	0	36	1	0	0.00000	0.00000
17	368581000119106	Neuropathy due to type 2 diabetes mellitus (disorder)	123	195967001	Asthma	1095	28	2	0	28	2	1065	0.00000	-0.00693	0.00000	0.00000	0.00000	1.0000000000	1.0000000000	0.05114	-0.07196	7	1	0	21	1	0	0.00000	0.00000
15	40055000	Chronic sinusitis (disorder)	123	195967001	Asthma	1095	216	2	1	215	1	878	2.53472	0.03254	4.08372	65.55103	0.25441	0.3557536751	1.0000000000	0.39452	0.52023	104	1	1	112	1	0	0.69315	4.65396
14	10509002	Acute bronchitis (disorder)	123	195967001	Asthma	1095	863	2	2	861	0	232	1.26883	0.02218	0.00000	0.00000	0.00000	1.0000000000	1.0000000000	1.57626	0.21969	418	1	1	445	1	1	0.00000	-0.06245
13	370247008	Facial laceration	123	195967001	Asthma	1095	109	2	0	109	2	984	0.00000	-0.01422	0.00000	0.00000	0.00000	1.0000000000	1.0000000000	0.19909	-0.26194	55	1	0	54	1	0	0.00000	0.00000
125	1734006	Fracture of the vertebral column with spinal cord injury	97	403192003	Third degree burn	1095	5	8	0	5	8	1082	0.00000	-0.00581	0.00000	0.00000	0.00000	1.0000000000	1.0000000000	0.03653	-0.05176	3	3	0	2	5	0	0.00000	0.00000
10	62106007	Concussion with no loss of consciousness	123	195967001	Asthma	1095	206	2	0	206	2	887	0.00000	-0.02059	0.00000	0.00000	0.00000	1.0000000000	1.0000000000	0.37626	-0.46075	96	1	0	110	1	0	0.00000	0.00000
9	44465007	Sprain of ankle	123	195967001	Asthma	1095	362	2	1	361	1	732	1.51243	0.01540	2.02770	32.51099	0.12647	0.5520973680	1.0000000000	0.66119	0.26779	185	1	0	177	1	1	-0.69315	-5.18178
8	233678006	Childhood asthma	123	195967001	Asthma	1095	45	2	0	45	2	1048	0.00000	-0.00886	0.00000	0.00000	0.00000	1.0000000000	1.0000000000	0.08219	-0.11396	25	1	0	20	1	0	0.00000	0.00000
7	75498004	Acute bacterial sinusitis (disorder)	123	195967001	Asthma	1095	187	2	0	187	2	906	0.00000	-0.01941	0.00000	0.00000	0.00000	1.0000000000	1.0000000000	0.34155	-0.42390	89	1	0	98	1	0	0.00000	0.00000
6	39848009	Whiplash injury to neck	123	195967001	Asthma	1095	182	2	0	182	2	911	0.00000	-0.01910	0.00000	0.00000	0.00000	1.0000000000	1.0000000000	0.33242	-0.41405	92	1	0	90	1	0	0.00000	0.00000
5	284549007	Laceration of hand	123	195967001	Asthma	1095	104	2	0	104	2	989	0.00000	-0.01386	0.00000	0.00000	0.00000	1.0000000000	1.0000000000	0.18995	-0.25091	54	1	0	50	1	0	0.00000	0.00000
1	444814009	Viral sinusitis (disorder)	123	195967001	Asthma	1095	993	2	2	991	0	102	1.10272	0.01371	0.00000	0.00000	0.00000	1.0000000000	1.0000000000	1.81370	0.09249	478	1	1	515	1	1	0.00000	-0.07441
109	90560007	Gout	97	403192003	Third degree burn	1095	4	8	0	4	8	1083	0.00000	-0.00519	0.00000	0.00000	0.00000	1.0000000000	1.0000000000	0.02922	-0.04156	0	3	0	4	5	0	0.00000	0.00000
96	283371005	Laceration of forearm	97	403192003	Third degree burn	1095	75	8	0	75	8	1012	0.00000	-0.02326	0.00000	0.00000	0.00000	1.0000000000	1.0000000000	0.54795	-0.63035	39	3	0	36	5	0	0.00000	0.00000
94	703151001	History of single seizure (situation)	97	403192003	Third degree burn	1095	39	8	0	39	8	1048	0.00000	-0.01649	0.00000	0.00000	0.00000	1.0000000000	1.0000000000	0.28493	-0.36169	14	3	0	25	5	0	0.00000	0.00000
93	128613002	Seizure disorder	97	403192003	Third degree burn	1095	39	8	0	39	8	1048	0.00000	-0.01649	0.00000	0.00000	0.00000	1.0000000000	1.0000000000	0.28493	-0.36169	14	3	0	25	5	0	0.00000	0.00000
118	48333001	Burn injury(morphologic abnormality)	57	192127007	Child attention deficit disorder	1095	1	76	0	1	76	1018	0.00000	-0.00826	0.00000	0.00000	0.00000	1.0000000000	1.0000000000	0.06941	-0.09681	0	24	0	1	52	0	0.00000	0.00000
86	713197008	Recurrent rectal polyp	97	403192003	Third degree burn	1095	22	8	0	22	8	1065	0.00000	-0.01228	0.00000	0.00000	0.00000	1.0000000000	1.0000000000	0.16073	-0.21503	12	3	0	10	5	0	0.00000	0.00000
75	431855005	Chronic kidney disease stage 1 (disorder)	97	403192003	Third degree burn	1095	28	8	0	28	8	1059	0.00000	-0.01390	0.00000	0.00000	0.00000	1.0000000000	1.0000000000	0.20457	-0.26851	10	3	0	18	5	0	0.00000	0.00000
64	444448004	Injury of medial collateral ligament of knee	97	403192003	Third degree burn	1095	32	8	0	32	8	1055	0.00000	-0.01488	0.00000	0.00000	0.00000	1.0000000000	1.0000000000	0.23379	-0.30310	17	3	0	15	5	0	0.00000	0.00000
47	359817006	Closed fracture of hip	97	403192003	Third degree burn	1095	29	8	0	29	8	1058	0.00000	-0.01415	0.00000	0.00000	0.00000	1.0000000000	1.0000000000	0.21187	-0.27724	11	3	0	18	5	0	0.00000	0.00000
44	58150001	Fracture of clavicle	97	403192003	Third degree burn	1095	112	8	0	112	8	975	0.00000	-0.02896	0.00000	0.00000	0.00000	1.0000000000	1.0000000000	0.81826	-0.86256	55	3	0	57	5	0	0.00000	0.00000
43	307731004	Injury of tendon of the rotator cuff of shoulder	97	403192003	Third degree burn	1095	51	8	0	51	8	1036	0.00000	-0.01896	0.00000	0.00000	0.00000	1.0000000000	1.0000000000	0.37260	-0.45691	26	3	0	25	5	0	0.00000	0.00000
42	16114001	Fracture of ankle	97	403192003	Third degree burn	1095	108	8	0	108	8	979	0.00000	-0.02838	0.00000	0.00000	0.00000	1.0000000000	1.0000000000	0.78904	-0.83919	48	3	0	60	5	0	0.00000	0.00000
41	283385000	Laceration of thigh	97	403192003	Third degree burn	1095	105	8	1	104	7	983	1.30357	0.00848	1.35027	11.08203	0.16452	0.5547693232	1.0000000000	0.76712	0.17860	50	3	0	55	5	1	-1.79176	-4.02535
38	398254007	Preeclampsia	97	403192003	Third degree burn	1095	101	8	0	101	8	986	0.00000	-0.02735	0.00000	0.00000	0.00000	1.0000000000	1.0000000000	0.73790	-0.79734	101	3	0	0	5	0	0.00000	0.00000
35	19169002	Miscarriage in first trimester	97	403192003	Third degree burn	1095	174	8	1	173	7	914	0.78664	-0.00796	0.75475	6.17317	0.09228	1.0000000000	1.0000000000	1.27123	-0.18348	174	3	1	0	5	0	1.38629	5.16479
33	429007001	History of cardiac arrest (situation)	97	403192003	Third degree burn	1095	42	8	0	42	8	1045	0.00000	-0.01713	0.00000	0.00000	0.00000	1.0000000000	1.0000000000	0.30685	-0.38609	24	3	0	18	5	0	0.00000	0.00000
32	410429000	Cardiac Arrest	97	403192003	Third degree burn	1095	42	8	0	42	8	1045	0.00000	-0.01713	0.00000	0.00000	0.00000	1.0000000000	1.0000000000	0.30685	-0.38609	24	3	0	18	5	0	0.00000	0.00000
27	408512008	Body mass index 40+ - severely obese (finding)	97	403192003	Third degree burn	1095	97	8	1	96	7	991	1.41108	0.01099	1.47470	12.11199	0.17955	0.5250511798	1.0000000000	0.70868	0.22712	67	3	1	30	5	0	1.38629	4.21951
21	15777000	Prediabetes	97	403192003	Third degree burn	1095	333	8	5	328	3	759	2.05518	0.05984	3.85671	16.23254	0.91632	0.0605333035	0.4796557004	2.43288	0.80554	159	3	2	174	5	3	-0.06454	0.31072
130	314994000	Metastasis from malignant tumor of prostate (disorder)	71	201834006	Localized  primary osteoarthritis of the hand	1095	1	28	0	1	28	1066	0.00000	-0.00490	0.00000	0.00000	0.00000	1.0000000000	1.0000000000	0.02557	-0.03643	0	19	0	1	9	0	0.00000	0.00000
129	47505003	Posttraumatic stress disorder	71	201834006	Localized  primary osteoarthritis of the hand	1095	4	28	0	4	28	1063	0.00000	-0.00981	0.00000	0.00000	0.00000	1.0000000000	1.0000000000	0.10228	-0.14049	1	19	0	3	9	0	0.00000	0.00000
15	40055000	Chronic sinusitis (disorder)	97	403192003	Third degree burn	1095	216	8	4	212	4	875	2.53472	0.06527	4.12736	16.63719	1.02392	0.0531406653	0.4455289012	1.57808	0.95563	104	3	1	112	5	3	0.40547	1.00764
14	10509002	Acute bronchitis (disorder)	97	403192003	Third degree burn	1095	863	8	7	856	1	231	1.11023	0.01824	1.88902	15.43107	0.23125	1.0000000000	1.0000000000	6.30502	0.13111	418	3	2	445	5	5	0.22314	0.84730
117	230265002	Familial Alzheimer's disease of early onset (disorder)	58	239720000	Tear of meniscus of knee	1095	6	20	0	6	20	1069	0.00000	-0.01012	0.00000	0.00000	0.00000	1.0000000000	1.0000000000	0.10959	-0.15003	2	10	0	4	10	0	0.00000	0.00000
125	1734006	Fracture of the vertebral column with spinal cord injury	71	201834006	Localized  primary osteoarthritis of the hand	1095	5	28	0	5	28	1062	0.00000	-0.01097	0.00000	0.00000	0.00000	1.0000000000	1.0000000000	0.12785	-0.17358	3	19	0	2	9	0	0.00000	0.00000
118	48333001	Burn injury(morphologic abnormality)	71	201834006	Localized  primary osteoarthritis of the hand	1095	1	28	0	1	28	1066	0.00000	-0.00490	0.00000	0.00000	0.00000	1.0000000000	1.0000000000	0.02557	-0.03643	0	19	0	1	9	0	0.00000	0.00000
117	230265002	Familial Alzheimer's disease of early onset (disorder)	71	201834006	Localized  primary osteoarthritis of the hand	1095	6	28	0	6	28	1061	0.00000	-0.01202	0.00000	0.00000	0.00000	1.0000000000	1.0000000000	0.15342	-0.20592	2	19	0	4	9	0	0.00000	0.00000
115	36923009	Major depression  single episode	71	201834006	Localized  primary osteoarthritis of the hand	1095	6	28	0	6	28	1061	0.00000	-0.01202	0.00000	0.00000	0.00000	1.0000000000	1.0000000000	0.15342	-0.20592	3	19	0	3	9	0	0.00000	0.00000
109	90560007	Gout	71	201834006	Localized  primary osteoarthritis of the hand	1095	4	28	0	4	28	1063	0.00000	-0.00981	0.00000	0.00000	0.00000	1.0000000000	1.0000000000	0.10228	-0.14049	0	19	0	4	9	0	0.00000	0.00000
106	24079001	Atopic dermatitis	71	201834006	Localized  primary osteoarthritis of the hand	1095	20	28	0	20	28	1047	0.00000	-0.02210	0.00000	0.00000	0.00000	1.0000000000	1.0000000000	0.51142	-0.59590	13	19	0	7	9	0	0.00000	0.00000
102	90781000119102	Microalbuminuria due to type 2 diabetes mellitus (disorder)	71	201834006	Localized  primary osteoarthritis of the hand	1095	6	28	0	6	28	1061	0.00000	-0.01202	0.00000	0.00000	0.00000	1.0000000000	1.0000000000	0.15342	-0.20592	3	19	0	3	9	0	0.00000	0.00000
98	1551000119108	Nonproliferative diabetic retinopathy due to type 2 diabetes mellitus (disorder)	71	201834006	Localized  primary osteoarthritis of the hand	1095	12	28	2	10	26	1057	6.51786	0.09409	8.13077	38.97431	1.69623	0.0355336367	0.3556605050	0.30685	1.19887	7	19	2	5	9	0	2.35138	1.50408
97	403192003	Third degree burn	71	201834006	Localized  primary osteoarthritis of the hand	1095	8	28	0	8	28	1059	0.00000	-0.01390	0.00000	0.00000	0.00000	1.0000000000	1.0000000000	0.20457	-0.26851	3	19	0	5	9	0	0.00000	0.00000
96	283371005	Laceration of forearm	71	201834006	Localized  primary osteoarthritis of the hand	1095	75	28	4	71	24	996	2.08571	0.04769	2.33803	6.92297	0.78960	0.1189753943	0.6839332097	1.91781	0.77704	39	19	4	36	9	0	1.74920	2.37491
94	703151001	History of single seizure (situation)	71	201834006	Localized  primary osteoarthritis of the hand	1095	39	28	1	38	27	1029	1.00275	0.00009	1.00292	7.57566	0.13277	1.0000000000	1.0000000000	0.99726	0.00198	14	19	1	25	9	0	2.99573	2.70805
93	128613002	Seizure disorder	71	201834006	Localized  primary osteoarthritis of the hand	1095	39	28	1	38	27	1029	1.00275	0.00009	1.00292	7.57566	0.13277	1.0000000000	1.0000000000	0.99726	0.00198	14	19	1	25	9	0	2.99573	2.70805
89	47693006	Rupture of appendix	71	201834006	Localized  primary osteoarthritis of the hand	1095	20	28	1	19	27	1048	1.95536	0.02111	2.04288	15.81901	0.26382	0.4070686830	1.0000000000	0.51142	0.40410	10	19	0	10	9	1	-2.30259	-2.39790
86	713197008	Recurrent rectal polyp	71	201834006	Localized  primary osteoarthritis of the hand	1095	22	28	3	19	25	1048	5.33279	0.10050	6.61895	23.82081	1.83917	0.0166599634	0.2196591865	0.56256	1.35609	12	19	2	10	9	1	0.04879	-0.45199
82	94260004	Secondary malignant neoplasm of colon	71	201834006	Localized  primary osteoarthritis of the hand	1095	4	28	0	4	28	1063	0.00000	-0.00981	0.00000	0.00000	0.00000	1.0000000000	1.0000000000	0.10228	-0.14049	2	19	0	2	9	0	0.00000	0.00000
76	127013003	Diabetic renal disease (disorder)	71	201834006	Localized  primary osteoarthritis of the hand	1095	28	28	3	25	25	1042	4.19005	0.08371	5.00160	17.66000	1.41654	0.0319796229	0.3290939384	0.71598	1.22097	10	19	1	18	9	2	1.29098	0.09531
75	431855005	Chronic kidney disease stage 1 (disorder)	71	201834006	Localized  primary osteoarthritis of the hand	1095	28	28	3	25	25	1042	4.19005	0.08371	5.00160	17.66000	1.41654	0.0319796229	0.3290939384	0.71598	1.22097	10	19	1	18	9	2	1.29098	0.09531
72	35999006	Blighted ovum	71	201834006	Localized  primary osteoarthritis of the hand	1095	53	28	7	46	21	1021	5.16509	0.15217	7.39855	18.28827	2.99310	0.0002247947	0.0071236376	1.35525	1.76412	53	19	7	0	9	0	1.31219	2.14843
69	233604007	Pneumonia	71	201834006	Localized  primary osteoarthritis of the hand	1095	7	28	0	7	28	1060	0.00000	-0.01299	0.00000	0.00000	0.00000	1.0000000000	1.0000000000	0.17900	-0.23756	3	19	0	4	9	0	0.00000	0.00000
67	403191005	Second degree burn	71	201834006	Localized  primary osteoarthritis of the hand	1095	49	28	2	47	26	1020	1.59621	0.02090	1.66939	7.24351	0.38474	0.3594523324	1.0000000000	1.25297	0.41314	23	19	2	26	9	0	2.35138	2.52573
64	444448004	Injury of medial collateral ligament of knee	71	201834006	Localized  primary osteoarthritis of the hand	1095	32	28	2	30	26	1037	2.44420	0.04059	2.65897	11.71957	0.60328	0.1957480899	0.8340316782	0.81826	0.72240	17	19	1	15	9	1	0.69315	0.11778
63	68496003	Polyp of colon	71	201834006	Localized  primary osteoarthritis of the hand	1095	91	28	7	84	21	983	3.00824	0.09794	3.90079	9.44154	1.61162	0.0060472962	0.1051151811	2.32694	1.26580	43	19	5	48	9	2	-0.13613	-0.95711
58	239720000	Tear of meniscus of knee	71	201834006	Localized  primary osteoarthritis of the hand	1095	20	28	1	19	27	1048	1.95536	0.02111	2.04288	15.81901	0.26382	0.4070686830	1.0000000000	0.51142	0.40410	10	19	1	10	9	0	2.99573	2.39790
57	192127007	Child attention deficit disorder	71	201834006	Localized  primary osteoarthritis of the hand	1095	76	28	3	73	25	994	1.54370	0.02405	1.63397	5.53964	0.48196	0.4368350939	1.0000000000	1.94338	0.44253	24	19	1	52	9	2	1.29098	-0.07696
54	5602001	Opioid abuse (disorder)	71	201834006	Localized  primary osteoarthritis of the hand	1095	7	28	1	6	27	1061	5.58673	0.05960	6.54938	56.29236	0.76199	0.1662561273	0.7915572889	0.17900	0.76244	0	19	0	7	9	1	-2.30259	-2.07944
50	446096008	Perennial allergic rhinitis	71	201834006	Localized  primary osteoarthritis of the hand	1095	26	28	0	26	28	1041	0.00000	-0.02526	0.00000	0.00000	0.00000	1.0000000000	1.0000000000	0.66484	-0.73538	14	19	0	12	9	0	0.00000	0.00000
49	88805009	Chronic congestive heart failure (disorder)	71	201834006	Localized  primary osteoarthritis of the hand	1095	10	28	1	9	27	1058	3.91071	0.04527	4.35391	35.59037	0.53263	0.2290399332	0.8880487574	0.25571	0.67150	5	19	1	5	9	0	2.99573	1.79176
118	48333001	Burn injury(morphologic abnormality)	59	262574004	Bullet wound	1095	1	20	0	1	20	1074	0.00000	-0.00412	0.00000	0.00000	0.00000	1.0000000000	1.0000000000	0.01826	-0.02611	0	9	0	1	11	0	0.00000	0.00000
47	359817006	Closed fracture of hip	71	201834006	Localized  primary osteoarthritis of the hand	1095	29	28	2	27	26	1040	2.69704	0.04534	2.96296	13.12205	0.66904	0.1677607757	0.7942848378	0.74155	0.78459	11	19	0	18	9	2	-1.70475	-2.30259
44	58150001	Fracture of clavicle	71	201834006	Localized  primary osteoarthritis of the hand	1095	112	28	3	109	25	958	1.04751	0.00260	1.05468	3.55045	0.31330	0.7594661643	1.0000000000	2.86393	0.04993	55	19	2	57	9	1	0.04879	-0.71054
43	307731004	Injury of tendon of the rotator cuff of shoulder	71	201834006	Localized  primary osteoarthritis of the hand	1095	51	28	3	48	25	1019	2.30042	0.04656	2.54750	8.73347	0.74309	0.1376504409	0.7296699408	1.30411	0.79579	26	19	1	25	9	2	1.29098	0.69315
42	16114001	Fracture of ankle	71	201834006	Localized  primary osteoarthritis of the hand	1095	108	28	2	106	26	961	0.72421	-0.01478	0.69739	2.97942	0.16324	1.0000000000	1.0000000000	2.76164	-0.32640	48	19	2	60	9	0	2.35138	3.21888
41	283385000	Laceration of thigh	71	201834006	Localized  primary osteoarthritis of the hand	1095	105	28	4	101	24	966	1.48980	0.02584	1.59406	4.68539	0.54233	0.3348341227	1.0000000000	2.68493	0.44029	50	19	3	55	9	1	-0.31015	-1.15367
39	74400008	Appendicitis	71	201834006	Localized  primary osteoarthritis of the hand	1095	51	28	3	48	25	1019	2.30042	0.04656	2.54750	8.73347	0.74309	0.1376504409	0.7296699408	1.30411	0.79579	27	19	2	24	9	1	0.04879	-0.54473
38	398254007	Preeclampsia	71	201834006	Localized  primary osteoarthritis of the hand	1095	101	28	7	94	21	973	2.71040	0.08832	3.45035	8.32849	1.42942	0.0107562715	0.1619529182	2.58265	1.15897	101	19	7	0	9	0	1.31219	2.73622
35	19169002	Miscarriage in first trimester	71	201834006	Localized  primary osteoarthritis of the hand	1095	174	28	16	158	12	909	3.59606	0.18279	7.67089	16.52269	3.56131	0.0000004637	0.0000249729	4.44932	1.64139	174	19	16	0	9	0	0.78276	2.47444
33	429007001	History of cardiac arrest (situation)	71	201834006	Localized  primary osteoarthritis of the hand	1095	42	28	1	41	27	1026	0.93112	-0.00223	0.92683	6.98809	0.12293	1.0000000000	1.0000000000	1.07397	-0.05240	24	19	1	18	9	0	2.99573	3.21888
32	410429000	Cardiac Arrest	71	201834006	Localized  primary osteoarthritis of the hand	1095	42	28	1	41	27	1026	0.93112	-0.00223	0.92683	6.98809	0.12293	1.0000000000	1.0000000000	1.07397	-0.05240	24	19	1	18	9	0	2.99573	3.21888
30	399211009	History of myocardial infarction (situation)	71	201834006	Localized  primary osteoarthritis of the hand	1095	31	28	0	31	28	1036	0.00000	-0.02765	0.00000	0.00000	0.00000	1.0000000000	1.0000000000	0.79269	-0.84213	2	19	0	29	9	0	0.00000	0.00000
27	408512008	Body mass index 40+ - severely obese (finding)	71	201834006	Localized  primary osteoarthritis of the hand	1095	97	28	6	91	22	976	2.41900	0.07166	2.92507	7.39811	1.15652	0.0312954895	0.3268117118	2.48037	1.00812	67	19	5	30	9	1	-0.73397	-0.76676
24	162864005	Body mass index 30+ - obesity (finding)	71	201834006	Localized  primary osteoarthritis of the hand	1095	439	28	19	420	9	647	1.69256	0.09178	3.25212	7.25624	1.45754	0.0030635971	0.0612579841	11.22557	0.71010	226	19	14	213	9	5	-0.17217	-0.93348
23	36971009	Sinusitis (disorder)	71	201834006	Localized  primary osteoarthritis of the hand	1095	190	28	7	183	21	884	1.44079	0.03272	1.61020	3.84373	0.67454	0.3085597153	0.9994602144	4.85845	0.44948	84	19	5	106	9	2	-0.13613	-1.10979
117	230265002	Familial Alzheimer's disease of early onset (disorder)	90	444470001	Injury of anterior cruciate ligament	1095	6	19	0	6	19	1070	0.00000	-0.00986	0.00000	0.00000	0.00000	1.0000000000	1.0000000000	0.10411	-0.14288	2	10	0	4	9	0	0.00000	0.00000
21	15777000	Prediabetes	71	201834006	Localized  primary osteoarthritis of the hand	1095	333	28	16	317	12	750	1.87902	0.09413	3.15457	6.74470	1.47543	0.0030948285	0.0616018244	8.51507	0.83725	159	19	12	174	9	4	-0.22957	-1.13873
20	80394007	Hyperglycemia (disorder)	71	201834006	Localized  primary osteoarthritis of the hand	1095	55	28	7	48	21	1019	4.97727	0.14817	7.07639	17.45837	2.86827	0.0002857888	0.0086804644	1.40639	1.73313	23	19	4	32	9	3	0.36291	-0.54719
120	162573006	Suspected lung cancer (situation)	90	444470001	Injury of anterior cruciate ligament	1095	8	19	1	7	18	1069	7.20395	0.07072	8.48413	72.57709	0.99178	0.1310631548	0.7119259731	0.13881	0.81247	0	10	0	8	9	1	-2.30259	-2.19722
18	302870006	Hypertriglyceridemia (disorder)	71	201834006	Localized  primary osteoarthritis of the hand	1095	64	28	7	57	21	1010	4.27734	0.13228	5.90643	14.47021	2.41088	0.0007473984	0.0195453746	1.63653	1.60136	28	19	4	36	9	3	0.36291	-0.48551
17	368581000119106	Neuropathy due to type 2 diabetes mellitus (disorder)	71	201834006	Localized  primary osteoarthritis of the hand	1095	28	28	6	22	22	1045	8.38010	0.19367	12.95455	35.09341	4.78210	0.0000408550	0.0015391652	0.71598	2.02832	7	19	3	21	9	3	0.60614	-0.87547
123	195967001	Asthma	90	444470001	Injury of anterior cruciate ligament	1095	2	19	0	2	19	1074	0.00000	-0.00568	0.00000	0.00000	0.00000	1.0000000000	1.0000000000	0.03470	-0.04922	1	10	0	1	9	0	0.00000	0.00000
15	40055000	Chronic sinusitis (disorder)	71	201834006	Localized  primary osteoarthritis of the hand	1095	216	28	12	204	16	863	2.17262	0.09416	3.17279	6.81061	1.47808	0.0058801089	0.1030251407	5.52329	0.99484	104	19	9	112	9	3	-0.25131	-1.11616
14	10509002	Acute bronchitis (disorder)	71	201834006	Localized  primary osteoarthritis of the hand	1095	863	28	25	838	3	229	1.13288	0.04152	2.27725	7.60961	0.68149	0.2404124331	0.9095097439	22.06758	0.17264	418	19	18	445	9	7	-0.10613	-0.98050
13	370247008	Facial laceration	71	201834006	Localized  primary osteoarthritis of the hand	1095	109	28	5	104	23	963	1.79391	0.04276	2.01296	5.40679	0.74943	0.1885475497	0.8196068864	2.78721	0.66383	55	19	1	54	9	4	1.81708	1.35120
125	1734006	Fracture of the vertebral column with spinal cord injury	45	263102004	Fracture subluxation of wrist	1095	5	109	0	5	109	981	0.00000	-0.02252	0.00000	0.00000	0.00000	1.0000000000	1.0000000000	0.49772	-0.58276	3	51	0	2	58	0	0.00000	0.00000
124	1501000119109	Proliferative diabetic retinopathy due to type II diabetes mellitus (disorder)	45	263102004	Fracture subluxation of wrist	1095	1	109	0	1	109	985	0.00000	-0.01005	0.00000	0.00000	0.00000	1.0000000000	1.0000000000	0.09954	-0.13690	1	51	0	0	58	0	0.00000	0.00000
10	62106007	Concussion with no loss of consciousness	71	201834006	Localized  primary osteoarthritis of the hand	1095	206	28	8	198	20	869	1.51872	0.04045	1.75556	4.04345	0.76221	0.2165323678	0.8697435848	5.26758	0.52202	96	19	4	110	9	4	0.57054	-0.13103
130	314994000	Metastasis from malignant tumor of prostate (disorder)	90	444470001	Injury of anterior cruciate ligament	1095	1	19	0	1	19	1075	0.00000	-0.00402	0.00000	0.00000	0.00000	1.0000000000	1.0000000000	0.01735	-0.02482	0	10	0	1	9	0	0.00000	0.00000
131	93761005	Primary malignant neoplasm of colon	90	444470001	Injury of anterior cruciate ligament	1095	5	19	0	5	19	1071	0.00000	-0.00900	0.00000	0.00000	0.00000	1.0000000000	1.0000000000	0.08676	-0.12003	3	10	0	2	9	0	0.00000	0.00000
7	75498004	Acute bacterial sinusitis (disorder)	71	201834006	Localized  primary osteoarthritis of the hand	1095	187	28	8	179	20	888	1.67303	0.04948	1.98436	4.57582	0.86054	0.1227696876	0.6908155882	4.78174	0.63842	89	19	5	98	9	3	0.18232	-0.58265
6	39848009	Whiplash injury to neck	71	201834006	Localized  primary osteoarthritis of the hand	1095	182	28	4	178	24	889	0.85950	-0.01016	0.83240	2.42838	0.28533	1.0000000000	1.0000000000	4.65388	-0.17731	92	19	3	90	9	1	-0.31015	-1.05559
5	284549007	Laceration of hand	71	201834006	Localized  primary osteoarthritis of the hand	1095	104	28	2	102	26	965	0.75206	-0.01301	0.72775	3.11065	0.17026	1.0000000000	1.0000000000	2.65936	-0.28663	54	19	0	50	9	2	-1.70475	-3.25810
117	230265002	Familial Alzheimer's disease of early onset (disorder)	45	263102004	Fracture subluxation of wrist	1095	6	109	0	6	109	980	0.00000	-0.02468	0.00000	0.00000	0.00000	1.0000000000	1.0000000000	0.59726	-0.67560	2	51	0	4	58	0	0.00000	0.00000
115	36923009	Major depression  single episode	45	263102004	Fracture subluxation of wrist	1095	6	109	0	6	109	980	0.00000	-0.02468	0.00000	0.00000	0.00000	1.0000000000	1.0000000000	0.59726	-0.67560	3	51	0	3	58	0	0.00000	0.00000
114	449868002	Smokes tobacco daily	45	263102004	Fracture subluxation of wrist	1095	9	109	0	9	109	977	0.00000	-0.03027	0.00000	0.00000	0.00000	0.6110370615	1.0000000000	0.89589	-0.92288	2	51	0	7	58	0	0.00000	0.00000
111	235919008	Cholelithiasis	45	263102004	Fracture subluxation of wrist	1095	9	109	1	8	108	978	1.11621	0.00352	1.13194	9.13646	0.14024	1.0000000000	1.0000000000	0.89589	0.07712	7	51	0	2	58	1	-4.07754	-1.09861
109	90560007	Gout	45	263102004	Fracture subluxation of wrist	1095	4	109	0	4	109	982	0.00000	-0.02013	0.00000	0.00000	0.00000	1.0000000000	1.0000000000	0.39817	-0.48354	0	51	0	4	58	0	0.00000	0.00000
107	40275004	Contact dermatitis	45	263102004	Fracture subluxation of wrist	1095	18	109	1	17	108	969	0.55810	-0.01899	0.52778	4.00477	0.06955	1.0000000000	1.0000000000	1.79178	-0.48119	9	51	0	9	58	1	-4.07754	-2.30259
106	24079001	Atopic dermatitis	45	263102004	Fracture subluxation of wrist	1095	20	109	4	16	105	970	2.00917	0.04577	2.30952	7.03604	0.75808	0.1294841414	0.7077283894	1.99087	0.74136	13	51	2	7	58	2	-0.12405	0.51083
102	90781000119102	Microalbuminuria due to type 2 diabetes mellitus (disorder)	45	263102004	Fracture subluxation of wrist	1095	6	109	0	6	109	980	0.00000	-0.02468	0.00000	0.00000	0.00000	1.0000000000	1.0000000000	0.59726	-0.67560	3	51	0	3	58	0	0.00000	0.00000
98	1551000119108	Nonproliferative diabetic retinopathy due to type 2 diabetes mellitus (disorder)	45	263102004	Fracture subluxation of wrist	1095	12	109	0	12	109	974	0.00000	-0.03500	0.00000	0.00000	0.00000	0.6213470456	1.0000000000	1.19452	-1.13391	7	51	0	5	58	0	0.00000	0.00000
97	403192003	Third degree burn	45	263102004	Fracture subluxation of wrist	1095	8	109	1	7	108	979	1.25573	0.00729	1.29497	10.62474	0.15784	0.5690084463	1.0000000000	0.79635	0.15493	3	51	0	5	58	1	-4.07754	-1.79176
96	283371005	Laceration of forearm	45	263102004	Fracture subluxation of wrist	1095	75	109	10	65	99	921	1.33945	0.03060	1.43124	2.87437	0.71266	0.3161931466	1.0000000000	7.46575	0.37779	39	51	4	36	58	6	0.25392	0.42900
94	703151001	History of single seizure (situation)	45	263102004	Fracture subluxation of wrist	1095	39	109	2	37	107	949	0.51517	-0.03098	0.47941	2.01708	0.11395	0.4195763281	1.0000000000	3.88219	-0.70257	14	51	1	25	58	1	-0.12629	-0.55005
93	128613002	Seizure disorder	45	263102004	Fracture subluxation of wrist	1095	39	109	2	37	107	949	0.51517	-0.03098	0.47941	2.01708	0.11395	0.4195763281	1.0000000000	3.88219	-0.70257	14	51	1	25	58	1	-0.12629	-0.55005
89	47693006	Rupture of appendix	45	263102004	Fracture subluxation of wrist	1095	20	109	2	18	107	968	1.00459	0.00021	1.00519	4.39134	0.23009	1.0000000000	1.0000000000	1.99087	0.00440	10	51	1	10	58	1	-0.12629	0.00000
86	713197008	Recurrent rectal polyp	45	263102004	Fracture subluxation of wrist	1095	22	109	4	18	105	968	1.82652	0.03935	2.04868	6.16670	0.68060	0.2653344177	0.9339825096	2.18995	0.64839	12	51	3	10	58	1	-1.18717	-0.78846
127	431856006	Chronic kidney disease stage 2 (disorder)	60	301011002	Escherichia coli urinary tract infection	1095	5	92	1	4	91	999	2.38043	0.02832	2.74451	24.81366	0.30355	0.3557280433	1.0000000000	0.42009	0.49402	3	85	1	2	7	0	4.45435	1.38629
82	94260004	Secondary malignant neoplasm of colon	45	263102004	Fracture subluxation of wrist	1095	4	109	0	4	109	982	0.00000	-0.02013	0.00000	0.00000	0.00000	1.0000000000	1.0000000000	0.39817	-0.48354	2	51	0	2	58	0	0.00000	0.00000
78	239872002	Osteoarthritis of hip	45	263102004	Fracture subluxation of wrist	1095	21	109	1	20	108	966	0.47837	-0.02425	0.44722	3.36521	0.05943	0.7135465093	1.0000000000	2.09041	-0.62780	13	51	1	8	58	0	3.95124	2.63906
76	127013003	Diabetic renal disease (disorder)	45	263102004	Fracture subluxation of wrist	1095	28	109	2	26	107	960	0.71756	-0.01521	0.69015	2.94817	0.16156	1.0000000000	1.0000000000	2.78721	-0.33617	10	51	1	18	58	1	-0.12629	-0.54654
75	431855005	Chronic kidney disease stage 1 (disorder)	45	263102004	Fracture subluxation of wrist	1095	28	109	2	26	107	960	0.71756	-0.01521	0.69015	2.94817	0.16156	1.0000000000	1.0000000000	2.78721	-0.33617	10	51	1	18	58	1	-0.12629	-0.54654
72	35999006	Blighted ovum	45	263102004	Fracture subluxation of wrist	1095	53	109	5	48	104	938	0.94772	-0.00392	0.93950	2.41247	0.36588	1.0000000000	1.0000000000	5.27580	-0.06484	53	51	5	0	58	0	2.41591	2.45101
71	201834006	Localized  primary osteoarthritis of the hand	45	263102004	Fracture subluxation of wrist	1095	28	109	2	26	107	960	0.71756	-0.01521	0.69015	2.94817	0.16156	1.0000000000	1.0000000000	2.78721	-0.33617	19	51	1	9	58	1	-0.12629	0.69315
69	233604007	Pneumonia	45	263102004	Fracture subluxation of wrist	1095	7	109	3	4	106	982	4.30537	0.08815	6.94811	31.46170	1.53445	0.0249389977	0.2905941929	0.69680	1.23718	3	51	1	4	58	2	0.55005	0.28768
67	403191005	Second degree burn	45	263102004	Fracture subluxation of wrist	1095	49	109	4	45	105	941	0.82007	-0.01295	0.79661	2.25900	0.28092	0.8108237008	1.0000000000	4.87763	-0.23331	23	51	1	26	58	3	0.93898	0.90937
64	444448004	Injury of medial collateral ligament of knee	45	263102004	Fracture subluxation of wrist	1095	32	109	4	28	105	958	1.25573	0.01475	1.30340	3.78794	0.44849	0.5508158345	1.0000000000	3.18539	0.25657	17	51	1	15	58	3	0.93898	1.09861
63	68496003	Polyp of colon	45	263102004	Fracture subluxation of wrist	1095	91	109	18	73	91	913	1.98710	0.09881	2.47388	4.32654	1.41455	0.0028078930	0.0569230589	9.05845	0.91759	43	51	9	48	58	9	-0.11035	-0.09181
59	262574004	Bullet wound	45	263102004	Fracture subluxation of wrist	1095	20	109	0	20	109	966	0.00000	-0.04535	0.00000	0.00000	0.00000	0.2499376651	0.9133257124	1.99087	-1.58056	9	51	0	11	58	0	0.00000	0.00000
58	239720000	Tear of meniscus of knee	45	263102004	Fracture subluxation of wrist	1095	20	109	1	19	108	967	0.50229	-0.02257	0.47125	3.55487	0.06247	0.7121796267	1.0000000000	1.99087	-0.58056	10	51	0	10	58	1	-4.07754	-2.39790
57	192127007	Child attention deficit disorder	45	263102004	Fracture subluxation of wrist	1095	76	109	6	70	103	916	0.79310	-0.01879	0.76227	1.79825	0.32313	0.6914259605	1.0000000000	7.56530	-0.29115	24	51	1	52	58	5	1.41755	0.78526
54	5602001	Opioid abuse (disorder)	45	263102004	Fracture subluxation of wrist	1095	7	109	0	7	109	979	0.00000	-0.02667	0.00000	0.00000	0.00000	1.0000000000	1.0000000000	0.69680	-0.76282	0	51	0	7	58	0	0.00000	0.00000
52	124171000119105	Chronic intractable migraine without aura	45	263102004	Fracture subluxation of wrist	1095	51	109	6	45	103	941	1.18187	0.01336	1.21812	2.92440	0.50739	0.6310277764	1.0000000000	5.07671	0.20406	21	51	3	30	58	3	-0.12189	-0.31845
50	446096008	Perennial allergic rhinitis	45	263102004	Fracture subluxation of wrist	1095	26	109	5	21	104	965	1.93190	0.04832	2.20925	5.98176	0.81594	0.1710142375	0.7972585288	2.58813	0.74173	14	51	4	12	58	1	-1.45650	-1.06087
49	88805009	Chronic congestive heart failure (disorder)	45	263102004	Fracture subluxation of wrist	1095	10	109	1	9	108	977	1.00459	0.00015	1.00514	8.00971	0.12614	1.0000000000	1.0000000000	0.99543	0.00330	5	51	0	5	58	1	-4.07754	-1.79176
47	359817006	Closed fracture of hip	45	263102004	Fracture subluxation of wrist	1095	29	109	7	22	102	964	2.42487	0.07814	3.00713	7.21132	1.25398	0.0195807224	0.2449385150	2.88676	1.04143	11	51	3	18	58	4	0.14953	-0.16430
44	58150001	Fracture of clavicle	45	263102004	Fracture subluxation of wrist	1095	112	109	18	94	91	892	1.61452	0.06897	1.87702	3.24832	1.08462	0.0295456607	0.3166688761	11.14886	0.64518	55	51	4	57	58	14	0.98343	1.06762
43	307731004	Injury of tendon of the rotator cuff of shoulder	45	263102004	Fracture subluxation of wrist	1095	51	109	4	47	105	939	0.78791	-0.01559	0.76109	2.15452	0.26886	0.8110142269	1.0000000000	5.07671	-0.28136	26	51	1	25	58	3	0.93898	1.06224
42	16114001	Fracture of ankle	45	263102004	Fracture subluxation of wrist	1095	108	109	9	99	100	887	0.83716	-0.01791	0.80636	1.64507	0.39525	0.7342785230	1.0000000000	10.75068	-0.23274	48	51	1	60	58	8	1.84103	1.75175
41	283385000	Laceration of thigh	45	263102004	Fracture subluxation of wrist	1095	105	109	13	92	96	894	1.24377	0.02640	1.31590	2.44056	0.70950	0.3905468092	1.0000000000	10.45205	0.28982	50	51	9	55	58	4	-0.84372	-0.81093
39	74400008	Appendicitis	45	263102004	Fracture subluxation of wrist	1095	51	109	8	43	101	943	1.57582	0.04232	1.73705	3.79716	0.79463	0.1541569681	0.7722801598	5.07671	0.56663	27	51	3	24	58	5	0.35667	0.54473
38	398254007	Preeclampsia	45	263102004	Fracture subluxation of wrist	1095	101	109	10	91	99	895	0.99464	-0.00057	0.99345	1.97111	0.50070	1.0000000000	1.0000000000	10.05388	-0.00705	101	51	10	0	58	0	1.80829	2.40695
35	19169002	Miscarriage in first trimester	45	263102004	Fracture subluxation of wrist	1095	174	109	21	153	88	833	1.21243	0.03070	1.29924	2.15554	0.78311	0.3331532485	1.0000000000	17.32055	0.26404	174	51	21	0	58	0	1.23214	2.22848
33	429007001	History of cardiac arrest (situation)	45	263102004	Fracture subluxation of wrist	1095	42	109	6	36	103	950	1.43512	0.02889	1.53722	3.73531	0.63262	0.2987046469	0.9870898856	4.18082	0.43417	24	51	4	18	58	2	-0.78016	-0.35667
32	410429000	Cardiac Arrest	45	263102004	Fracture subluxation of wrist	1095	42	109	6	36	103	950	1.43512	0.02889	1.53722	3.73531	0.63262	0.2987046469	0.9870898856	4.18082	0.43417	24	51	4	18	58	2	-0.78016	-0.35667
30	399211009	History of myocardial infarction (situation)	45	263102004	Fracture subluxation of wrist	1095	31	109	2	29	107	957	0.64812	-0.01997	0.61682	2.62108	0.14516	0.7613405663	1.0000000000	3.08584	-0.44567	2	51	0	29	58	2	-3.40120	-2.74084
27	408512008	Body mass index 40+ - severely obese (finding)	45	263102004	Fracture subluxation of wrist	1095	97	109	14	83	95	903	1.44992	0.04664	1.60330	2.93444	0.87600	0.1522482124	0.7689498321	9.65571	0.49334	67	51	12	30	58	2	-1.74297	-0.88805
24	162864005	Body mass index 30+ - obesity (finding)	45	263102004	Fracture subluxation of wrist	1095	439	109	50	389	59	597	1.14418	0.03921	1.30060	1.93601	0.87373	0.2165936975	0.8697435848	43.69954	0.19024	226	51	29	213	58	21	-0.31019	-0.23683
23	36971009	Sinusitis (disorder)	45	263102004	Fracture subluxation of wrist	1095	190	109	28	162	81	824	1.48044	0.07319	1.75827	2.78945	1.10829	0.0226021801	0.2721606699	18.91324	0.54232	84	51	11	106	58	17	0.24496	0.17701
21	15777000	Prediabetes	45	263102004	Fracture subluxation of wrist	1095	333	109	32	301	77	685	0.96537	-0.00761	0.94577	1.45963	0.61281	0.9126657751	1.0000000000	33.14795	-0.04933	159	51	13	174	58	19	0.19457	0.26429
20	80394007	Hyperglycemia (disorder)	45	263102004	Fracture subluxation of wrist	1095	55	109	5	50	104	936	0.91326	-0.00663	0.90000	2.30713	0.35109	1.0000000000	1.0000000000	5.47489	-0.10989	23	51	2	32	58	3	0.26488	0.06899
19	237602007	Metabolic syndrome X (disorder)	45	263102004	Fracture subluxation of wrist	1095	64	109	6	58	103	928	0.94180	-0.00482	0.93204	2.21320	0.39251	1.0000000000	1.0000000000	6.37078	-0.07446	28	51	3	36	58	3	-0.12189	-0.22957
18	302870006	Hypertriglyceridemia (disorder)	45	263102004	Fracture subluxation of wrist	1095	64	109	6	58	103	928	0.94180	-0.00482	0.93204	2.21320	0.39251	1.0000000000	1.0000000000	6.37078	-0.07446	28	51	3	36	58	3	-0.12189	-0.22957
17	368581000119106	Neuropathy due to type 2 diabetes mellitus (disorder)	45	263102004	Fracture subluxation of wrist	1095	28	109	4	24	105	962	1.43512	0.02344	1.52698	4.48525	0.51985	0.5150537613	1.0000000000	2.78721	0.40079	7	51	2	21	58	2	-0.12405	-0.93827
125	1734006	Fracture of the vertebral column with spinal cord injury	35	19169002	Miscarriage in first trimester	1095	5	174	1	4	173	917	1.25862	0.00761	1.32514	11.92748	0.14722	0.5797807012	1.0000000000	0.79452	0.15640	3	174	1	2	0	0	5.16479	1.38629
15	40055000	Chronic sinusitis (disorder)	45	263102004	Fracture subluxation of wrist	1095	216	109	23	193	86	793	1.06970	0.01149	1.09887	1.78698	0.67573	0.7040724006	1.0000000000	21.50137	0.09302	104	51	9	112	58	14	0.25951	0.33294
14	10509002	Acute bronchitis (disorder)	45	263102004	Fracture subluxation of wrist	1095	863	109	95	768	14	218	1.10586	0.06788	1.92615	3.44330	1.07747	0.0257378335	0.2915183263	85.90594	0.14358	418	51	44	445	58	51	0.01017	0.07662
13	370247008	Facial laceration	45	263102004	Fracture subluxation of wrist	1095	109	109	16	93	93	893	1.47462	0.05247	1.65198	2.92654	0.93252	0.0912883830	0.5996557347	10.85023	0.52062	55	51	6	54	58	10	0.33437	0.46282
125	1734006	Fracture of the vertebral column with spinal cord injury	19	237602007	Metabolic syndrome X (disorder)	1095	5	64	0	5	64	1026	0.00000	-0.01687	0.00000	0.00000	0.00000	1.0000000000	1.0000000000	0.29224	-0.36987	3	28	0	2	36	0	0.00000	0.00000
124	1501000119109	Proliferative diabetic retinopathy due to type II diabetes mellitus (disorder)	19	237602007	Metabolic syndrome X (disorder)	1095	1	64	1	0	63	1031	17.10937	0.12135	0.00000	0.00000	0.00000	0.0584474886	0.4685406893	0.05845	0.91805	1	28	1	0	36	0	3.36730	0.69315
10	62106007	Concussion with no loss of consciousness	45	263102004	Fracture subluxation of wrist	1095	206	109	24	182	85	804	1.17039	0.02727	1.24732	2.01731	0.77123	0.3669936569	1.0000000000	20.50594	0.21719	96	51	10	110	58	14	0.17068	0.17963
7	75498004	Acute bacterial sinusitis (disorder)	45	263102004	Fracture subluxation of wrist	1095	187	109	20	167	89	819	1.07442	0.01123	1.10207	1.84034	0.65996	0.6885427973	1.0000000000	18.61461	0.09846	89	51	11	98	58	9	-0.27823	-0.26833
6	39848009	Whiplash injury to neck	45	263102004	Fracture subluxation of wrist	1095	182	109	19	163	90	823	1.04874	0.00724	1.06592	1.79755	0.63207	0.7870411013	1.0000000000	18.11689	0.06515	92	51	10	90	58	9	-0.19918	-0.07551
5	284549007	Laceration of hand	45	263102004	Fracture subluxation of wrist	1095	104	109	8	96	101	890	0.77276	-0.02448	0.73432	1.55461	0.34686	0.4940706688	1.0000000000	10.35251	-0.33501	54	51	5	50	58	3	-0.59635	-0.40358
117	230265002	Familial Alzheimer's disease of early onset (disorder)	19	237602007	Metabolic syndrome X (disorder)	1095	6	64	2	4	62	1027	5.70312	0.08698	8.28226	46.09666	1.48809	0.0433161433	0.3987203055	0.35068	1.15127	2	28	2	4	36	0	2.70805	0.69315
115	36923009	Major depression  single episode	19	237602007	Metabolic syndrome X (disorder)	1095	6	64	1	5	63	1026	2.85156	0.03424	3.25714	28.30123	0.37486	0.3038598319	0.9949586182	0.35068	0.56631	3	28	0	3	36	1	-3.61092	-1.38629
1	444814009	Viral sinusitis (disorder)	45	263102004	Fracture subluxation of wrist	1095	993	109	104	889	5	97	1.05214	0.05409	2.26952	5.70340	0.90309	0.0819334933	0.5645307727	98.84658	0.07260	478	51	50	515	58	54	-0.02642	0.00218
111	235919008	Cholelithiasis	19	237602007	Metabolic syndrome X (disorder)	1095	9	64	0	9	64	1022	0.00000	-0.02268	0.00000	0.00000	0.00000	1.0000000000	1.0000000000	0.52603	-0.60978	7	28	0	2	36	0	0.00000	0.00000
109	90560007	Gout	19	237602007	Metabolic syndrome X (disorder)	1095	4	64	0	4	64	1027	0.00000	-0.01509	0.00000	0.00000	0.00000	1.0000000000	1.0000000000	0.23379	-0.30310	0	28	0	4	36	0	0.00000	0.00000
107	40275004	Contact dermatitis	19	237602007	Metabolic syndrome X (disorder)	1095	18	64	2	16	62	1015	1.90104	0.02902	2.04637	9.09966	0.46020	0.2838342633	0.9659403678	1.05205	0.54789	9	28	0	9	36	2	-2.94444	-1.70475
106	24079001	Atopic dermatitis	19	237602007	Metabolic syndrome X (disorder)	1095	20	64	0	20	64	1011	0.00000	-0.03398	0.00000	0.00000	0.00000	0.6248676804	1.0000000000	1.16895	-1.11700	13	28	0	7	36	0	0.00000	0.00000
102	90781000119102	Microalbuminuria due to type 2 diabetes mellitus (disorder)	19	237602007	Metabolic syndrome X (disorder)	1095	6	64	6	0	58	1031	17.10937	0.29792	0.00000	0.00000	0.00000	0.0000000317	0.0000020049	0.35068	2.37366	3	28	3	3	36	3	-0.22957	0.00000
98	1551000119108	Nonproliferative diabetic retinopathy due to type 2 diabetes mellitus (disorder)	19	237602007	Metabolic syndrome X (disorder)	1095	12	64	12	0	52	1031	17.10937	0.42249	0.00000	0.00000	0.00000	0.0000000000	0.0000000000	0.70137	2.93374	7	28	7	5	36	5	-0.49470	0.00000
97	403192003	Third degree burn	19	237602007	Metabolic syndrome X (disorder)	1095	8	64	1	7	63	1024	2.13867	0.02434	2.32200	19.16544	0.28132	0.3833144949	1.0000000000	0.46758	0.44656	3	28	0	5	36	1	-3.61092	-1.79176
96	283371005	Laceration of forearm	19	237602007	Metabolic syndrome X (disorder)	1095	75	64	5	70	59	961	1.14062	0.00950	1.16344	2.99213	0.45238	0.7966432752	1.0000000000	4.38356	0.15640	39	28	4	36	36	1	-1.53148	-1.23601
94	703151001	History of single seizure (situation)	19	237602007	Metabolic syndrome X (disorder)	1095	39	64	2	37	62	994	0.87740	-0.00587	0.86661	3.67902	0.20413	1.0000000000	1.0000000000	2.27945	-0.12849	14	28	0	25	36	2	-2.94444	-2.60269
93	128613002	Seizure disorder	19	237602007	Metabolic syndrome X (disorder)	1095	39	64	2	37	62	994	0.87740	-0.00587	0.86661	3.67902	0.20413	1.0000000000	1.0000000000	2.27945	-0.12849	14	28	0	25	36	2	-2.94444	-2.60269
89	47693006	Rupture of appendix	19	237602007	Metabolic syndrome X (disorder)	1095	20	64	0	20	64	1011	0.00000	-0.03398	0.00000	0.00000	0.00000	0.6248676804	1.0000000000	1.16895	-1.11700	10	28	0	10	36	0	0.00000	0.00000
86	713197008	Recurrent rectal polyp	19	237602007	Metabolic syndrome X (disorder)	1095	22	64	2	20	62	1011	1.55540	0.01981	1.63065	7.13472	0.37269	0.3720143327	1.0000000000	1.28584	0.39224	12	28	1	10	36	1	-0.24362	0.16705
82	94260004	Secondary malignant neoplasm of colon	19	237602007	Metabolic syndrome X (disorder)	1095	4	64	1	3	63	1028	4.27734	0.04944	5.43915	53.04017	0.55777	0.2143481492	0.8672161313	0.23379	0.69690	2	28	0	2	36	1	-3.61092	-1.09861
78	239872002	Osteoarthritis of hip	19	237602007	Metabolic syndrome X (disorder)	1095	21	64	4	17	60	1014	3.25893	0.07870	3.97647	12.18594	1.29759	0.0299470893	0.3180139089	1.22740	1.16657	13	28	1	8	36	3	0.80235	1.33977
76	127013003	Diabetic renal disease (disorder)	19	237602007	Metabolic syndrome X (disorder)	1095	28	64	28	0	36	1031	17.10937	0.65018	0.00000	0.00000	0.00000	0.0000000000	0.0000000000	1.63653	3.45934	10	28	10	18	36	18	0.23639	0.00000
75	431855005	Chronic kidney disease stage 1 (disorder)	19	237602007	Metabolic syndrome X (disorder)	1095	28	64	28	0	36	1031	17.10937	0.65018	0.00000	0.00000	0.00000	0.0000000000	0.0000000000	1.63653	3.45934	10	28	10	18	36	18	0.23639	0.00000
72	35999006	Blighted ovum	19	237602007	Metabolic syndrome X (disorder)	1095	53	64	4	49	60	982	1.29127	0.01637	1.33605	3.82561	0.46660	0.5446666602	1.0000000000	3.09772	0.28711	53	28	4	0	36	0	2.07944	2.65676
71	201834006	Localized  primary osteoarthritis of the hand	19	237602007	Metabolic syndrome X (disorder)	1095	28	64	7	21	57	1010	4.27734	0.13228	5.90643	14.47021	2.41088	0.0007473984	0.0195453746	1.63653	1.60136	19	28	4	9	36	3	-0.48551	0.36291
69	233604007	Pneumonia	19	237602007	Metabolic syndrome X (disorder)	1095	7	64	0	7	64	1024	0.00000	-0.01998	0.00000	0.00000	0.00000	1.0000000000	1.0000000000	0.40913	-0.49481	3	28	0	4	36	0	0.00000	0.00000
67	403191005	Second degree burn	19	237602007	Metabolic syndrome X (disorder)	1095	49	64	5	44	59	987	1.74585	0.04022	1.90100	4.97260	0.72674	0.2011812805	0.8478009028	2.86393	0.63489	23	28	2	26	36	3	0.14310	0.25705
64	444448004	Injury of medial collateral ligament of knee	19	237602007	Metabolic syndrome X (disorder)	1095	32	64	3	29	61	1002	1.60400	0.02611	1.69927	5.73536	0.50346	0.4277586209	1.0000000000	1.87032	0.47879	17	28	2	15	36	1	-0.90287	-0.52130
63	68496003	Polyp of colon	19	237602007	Metabolic syndrome X (disorder)	1095	91	64	6	85	58	946	1.12809	0.00961	1.15132	2.74625	0.48267	0.6458562072	1.0000000000	5.31872	0.14772	43	28	1	48	36	5	1.26316	1.42334
59	262574004	Bullet wound	19	237602007	Metabolic syndrome X (disorder)	1095	20	64	1	19	63	1012	0.85547	-0.00491	0.84545	6.41754	0.11138	1.0000000000	1.0000000000	1.16895	-0.11700	9	28	0	11	36	1	-3.61092	-2.48491
58	239720000	Tear of meniscus of knee	19	237602007	Metabolic syndrome X (disorder)	1095	20	64	2	18	62	1013	1.71094	0.02416	1.81541	8.00062	0.41193	0.3282786903	1.0000000000	1.16895	0.46797	10	28	0	10	36	2	-2.94444	-1.79176
57	192127007	Child attention deficit disorder	19	237602007	Metabolic syndrome X (disorder)	1095	76	64	6	70	58	961	1.35074	0.02387	1.42020	3.40634	0.59212	0.4421125672	1.0000000000	4.44201	0.36322	24	28	1	52	36	5	1.26316	0.78526
54	5602001	Opioid abuse (disorder)	19	237602007	Metabolic syndrome X (disorder)	1095	7	64	1	6	63	1025	2.44420	0.02886	2.71164	22.86920	0.32152	0.3447716508	1.0000000000	0.40913	0.50519	0	28	0	7	36	1	-3.61092	-2.07944
52	124171000119105	Chronic intractable migraine without aura	19	237602007	Metabolic syndrome X (disorder)	1095	51	64	5	46	59	985	1.67739	0.03730	1.81466	4.73741	0.69511	0.2148934447	0.8672161313	2.98082	0.59190	21	28	1	30	36	4	1.06471	0.95098
50	446096008	Perennial allergic rhinitis	19	237602007	Metabolic syndrome X (disorder)	1095	26	64	1	25	63	1006	0.65805	-0.01329	0.63873	4.79058	0.08516	1.0000000000	1.0000000000	1.51963	-0.33321	14	28	1	12	36	0	3.36730	2.70805
49	88805009	Chronic congestive heart failure (disorder)	19	237602007	Metabolic syndrome X (disorder)	1095	10	64	0	10	64	1021	0.00000	-0.02392	0.00000	0.00000	0.00000	1.0000000000	1.0000000000	0.58447	-0.66400	5	28	0	5	36	0	0.00000	0.00000
47	359817006	Closed fracture of hip	19	237602007	Metabolic syndrome X (disorder)	1095	29	64	0	29	64	1002	0.00000	-0.04109	0.00000	0.00000	0.00000	0.4078952467	1.0000000000	1.69498	-1.43027	11	28	0	18	36	0	0.00000	0.00000
44	58150001	Fracture of clavicle	19	237602007	Metabolic syndrome X (disorder)	1095	112	64	9	103	55	928	1.37486	0.03153	1.47432	3.07023	0.70796	0.2879641576	0.9712041902	6.54612	0.40619	55	28	4	57	36	5	-0.02469	0.17355
43	307731004	Injury of tendon of the rotator cuff of shoulder	19	237602007	Metabolic syndrome X (disorder)	1095	51	64	8	43	56	988	2.68382	0.09272	3.28239	7.31425	1.47303	0.0074735505	0.1247202016	2.98082	1.17686	26	28	3	25	36	5	0.23124	0.47692
42	16114001	Fracture of ankle	19	237602007	Metabolic syndrome X (disorder)	1095	108	64	4	104	60	927	0.63368	-0.03019	0.59423	1.66817	0.21167	0.3930397225	1.0000000000	6.31233	-0.54840	48	28	1	60	36	3	0.80235	0.84730
41	283385000	Laceration of thigh	19	237602007	Metabolic syndrome X (disorder)	1095	105	64	9	96	55	935	1.46652	0.03785	1.59375	3.32503	0.76391	0.1939583559	0.8321439142	6.13699	0.48661	50	28	5	55	36	4	-0.41552	-0.29335
114	449868002	Smokes tobacco daily	62	185086009	Chronic obstructive bronchitis (disorder)	1095	9	6	0	9	6	1080	0.00000	-0.00676	0.00000	0.00000	0.00000	1.0000000000	1.0000000000	0.04932	-0.06945	2	4	0	7	2	0	0.00000	0.00000
39	74400008	Appendicitis	19	237602007	Metabolic syndrome X (disorder)	1095	51	64	1	50	63	981	0.33548	-0.03659	0.31143	2.29150	0.04232	0.3580233069	1.0000000000	2.98082	-0.99307	27	28	0	24	36	1	-3.61092	-3.21888
38	398254007	Preeclampsia	19	237602007	Metabolic syndrome X (disorder)	1095	101	64	11	90	53	941	1.86340	0.06857	2.17002	4.30245	1.09449	0.0405687125	0.3849833570	5.90320	0.79770	101	28	11	0	36	0	1.26567	2.32060
35	19169002	Miscarriage in first trimester	19	237602007	Metabolic syndrome X (disorder)	1095	174	64	15	159	49	872	1.47495	0.05143	1.67886	3.06688	0.91904	0.1103653826	0.6550286197	10.16986	0.51846	174	28	15	0	36	0	1.05315	2.53370
33	429007001	History of cardiac arrest (situation)	19	237602007	Metabolic syndrome X (disorder)	1095	42	64	2	40	62	991	0.81473	-0.00922	0.79919	3.38371	0.18876	1.0000000000	1.0000000000	2.45479	-0.20364	24	28	2	18	36	0	2.70805	2.56495
32	410429000	Cardiac Arrest	19	237602007	Metabolic syndrome X (disorder)	1095	42	64	2	40	62	991	0.81473	-0.00922	0.79919	3.38371	0.18876	1.0000000000	1.0000000000	2.45479	-0.20364	24	28	2	18	36	0	2.70805	2.56495
30	399211009	History of myocardial infarction (situation)	19	237602007	Metabolic syndrome X (disorder)	1095	31	64	1	30	63	1001	0.55192	-0.01906	0.52963	3.94712	0.07107	1.0000000000	1.0000000000	1.81187	-0.49153	2	28	0	29	36	1	-3.61092	-3.40120
27	408512008	Body mass index 40+ - severely obese (finding)	19	237602007	Metabolic syndrome X (disorder)	1095	97	64	5	92	59	939	0.88193	-0.00917	0.86496	2.20916	0.33866	1.0000000000	1.0000000000	5.66941	-0.15260	67	28	4	30	36	1	-1.53148	-0.55760
24	162864005	Body mass index 30+ - obesity (finding)	19	237602007	Metabolic syndrome X (disorder)	1095	439	64	24	415	40	616	0.93536	-0.01317	0.89060	1.49973	0.52888	0.6954104148	1.0000000000	25.65845	-0.09266	226	28	11	213	36	13	-0.06120	0.21458
23	36971009	Sinusitis (disorder)	19	237602007	Metabolic syndrome X (disorder)	1095	190	64	15	175	49	856	1.35074	0.04004	1.49738	2.73052	0.82114	0.1773373347	0.8029498763	11.10502	0.40247	84	28	5	106	36	10	0.36101	0.42819
21	15777000	Prediabetes	19	237602007	Metabolic syndrome X (disorder)	1095	333	64	38	295	26	736	1.95242	0.15687	3.64641	6.11377	2.17482	0.0000008797	0.0000441265	19.46301	0.93046	159	28	14	174	36	24	0.18232	0.40402
20	80394007	Hyperglycemia (disorder)	19	237602007	Metabolic syndrome X (disorder)	1095	55	64	55	0	9	1031	17.10937	0.92300	0.00000	0.00000	0.00000	0.0000000000	0.0000000000	3.21461	3.73196	23	28	23	32	36	32	0.04256	0.00000
18	302870006	Hypertriglyceridemia (disorder)	19	237602007	Metabolic syndrome X (disorder)	1095	64	64	64	0	0	1031	17.10937	1.00000	0.00000	0.00000	0.00000	0.0000000000	0.0000000000	3.74064	3.77729	28	28	28	36	36	36	0.00000	0.00000
17	368581000119106	Neuropathy due to type 2 diabetes mellitus (disorder)	19	237602007	Metabolic syndrome X (disorder)	1095	28	64	28	0	36	1031	17.10937	0.65018	0.00000	0.00000	0.00000	0.0000000000	0.0000000000	1.63653	3.45934	7	28	7	21	36	21	0.61091	0.00000
15	40055000	Chronic sinusitis (disorder)	19	237602007	Metabolic syndrome X (disorder)	1095	216	64	14	202	50	829	1.10894	0.01346	1.14911	2.11966	0.62296	0.6292558955	1.0000000000	12.62466	0.13874	104	28	6	112	36	8	0.02985	0.20067
14	10509002	Acute bronchitis (disorder)	19	237602007	Metabolic syndrome X (disorder)	1095	863	64	58	805	6	226	1.14988	0.07202	2.71387	6.37096	1.15604	0.0171074362	0.2232466162	50.44018	0.19782	418	28	23	445	36	35	0.08900	0.33511
13	370247008	Facial laceration	19	237602007	Metabolic syndrome X (disorder)	1095	109	64	9	100	55	931	1.41270	0.03419	1.52345	3.17495	0.73101	0.2783723549	0.9565195531	6.37078	0.44011	55	28	4	54	36	5	-0.02469	0.22314
10	62106007	Concussion with no loss of consciousness	19	237602007	Metabolic syndrome X (disorder)	1095	206	64	19	187	45	844	1.57805	0.06933	1.90564	3.33331	1.08945	0.0307671173	0.3242181937	12.04018	0.61704	96	28	8	110	36	11	0.05183	0.16705
7	75498004	Acute bacterial sinusitis (disorder)	19	237602007	Metabolic syndrome X (disorder)	1095	187	64	15	172	49	859	1.37241	0.04211	1.52883	2.78873	0.83813	0.1710483090	0.7972585288	10.92968	0.42352	89	28	6	98	36	9	0.12516	0.28651
6	39848009	Whiplash injury to neck	19	237602007	Metabolic syndrome X (disorder)	1095	182	64	12	170	52	861	1.12809	0.01425	1.16878	2.23635	0.61083	0.6056718385	1.0000000000	10.63744	0.15974	92	28	6	90	36	6	-0.21131	0.02062
5	284549007	Laceration of hand	19	237602007	Metabolic syndrome X (disorder)	1095	104	64	8	96	56	935	1.31611	0.02551	1.39137	3.00504	0.64422	0.3795683378	1.0000000000	6.07854	0.34647	54	28	3	50	36	5	0.23124	0.54654
1	444814009	Viral sinusitis (disorder)	19	237602007	Metabolic syndrome X (disorder)	1095	993	64	63	930	1	101	1.08549	0.06646	6.84194	49.85778	0.93891	0.0242893411	0.2869607490	58.03836	0.11642	478	28	28	515	36	35	-0.01418	0.13976
117	230265002	Familial Alzheimer's disease of early onset (disorder)	63	68496003	Polyp of colon	1095	6	91	0	6	91	998	0.00000	-0.02235	0.00000	0.00000	0.00000	1.0000000000	1.0000000000	0.49863	-0.58364	2	43	0	4	48	0	0.00000	0.00000
118	48333001	Burn injury(morphologic abnormality)	64	444448004	Injury of medial collateral ligament of knee	1095	1	32	0	1	32	1062	0.00000	-0.00525	0.00000	0.00000	0.00000	1.0000000000	1.0000000000	0.02922	-0.04156	0	17	0	1	15	0	0.00000	0.00000
114	449868002	Smokes tobacco daily	65	239873007	Osteoarthritis of knee	1095	9	57	1	8	56	1030	2.13450	0.02420	2.29911	18.70335	0.28262	0.3830345370	1.0000000000	0.46849	0.44566	2	30	1	7	27	0	3.43399	1.09861
128	86849004	Suicidal deliberate poisoning	99	30832001	Rupture of patellar tendon	1095	1	23	0	1	23	1071	0.00000	-0.00443	0.00000	0.00000	0.00000	1.0000000000	1.0000000000	0.02100	-0.02999	0	14	0	1	9	0	0.00000	0.00000
114	449868002	Smokes tobacco daily	66	55822004	Hyperlipidemia	1095	9	119	2	7	117	969	2.04482	0.03321	2.36630	11.52434	0.48587	0.2550748223	0.9157655584	0.97808	0.60086	2	64	0	7	55	2	-3.34990	-1.50408
118	48333001	Burn injury(morphologic abnormality)	44	58150001	Fracture of clavicle	1095	1	112	0	1	112	982	0.00000	-0.01021	0.00000	0.00000	0.00000	1.0000000000	1.0000000000	0.10228	-0.14049	0	55	0	1	57	0	0.00000	0.00000
131	93761005	Primary malignant neoplasm of colon	132	69896004	Rheumatoid arthritis	1095	5	3	0	5	3	1087	0.00000	-0.00355	0.00000	0.00000	0.00000	1.0000000000	1.0000000000	0.01370	-0.01963	3	2	0	2	1	0	0.00000	0.00000
130	314994000	Metastasis from malignant tumor of prostate (disorder)	132	69896004	Rheumatoid arthritis	1095	1	3	0	1	3	1091	0.00000	-0.00158	0.00000	0.00000	0.00000	1.0000000000	1.0000000000	0.00274	-0.00395	0	2	0	1	1	0	0.00000	0.00000
129	47505003	Posttraumatic stress disorder	132	69896004	Rheumatoid arthritis	1095	4	3	0	4	3	1088	0.00000	-0.00317	0.00000	0.00000	0.00000	1.0000000000	1.0000000000	0.01096	-0.01572	1	2	0	3	1	0	0.00000	0.00000
128	86849004	Suicidal deliberate poisoning	132	69896004	Rheumatoid arthritis	1095	1	3	0	1	3	1091	0.00000	-0.00158	0.00000	0.00000	0.00000	1.0000000000	1.0000000000	0.00274	-0.00395	0	2	0	1	1	0	0.00000	0.00000
127	431856006	Chronic kidney disease stage 2 (disorder)	132	69896004	Rheumatoid arthritis	1095	5	3	0	5	3	1087	0.00000	-0.00355	0.00000	0.00000	0.00000	1.0000000000	1.0000000000	0.01370	-0.01963	3	2	0	2	1	0	0.00000	0.00000
126	698754002	Chronic paralysis due to lesion of spinal cord	132	69896004	Rheumatoid arthritis	1095	2	3	0	2	3	1090	0.00000	-0.00224	0.00000	0.00000	0.00000	1.0000000000	1.0000000000	0.00548	-0.00788	2	2	0	0	1	0	0.00000	0.00000
125	1734006	Fracture of the vertebral column with spinal cord injury	132	69896004	Rheumatoid arthritis	1095	5	3	0	5	3	1087	0.00000	-0.00355	0.00000	0.00000	0.00000	1.0000000000	1.0000000000	0.01370	-0.01963	3	2	0	2	1	0	0.00000	0.00000
124	1501000119109	Proliferative diabetic retinopathy due to type II diabetes mellitus (disorder)	132	69896004	Rheumatoid arthritis	1095	1	3	0	1	3	1091	0.00000	-0.00158	0.00000	0.00000	0.00000	1.0000000000	1.0000000000	0.00274	-0.00395	1	2	0	0	1	0	0.00000	0.00000
123	195967001	Asthma	132	69896004	Rheumatoid arthritis	1095	2	3	0	2	3	1090	0.00000	-0.00224	0.00000	0.00000	0.00000	1.0000000000	1.0000000000	0.00548	-0.00788	1	2	0	1	1	0	0.00000	0.00000
121	254637007	Non-small cell lung cancer (disorder)	132	69896004	Rheumatoid arthritis	1095	8	3	0	8	3	1084	0.00000	-0.00450	0.00000	0.00000	0.00000	1.0000000000	1.0000000000	0.02192	-0.03128	0	2	0	8	1	0	0.00000	0.00000
120	162573006	Suspected lung cancer (situation)	132	69896004	Rheumatoid arthritis	1095	8	3	0	8	3	1084	0.00000	-0.00450	0.00000	0.00000	0.00000	1.0000000000	1.0000000000	0.02192	-0.03128	0	2	0	8	1	0	0.00000	0.00000
119	275272006	Brain damage - traumatic	132	69896004	Rheumatoid arthritis	1095	4	3	0	4	3	1088	0.00000	-0.00317	0.00000	0.00000	0.00000	1.0000000000	1.0000000000	0.01096	-0.01572	0	2	0	4	1	0	0.00000	0.00000
118	48333001	Burn injury(morphologic abnormality)	132	69896004	Rheumatoid arthritis	1095	1	3	0	1	3	1091	0.00000	-0.00158	0.00000	0.00000	0.00000	1.0000000000	1.0000000000	0.00274	-0.00395	0	2	0	1	1	0	0.00000	0.00000
117	230265002	Familial Alzheimer's disease of early onset (disorder)	132	69896004	Rheumatoid arthritis	1095	6	3	0	6	3	1086	0.00000	-0.00389	0.00000	0.00000	0.00000	1.0000000000	1.0000000000	0.01644	-0.02352	2	2	0	4	1	0	0.00000	0.00000
116	370143000	Major depression disorder	132	69896004	Rheumatoid arthritis	1095	8	3	0	8	3	1084	0.00000	-0.00450	0.00000	0.00000	0.00000	1.0000000000	1.0000000000	0.02192	-0.03128	3	2	0	5	1	0	0.00000	0.00000
115	36923009	Major depression  single episode	132	69896004	Rheumatoid arthritis	1095	6	3	0	6	3	1086	0.00000	-0.00389	0.00000	0.00000	0.00000	1.0000000000	1.0000000000	0.01644	-0.02352	3	2	0	3	1	0	0.00000	0.00000
114	449868002	Smokes tobacco daily	132	69896004	Rheumatoid arthritis	1095	9	3	0	9	3	1083	0.00000	-0.00477	0.00000	0.00000	0.00000	1.0000000000	1.0000000000	0.02466	-0.03514	2	2	0	7	1	0	0.00000	0.00000
113	443165006	Pathological fracture due to osteoporosis (disorder)	132	69896004	Rheumatoid arthritis	1095	10	3	0	10	3	1082	0.00000	-0.00503	0.00000	0.00000	0.00000	1.0000000000	1.0000000000	0.02740	-0.03899	7	2	0	3	1	0	0.00000	0.00000
112	49436004	Atrial Fibrillation	132	69896004	Rheumatoid arthritis	1095	35	3	0	35	3	1057	0.00000	-0.00952	0.00000	0.00000	0.00000	1.0000000000	1.0000000000	0.09589	-0.13210	9	2	0	26	1	0	0.00000	0.00000
111	235919008	Cholelithiasis	132	69896004	Rheumatoid arthritis	1095	9	3	0	9	3	1083	0.00000	-0.00477	0.00000	0.00000	0.00000	1.0000000000	1.0000000000	0.02466	-0.03514	7	2	0	2	1	0	0.00000	0.00000
110	65275009	Acute Cholecystitis	132	69896004	Rheumatoid arthritis	1095	9	3	0	9	3	1083	0.00000	-0.00477	0.00000	0.00000	0.00000	1.0000000000	1.0000000000	0.02466	-0.03514	7	2	0	2	1	0	0.00000	0.00000
109	90560007	Gout	132	69896004	Rheumatoid arthritis	1095	4	3	0	4	3	1088	0.00000	-0.00317	0.00000	0.00000	0.00000	1.0000000000	1.0000000000	0.01096	-0.01572	0	2	0	4	1	0	0.00000	0.00000
108	40930008	Hypothyroidism (disorder)	132	69896004	Rheumatoid arthritis	1095	13	3	0	13	3	1079	0.00000	-0.00575	0.00000	0.00000	0.00000	1.0000000000	1.0000000000	0.03562	-0.05049	11	2	0	2	1	0	0.00000	0.00000
107	40275004	Contact dermatitis	132	69896004	Rheumatoid arthritis	1095	18	3	0	18	3	1074	0.00000	-0.00678	0.00000	0.00000	0.00000	1.0000000000	1.0000000000	0.04932	-0.06945	9	2	0	9	1	0	0.00000	0.00000
106	24079001	Atopic dermatitis	132	69896004	Rheumatoid arthritis	1095	20	3	0	20	3	1072	0.00000	-0.00715	0.00000	0.00000	0.00000	1.0000000000	1.0000000000	0.05479	-0.07696	13	2	0	7	1	0	0.00000	0.00000
105	363406005	Malignant tumor of colon	132	69896004	Rheumatoid arthritis	1095	6	3	0	6	3	1086	0.00000	-0.00389	0.00000	0.00000	0.00000	1.0000000000	1.0000000000	0.01644	-0.02352	4	2	0	2	1	0	0.00000	0.00000
104	367498001	Seasonal allergic rhinitis	132	69896004	Rheumatoid arthritis	1095	20	3	0	20	3	1072	0.00000	-0.00715	0.00000	0.00000	0.00000	1.0000000000	1.0000000000	0.05479	-0.07696	9	2	0	11	1	0	0.00000	0.00000
102	90781000119102	Microalbuminuria due to type 2 diabetes mellitus (disorder)	132	69896004	Rheumatoid arthritis	1095	6	3	0	6	3	1086	0.00000	-0.00389	0.00000	0.00000	0.00000	1.0000000000	1.0000000000	0.01644	-0.02352	3	2	0	3	1	0	0.00000	0.00000
101	433144002	Chronic kidney disease stage 3 (disorder)	132	69896004	Rheumatoid arthritis	1095	3	3	0	3	3	1089	0.00000	-0.00275	0.00000	0.00000	0.00000	1.0000000000	1.0000000000	0.00822	-0.01181	1	2	0	2	1	0	0.00000	0.00000
100	161622006	History of lower limb amputation (situation)	132	69896004	Rheumatoid arthritis	1095	1	3	0	1	3	1091	0.00000	-0.00158	0.00000	0.00000	0.00000	1.0000000000	1.0000000000	0.00274	-0.00395	0	2	0	1	1	0	0.00000	0.00000
99	30832001	Rupture of patellar tendon	132	69896004	Rheumatoid arthritis	1095	23	3	0	23	3	1069	0.00000	-0.00768	0.00000	0.00000	0.00000	1.0000000000	1.0000000000	0.06301	-0.08816	14	2	0	9	1	0	0.00000	0.00000
98	1551000119108	Nonproliferative diabetic retinopathy due to type 2 diabetes mellitus (disorder)	132	69896004	Rheumatoid arthritis	1095	12	3	0	12	3	1080	0.00000	-0.00552	0.00000	0.00000	0.00000	1.0000000000	1.0000000000	0.03288	-0.04667	7	2	0	5	1	0	0.00000	0.00000
97	403192003	Third degree burn	132	69896004	Rheumatoid arthritis	1095	8	3	0	8	3	1084	0.00000	-0.00450	0.00000	0.00000	0.00000	1.0000000000	1.0000000000	0.02192	-0.03128	3	2	0	5	1	0	0.00000	0.00000
96	283371005	Laceration of forearm	132	69896004	Rheumatoid arthritis	1095	75	3	0	75	3	1017	0.00000	-0.01421	0.00000	0.00000	0.00000	1.0000000000	1.0000000000	0.20548	-0.26961	39	2	0	36	1	0	0.00000	0.00000
95	84757009	Epilepsy	132	69896004	Rheumatoid arthritis	1095	30	3	0	30	3	1062	0.00000	-0.00880	0.00000	0.00000	0.00000	1.0000000000	1.0000000000	0.08219	-0.11396	13	2	0	17	1	0	0.00000	0.00000
94	703151001	History of single seizure (situation)	132	69896004	Rheumatoid arthritis	1095	39	3	0	39	3	1053	0.00000	-0.01007	0.00000	0.00000	0.00000	1.0000000000	1.0000000000	0.10685	-0.14646	14	2	0	25	1	0	0.00000	0.00000
93	128613002	Seizure disorder	132	69896004	Rheumatoid arthritis	1095	39	3	0	39	3	1053	0.00000	-0.01007	0.00000	0.00000	0.00000	1.0000000000	1.0000000000	0.10685	-0.14646	14	2	0	25	1	0	0.00000	0.00000
91	64859006	Osteoporosis (disorder)	132	69896004	Rheumatoid arthritis	1095	37	3	0	37	3	1055	0.00000	-0.00980	0.00000	0.00000	0.00000	1.0000000000	1.0000000000	0.10137	-0.13930	24	2	0	13	1	0	0.00000	0.00000
89	47693006	Rupture of appendix	132	69896004	Rheumatoid arthritis	1095	20	3	0	20	3	1072	0.00000	-0.00715	0.00000	0.00000	0.00000	1.0000000000	1.0000000000	0.05479	-0.07696	10	2	0	10	1	0	0.00000	0.00000
86	713197008	Recurrent rectal polyp	132	69896004	Rheumatoid arthritis	1095	22	3	1	21	2	1071	16.59091	0.11701	25.50000	292.26983	2.22483	0.0591240338	0.4713812612	0.06027	0.91556	12	2	1	10	1	0	1.09861	2.56495
85	241929008	Acute allergic reaction	132	69896004	Rheumatoid arthritis	1095	47	3	0	47	3	1045	0.00000	-0.01110	0.00000	0.00000	0.00000	1.0000000000	1.0000000000	0.12877	-0.17475	25	2	0	22	1	0	0.00000	0.00000
83	110030002	Concussion injury of brain	132	69896004	Rheumatoid arthritis	1095	7	3	0	7	3	1085	0.00000	-0.00420	0.00000	0.00000	0.00000	1.0000000000	1.0000000000	0.01918	-0.02741	1	2	0	6	1	0	0.00000	0.00000
82	94260004	Secondary malignant neoplasm of colon	132	69896004	Rheumatoid arthritis	1095	4	3	0	4	3	1088	0.00000	-0.00317	0.00000	0.00000	0.00000	1.0000000000	1.0000000000	0.01096	-0.01572	2	2	0	2	1	0	0.00000	0.00000
81	236077008	Protracted diarrhea	132	69896004	Rheumatoid arthritis	1095	4	3	0	4	3	1088	0.00000	-0.00317	0.00000	0.00000	0.00000	1.0000000000	1.0000000000	0.01096	-0.01572	2	2	0	2	1	0	0.00000	0.00000
80	6072007	Bleeding from anus	132	69896004	Rheumatoid arthritis	1095	4	3	0	4	3	1088	0.00000	-0.00317	0.00000	0.00000	0.00000	1.0000000000	1.0000000000	0.01096	-0.01572	2	2	0	2	1	0	0.00000	0.00000
79	45816000	Pyelonephritis	132	69896004	Rheumatoid arthritis	1095	1	3	0	1	3	1091	0.00000	-0.00158	0.00000	0.00000	0.00000	1.0000000000	1.0000000000	0.00274	-0.00395	1	2	0	0	1	0	0.00000	0.00000
78	239872002	Osteoarthritis of hip	132	69896004	Rheumatoid arthritis	1095	21	3	0	21	3	1071	0.00000	-0.00733	0.00000	0.00000	0.00000	1.0000000000	1.0000000000	0.05753	-0.08070	13	2	0	8	1	0	0.00000	0.00000
76	127013003	Diabetic renal disease (disorder)	132	69896004	Rheumatoid arthritis	1095	28	3	0	28	3	1064	0.00000	-0.00849	0.00000	0.00000	0.00000	1.0000000000	1.0000000000	0.07671	-0.10663	10	2	0	18	1	0	0.00000	0.00000
75	431855005	Chronic kidney disease stage 1 (disorder)	132	69896004	Rheumatoid arthritis	1095	28	3	0	28	3	1064	0.00000	-0.00849	0.00000	0.00000	0.00000	1.0000000000	1.0000000000	0.07671	-0.10663	10	2	0	18	1	0	0.00000	0.00000
73	196416002	Impacted molars	132	69896004	Rheumatoid arthritis	1095	49	3	0	49	3	1043	0.00000	-0.01134	0.00000	0.00000	0.00000	1.0000000000	1.0000000000	0.13425	-0.18173	25	2	0	24	1	0	0.00000	0.00000
72	35999006	Blighted ovum	132	69896004	Rheumatoid arthritis	1095	53	3	1	52	2	1040	6.88679	0.06959	10.00000	112.07259	0.89228	0.1384109226	0.7306035772	0.14521	0.80439	53	2	1	0	1	0	1.09861	3.98898
71	201834006	Localized  primary osteoarthritis of the hand	132	69896004	Rheumatoid arthritis	1095	28	3	0	28	3	1064	0.00000	-0.00849	0.00000	0.00000	0.00000	1.0000000000	1.0000000000	0.07671	-0.10663	19	2	0	9	1	0	0.00000	0.00000
70	87433001	Pulmonary emphysema (disorder)	132	69896004	Rheumatoid arthritis	1095	17	3	0	17	3	1075	0.00000	-0.00658	0.00000	0.00000	0.00000	1.0000000000	1.0000000000	0.04658	-0.06568	9	2	0	8	1	0	0.00000	0.00000
69	233604007	Pneumonia	132	69896004	Rheumatoid arthritis	1095	7	3	0	7	3	1085	0.00000	-0.00420	0.00000	0.00000	0.00000	1.0000000000	1.0000000000	0.01918	-0.02741	3	2	0	4	1	0	0.00000	0.00000
68	26929004	Alzheimer's disease (disorder)	132	69896004	Rheumatoid arthritis	1095	23	3	2	21	1	1071	31.73913	0.23600	102.00000	1169.07930	8.89931	0.0012509548	0.0293606447	0.06301	1.49680	15	2	1	8	1	1	0.40547	0.57536
67	403191005	Second degree burn	132	69896004	Rheumatoid arthritis	1095	49	3	0	49	3	1043	0.00000	-0.01134	0.00000	0.00000	0.00000	1.0000000000	1.0000000000	0.13425	-0.18173	23	2	0	26	1	0	0.00000	0.00000
65	239873007	Osteoarthritis of knee	132	69896004	Rheumatoid arthritis	1095	57	3	0	57	3	1035	0.00000	-0.01228	0.00000	0.00000	0.00000	1.0000000000	1.0000000000	0.15616	-0.20935	30	2	0	27	1	0	0.00000	0.00000
64	444448004	Injury of medial collateral ligament of knee	132	69896004	Rheumatoid arthritis	1095	32	3	0	32	3	1060	0.00000	-0.00909	0.00000	0.00000	0.00000	1.0000000000	1.0000000000	0.08767	-0.12124	17	2	0	15	1	0	0.00000	0.00000
63	68496003	Polyp of colon	132	69896004	Rheumatoid arthritis	1095	91	3	2	89	1	1003	8.02198	0.11081	22.53933	251.00898	2.02392	0.0193969776	0.2439350568	0.24932	1.26383	43	2	1	48	1	1	0.40547	-0.10763
62	185086009	Chronic obstructive bronchitis (disorder)	132	69896004	Rheumatoid arthritis	1095	6	3	0	6	3	1086	0.00000	-0.00389	0.00000	0.00000	0.00000	1.0000000000	1.0000000000	0.01644	-0.02352	4	2	0	2	1	0	0.00000	0.00000
60	301011002	Escherichia coli urinary tract infection	132	69896004	Rheumatoid arthritis	1095	92	3	1	91	2	1001	3.96739	0.04711	5.50000	61.23874	0.49397	0.2316640945	0.8919067638	0.25205	0.67570	85	2	1	7	1	0	1.09861	4.45435
59	262574004	Bullet wound	132	69896004	Rheumatoid arthritis	1095	20	3	0	20	3	1072	0.00000	-0.00715	0.00000	0.00000	0.00000	1.0000000000	1.0000000000	0.05479	-0.07696	9	2	0	11	1	0	0.00000	0.00000
58	239720000	Tear of meniscus of knee	132	69896004	Rheumatoid arthritis	1095	20	3	0	20	3	1072	0.00000	-0.00715	0.00000	0.00000	0.00000	1.0000000000	1.0000000000	0.05479	-0.07696	10	2	0	10	1	0	0.00000	0.00000
57	192127007	Child attention deficit disorder	132	69896004	Rheumatoid arthritis	1095	76	3	0	76	3	1016	0.00000	-0.01431	0.00000	0.00000	0.00000	1.0000000000	1.0000000000	0.20822	-0.27288	24	2	0	52	1	0	0.00000	0.00000
56	92691004	Carcinoma in situ of prostate (disorder)	132	69896004	Rheumatoid arthritis	1095	23	3	0	23	3	1069	0.00000	-0.00768	0.00000	0.00000	0.00000	1.0000000000	1.0000000000	0.06301	-0.08816	0	2	0	23	1	0	0.00000	0.00000
54	5602001	Opioid abuse (disorder)	132	69896004	Rheumatoid arthritis	1095	7	3	0	7	3	1085	0.00000	-0.00420	0.00000	0.00000	0.00000	1.0000000000	1.0000000000	0.01918	-0.02741	0	2	0	7	1	0	0.00000	0.00000
53	7200002	Alcoholism	132	69896004	Rheumatoid arthritis	1095	5	3	0	5	3	1087	0.00000	-0.00355	0.00000	0.00000	0.00000	1.0000000000	1.0000000000	0.01370	-0.01963	0	2	0	5	1	0	0.00000	0.00000
52	124171000119105	Chronic intractable migraine without aura	132	69896004	Rheumatoid arthritis	1095	51	3	0	51	3	1041	0.00000	-0.01158	0.00000	0.00000	0.00000	1.0000000000	1.0000000000	0.13973	-0.18869	21	2	0	30	1	0	0.00000	0.00000
50	446096008	Perennial allergic rhinitis	132	69896004	Rheumatoid arthritis	1095	26	3	0	26	3	1066	0.00000	-0.00817	0.00000	0.00000	0.00000	1.0000000000	1.0000000000	0.07123	-0.09927	14	2	0	12	1	0	0.00000	0.00000
49	88805009	Chronic congestive heart failure (disorder)	132	69896004	Rheumatoid arthritis	1095	10	3	0	10	3	1082	0.00000	-0.00503	0.00000	0.00000	0.00000	1.0000000000	1.0000000000	0.02740	-0.03899	5	2	0	5	1	0	0.00000	0.00000
47	359817006	Closed fracture of hip	132	69896004	Rheumatoid arthritis	1095	29	3	1	28	2	1064	12.58621	0.10016	19.00000	215.73474	1.67335	0.0774352913	0.5508322426	0.07945	0.88970	11	2	1	18	1	0	1.09861	2.48491
46	62564004	Concussion with loss of consciousness	132	69896004	Rheumatoid arthritis	1095	67	3	0	67	3	1025	0.00000	-0.01338	0.00000	0.00000	0.00000	1.0000000000	1.0000000000	0.18356	-0.24313	36	2	0	31	1	0	0.00000	0.00000
45	263102004	Fracture subluxation of wrist	132	69896004	Rheumatoid arthritis	1095	109	3	2	107	1	985	6.69725	0.09929	18.41121	204.73058	1.65570	0.0275568219	0.3058075632	0.29863	1.20797	51	2	1	58	1	1	0.40547	-0.12629
44	58150001	Fracture of clavicle	132	69896004	Rheumatoid arthritis	1095	112	3	0	112	3	980	0.00000	-0.01769	0.00000	0.00000	0.00000	1.0000000000	1.0000000000	0.30685	-0.38609	55	2	0	57	1	0	0.00000	0.00000
43	307731004	Injury of tendon of the rotator cuff of shoulder	132	69896004	Rheumatoid arthritis	1095	51	3	0	51	3	1041	0.00000	-0.01158	0.00000	0.00000	0.00000	1.0000000000	1.0000000000	0.13973	-0.18869	26	2	0	25	1	0	0.00000	0.00000
42	16114001	Fracture of ankle	132	69896004	Rheumatoid arthritis	1095	108	3	1	107	2	985	3.37963	0.04126	4.60280	51.18264	0.41393	0.2678860284	0.9388450812	0.29589	0.62606	48	2	0	60	1	1	-0.69315	-4.11087
41	283385000	Laceration of thigh	132	69896004	Rheumatoid arthritis	1095	105	3	1	104	2	988	3.47619	0.04227	4.75000	52.83068	0.42707	0.2611830889	0.9281913645	0.28767	0.63524	50	2	1	55	1	0	1.09861	3.93183
40	428251008	History of appendectomy	132	69896004	Rheumatoid arthritis	1095	51	3	0	51	3	1041	0.00000	-0.01158	0.00000	0.00000	0.00000	1.0000000000	1.0000000000	0.13973	-0.18869	27	2	0	24	1	0	0.00000	0.00000
39	74400008	Appendicitis	132	69896004	Rheumatoid arthritis	1095	51	3	0	51	3	1041	0.00000	-0.01158	0.00000	0.00000	0.00000	1.0000000000	1.0000000000	0.13973	-0.18869	27	2	0	24	1	0	0.00000	0.00000
38	398254007	Preeclampsia	132	69896004	Rheumatoid arthritis	1095	101	3	1	100	2	992	3.61386	0.04367	4.96000	55.18309	0.44582	0.2521823659	0.9133257124	0.27671	0.64757	101	2	1	0	1	0	1.09861	4.62497
37	38822007	Cystitis	132	69896004	Rheumatoid arthritis	1095	71	3	0	71	3	1021	0.00000	-0.01380	0.00000	0.00000	0.00000	1.0000000000	1.0000000000	0.19452	-0.25643	68	2	0	3	1	0	0.00000	0.00000
35	19169002	Miscarriage in first trimester	132	69896004	Rheumatoid arthritis	1095	174	3	2	172	1	920	4.19540	0.07280	10.69767	118.62895	0.96469	0.0674763922	0.5101371685	0.47671	1.02257	174	2	2	0	1	0	0.69315	4.47734
33	429007001	History of cardiac arrest (situation)	132	69896004	Rheumatoid arthritis	1095	42	3	1	41	2	1051	8.69048	0.08050	12.81707	144.23288	1.13897	0.1108086610	0.6563282226	0.11507	0.84287	24	2	1	18	1	0	1.09861	3.21888
32	410429000	Cardiac Arrest	132	69896004	Rheumatoid arthritis	1095	42	3	1	41	2	1051	8.69048	0.08050	12.81707	144.23288	1.13897	0.1108086610	0.6563282226	0.11507	0.84287	24	2	1	18	1	0	1.09861	3.21888
30	399211009	History of myocardial infarction (situation)	132	69896004	Rheumatoid arthritis	1095	31	3	0	31	3	1061	0.00000	-0.00895	0.00000	0.00000	0.00000	1.0000000000	1.0000000000	0.08493	-0.11760	2	2	0	29	1	0	0.00000	0.00000
29	22298006	Myocardial Infarction	132	69896004	Rheumatoid arthritis	1095	31	3	0	31	3	1061	0.00000	-0.00895	0.00000	0.00000	0.00000	1.0000000000	1.0000000000	0.08493	-0.11760	2	2	0	29	1	0	0.00000	0.00000
28	53741008	Coronary Heart Disease	132	69896004	Rheumatoid arthritis	1095	80	3	1	79	2	1013	4.56250	0.05242	6.41139	71.48080	0.57506	0.2037272758	0.8524167357	0.21918	0.71409	24	2	0	56	1	1	-0.69315	-4.04305
27	408512008	Body mass index 40+ - severely obese (finding)	132	69896004	Rheumatoid arthritis	1095	97	3	0	97	3	995	0.00000	-0.01634	0.00000	0.00000	0.00000	1.0000000000	1.0000000000	0.26575	-0.34000	67	2	0	30	1	0	0.00000	0.00000
26	33737001	Fracture of rib	132	69896004	Rheumatoid arthritis	1095	54	3	0	54	3	1038	0.00000	-0.01194	0.00000	0.00000	0.00000	1.0000000000	1.0000000000	0.14795	-0.19905	32	2	0	22	1	0	0.00000	0.00000
24	162864005	Body mass index 30+ - obesity (finding)	132	69896004	Rheumatoid arthritis	1095	439	3	1	438	2	654	0.83144	-0.00723	0.74658	8.25854	0.06749	1.0000000000	1.0000000000	1.20274	-0.13930	226	2	1	213	1	0	1.09861	5.42495
23	36971009	Sinusitis (disorder)	132	69896004	Rheumatoid arthritis	1095	190	3	0	190	3	902	0.00000	-0.02402	0.00000	0.00000	0.00000	1.0000000000	1.0000000000	0.52055	-0.60459	84	2	0	106	1	0	0.00000	0.00000
21	15777000	Prediabetes	132	69896004	Rheumatoid arthritis	1095	333	3	3	330	0	762	3.28829	0.07929	0.00000	0.00000	0.00000	0.0279485131	0.3078193827	0.91233	1.06467	159	2	2	174	1	1	0.00000	-0.77653
20	80394007	Hyperglycemia (disorder)	132	69896004	Rheumatoid arthritis	1095	55	3	0	55	3	1037	0.00000	-0.01205	0.00000	0.00000	0.00000	1.0000000000	1.0000000000	0.15068	-0.20249	23	2	0	32	1	0	0.00000	0.00000
19	237602007	Metabolic syndrome X (disorder)	132	69896004	Rheumatoid arthritis	1095	64	3	0	64	3	1028	0.00000	-0.01306	0.00000	0.00000	0.00000	1.0000000000	1.0000000000	0.17534	-0.23308	28	2	0	36	1	0	0.00000	0.00000
18	302870006	Hypertriglyceridemia (disorder)	132	69896004	Rheumatoid arthritis	1095	64	3	0	64	3	1028	0.00000	-0.01306	0.00000	0.00000	0.00000	1.0000000000	1.0000000000	0.17534	-0.23308	28	2	0	36	1	0	0.00000	0.00000
17	368581000119106	Neuropathy due to type 2 diabetes mellitus (disorder)	132	69896004	Rheumatoid arthritis	1095	28	3	0	28	3	1064	0.00000	-0.00849	0.00000	0.00000	0.00000	1.0000000000	1.0000000000	0.07671	-0.10663	7	2	0	21	1	0	0.00000	0.00000
129	47505003	Posttraumatic stress disorder	106	24079001	Atopic dermatitis	1095	4	20	0	4	20	1071	0.00000	-0.00826	0.00000	0.00000	0.00000	1.0000000000	1.0000000000	0.07306	-0.10173	1	13	0	3	7	0	0.00000	0.00000
15	40055000	Chronic sinusitis (disorder)	132	69896004	Rheumatoid arthritis	1095	216	3	0	216	3	876	0.00000	-0.02598	0.00000	0.00000	0.00000	1.0000000000	1.0000000000	0.59178	-0.67064	104	2	0	112	1	0	0.00000	0.00000
14	10509002	Acute bronchitis (disorder)	132	69896004	Rheumatoid arthritis	1095	863	3	3	860	0	232	1.26883	0.02718	0.00000	0.00000	0.00000	1.0000000000	1.0000000000	2.36438	0.24966	418	2	2	445	1	1	0.00000	-0.75321
13	370247008	Facial laceration	132	69896004	Rheumatoid arthritis	1095	109	3	2	107	1	985	6.69725	0.09929	18.41121	204.73058	1.65570	0.0275568219	0.3058075632	0.29863	1.20797	55	2	1	54	1	1	0.40547	0.01802
125	1734006	Fracture of the vertebral column with spinal cord injury	106	24079001	Atopic dermatitis	1095	5	20	0	5	20	1070	0.00000	-0.00924	0.00000	0.00000	0.00000	1.0000000000	1.0000000000	0.09132	-0.12608	3	13	0	2	7	0	0.00000	0.00000
10	62106007	Concussion with no loss of consciousness	132	69896004	Rheumatoid arthritis	1095	206	3	0	206	3	886	0.00000	-0.02523	0.00000	0.00000	0.00000	1.0000000000	1.0000000000	0.56438	-0.64559	96	2	0	110	1	0	0.00000	0.00000
9	44465007	Sprain of ankle	132	69896004	Rheumatoid arthritis	1095	362	3	3	359	0	733	3.02486	0.07458	0.00000	0.00000	0.00000	0.0359307821	0.3569070239	0.99178	1.00594	185	2	2	177	1	1	0.00000	-0.64382
8	233678006	Childhood asthma	132	69896004	Rheumatoid arthritis	1095	45	3	0	45	3	1047	0.00000	-0.01085	0.00000	0.00000	0.00000	1.0000000000	1.0000000000	0.12329	-0.16773	25	2	0	20	1	0	0.00000	0.00000
7	75498004	Acute bacterial sinusitis (disorder)	132	69896004	Rheumatoid arthritis	1095	187	3	0	187	3	905	0.00000	-0.02379	0.00000	0.00000	0.00000	1.0000000000	1.0000000000	0.51233	-0.59677	89	2	0	98	1	0	0.00000	0.00000
6	39848009	Whiplash injury to neck	132	69896004	Rheumatoid arthritis	1095	182	3	0	182	3	910	0.00000	-0.02340	0.00000	0.00000	0.00000	1.0000000000	1.0000000000	0.49863	-0.58364	92	2	0	90	1	0	0.00000	0.00000
5	284549007	Laceration of hand	132	69896004	Rheumatoid arthritis	1095	104	3	1	103	2	989	3.50962	0.04261	4.80097	53.40152	0.43162	0.2589397177	0.9238844079	0.28493	0.63831	54	2	1	50	1	0	1.09861	4.00733
4	195662009	Acute viral pharyngitis (disorder)	132	69896004	Rheumatoid arthritis	1095	890	3	2	888	1	204	0.82022	-0.01963	0.45946	5.09150	0.04146	0.4633969581	1.0000000000	2.43836	-0.19676	430	2	2	460	1	0	0.69315	5.37528
3	65363002	Otitis media	132	69896004	Rheumatoid arthritis	1095	580	3	0	580	3	512	0.00000	-0.05562	0.00000	0.00000	0.00000	0.1037136957	0.6331122908	1.58904	-1.37242	277	2	0	303	1	0	0.00000	0.00000
1	444814009	Viral sinusitis (disorder)	132	69896004	Rheumatoid arthritis	1095	993	3	3	990	0	102	1.10272	0.01680	0.00000	0.00000	0.00000	1.0000000000	1.0000000000	2.72055	0.10448	478	2	2	515	1	1	0.00000	-0.76547
109	90560007	Gout	106	24079001	Atopic dermatitis	1095	4	20	0	4	20	1071	0.00000	-0.00826	0.00000	0.00000	0.00000	1.0000000000	1.0000000000	0.07306	-0.10173	0	13	0	4	7	0	0.00000	0.00000
118	48333001	Burn injury(morphologic abnormality)	69	233604007	Pneumonia	1095	1	7	0	1	7	1087	0.00000	-0.00243	0.00000	0.00000	0.00000	1.0000000000	1.0000000000	0.00639	-0.00919	0	3	0	1	4	0	0.00000	0.00000
102	90781000119102	Microalbuminuria due to type 2 diabetes mellitus (disorder)	106	24079001	Atopic dermatitis	1095	6	20	0	6	20	1069	0.00000	-0.01012	0.00000	0.00000	0.00000	1.0000000000	1.0000000000	0.10959	-0.15003	3	13	0	3	7	0	0.00000	0.00000
98	1551000119108	Nonproliferative diabetic retinopathy due to type 2 diabetes mellitus (disorder)	106	24079001	Atopic dermatitis	1095	12	20	0	12	20	1063	0.00000	-0.01436	0.00000	0.00000	0.00000	1.0000000000	1.0000000000	0.21918	-0.28591	7	13	0	5	7	0	0.00000	0.00000
97	403192003	Third degree burn	106	24079001	Atopic dermatitis	1095	8	20	0	8	20	1067	0.00000	-0.01170	0.00000	0.00000	0.00000	1.0000000000	1.0000000000	0.14612	-0.19676	3	13	0	5	7	0	0.00000	0.00000
96	283371005	Laceration of forearm	106	24079001	Atopic dermatitis	1095	75	20	1	74	19	1001	0.73000	-0.00999	0.71195	5.39217	0.09400	1.0000000000	1.0000000000	1.36986	-0.24480	39	13	1	36	7	0	2.63906	3.68888
94	703151001	History of single seizure (situation)	106	24079001	Atopic dermatitis	1095	39	20	1	38	19	1037	1.40385	0.01059	1.43629	11.01035	0.18736	0.5189626562	1.0000000000	0.71233	0.22404	14	13	1	25	7	0	2.63906	2.70805
93	128613002	Seizure disorder	106	24079001	Atopic dermatitis	1095	39	20	1	38	19	1037	1.40385	0.01059	1.43629	11.01035	0.18736	0.5189626562	1.0000000000	0.71233	0.22404	14	13	1	25	7	0	2.63906	2.70805
89	47693006	Rupture of appendix	106	24079001	Atopic dermatitis	1095	20	20	1	19	19	1056	2.73750	0.03233	2.92521	22.98381	0.37230	0.3106053939	1.0000000000	0.36530	0.55079	10	13	0	10	7	1	-2.07944	-2.39790
86	713197008	Recurrent rectal polyp	106	24079001	Atopic dermatitis	1095	22	20	0	22	20	1053	0.00000	-0.01953	0.00000	0.00000	0.00000	1.0000000000	1.0000000000	0.40183	-0.48731	12	13	0	10	7	0	0.00000	0.00000
123	195967001	Asthma	103	157141000119108	Proteinuria due to type 2 diabetes mellitus (disorder)	1095	2	3	0	2	3	1090	0.00000	-0.00224	0.00000	0.00000	0.00000	1.0000000000	1.0000000000	0.00548	-0.00788	1	1	0	1	2	0	0.00000	0.00000
75	431855005	Chronic kidney disease stage 1 (disorder)	106	24079001	Atopic dermatitis	1095	28	20	0	28	20	1047	0.00000	-0.02210	0.00000	0.00000	0.00000	1.0000000000	1.0000000000	0.51142	-0.59590	10	13	0	18	7	0	0.00000	0.00000
72	35999006	Blighted ovum	106	24079001	Atopic dermatitis	1095	53	20	1	52	19	1023	1.03302	0.00102	1.03543	7.88455	0.13598	1.0000000000	1.0000000000	0.96804	0.02324	53	13	1	0	7	0	2.63906	3.98898
69	233604007	Pneumonia	106	24079001	Atopic dermatitis	1095	7	20	0	7	20	1068	0.00000	-0.01094	0.00000	0.00000	0.00000	1.0000000000	1.0000000000	0.12785	-0.17358	3	13	0	4	7	0	0.00000	0.00000
67	403191005	Second degree burn	106	24079001	Atopic dermatitis	1095	49	20	0	49	20	1026	0.00000	-0.02952	0.00000	0.00000	0.00000	1.0000000000	1.0000000000	0.89498	-0.92218	23	13	0	26	7	0	0.00000	0.00000
64	444448004	Injury of medial collateral ligament of knee	106	24079001	Atopic dermatitis	1095	32	20	1	31	19	1044	1.71094	0.01682	1.77250	13.66383	0.22993	0.4503494275	1.0000000000	0.58447	0.33600	17	13	0	15	7	1	-2.07944	-2.77259
63	68496003	Polyp of colon	106	24079001	Atopic dermatitis	1095	91	20	1	90	19	985	0.60165	-0.01636	0.57602	4.35283	0.07623	1.0000000000	1.0000000000	1.66210	-0.41257	43	13	1	48	7	0	2.63906	3.78419
58	239720000	Tear of meniscus of knee	106	24079001	Atopic dermatitis	1095	20	20	0	20	20	1055	0.00000	-0.01860	0.00000	0.00000	0.00000	1.0000000000	1.0000000000	0.36530	-0.44921	10	13	0	10	7	0	0.00000	0.00000
57	192127007	Child attention deficit disorder	106	24079001	Atopic dermatitis	1095	76	20	0	76	20	999	0.00000	-0.03725	0.00000	0.00000	0.00000	0.3907375943	1.0000000000	1.38813	-1.25588	24	13	0	52	7	0	0.00000	0.00000
54	5602001	Opioid abuse (disorder)	106	24079001	Atopic dermatitis	1095	7	20	0	7	20	1068	0.00000	-0.01094	0.00000	0.00000	0.00000	1.0000000000	1.0000000000	0.12785	-0.17358	0	13	0	7	7	0	0.00000	0.00000
50	446096008	Perennial allergic rhinitis	106	24079001	Atopic dermatitis	1095	26	20	3	23	17	1052	6.31731	0.11311	8.07161	29.47062	2.21071	0.0103699019	0.1588603827	0.47489	1.43940	14	13	2	12	7	1	-0.06454	-0.48551
49	88805009	Chronic congestive heart failure (disorder)	106	24079001	Atopic dermatitis	1095	10	20	0	10	20	1065	0.00000	-0.01309	0.00000	0.00000	0.00000	1.0000000000	1.0000000000	0.18265	-0.24202	5	13	0	5	7	0	0.00000	0.00000
47	359817006	Closed fracture of hip	106	24079001	Atopic dermatitis	1095	29	20	1	28	19	1047	1.88793	0.01998	1.96805	15.22059	0.25447	0.4181826721	1.0000000000	0.52968	0.38677	11	13	1	18	7	0	2.63906	2.48491
44	58150001	Fracture of clavicle	106	24079001	Atopic dermatitis	1095	112	20	0	112	20	963	0.00000	-0.04604	0.00000	0.00000	0.00000	0.2527230989	0.9133257124	2.04566	-1.60676	55	13	0	57	7	0	0.00000	0.00000
43	307731004	Injury of tendon of the rotator cuff of shoulder	106	24079001	Atopic dermatitis	1095	51	20	1	50	19	1025	1.07353	0.00222	1.07895	8.22193	0.14159	0.6180548828	1.0000000000	0.93151	0.05027	26	13	1	25	7	0	2.63906	3.29584
42	16114001	Fracture of ankle	106	24079001	Atopic dermatitis	1095	108	20	1	107	19	968	0.50694	-0.02225	0.47614	3.59210	0.06311	0.7122123271	1.0000000000	1.97260	-0.57173	48	13	1	60	7	0	2.63906	3.89182
41	283385000	Laceration of thigh	106	24079001	Atopic dermatitis	1095	105	20	2	103	18	972	1.04286	0.00190	1.04854	4.58287	0.23990	1.0000000000	1.0000000000	1.91781	0.04008	50	13	1	55	7	1	0.55962	-0.09353
39	74400008	Appendicitis	106	24079001	Atopic dermatitis	1095	51	20	1	50	19	1025	1.07353	0.00222	1.07895	8.22193	0.14159	0.6180548828	1.0000000000	0.93151	0.05027	27	13	0	24	7	1	-2.07944	-3.21888
38	398254007	Preeclampsia	106	24079001	Atopic dermatitis	1095	101	20	0	101	20	974	0.00000	-0.04348	0.00000	0.00000	0.00000	0.2463831547	0.9133257124	1.84475	-1.50830	101	13	0	0	7	0	0.00000	0.00000
35	19169002	Miscarriage in first trimester	106	24079001	Atopic dermatitis	1095	174	20	3	171	17	904	0.94397	-0.00332	0.93292	3.21806	0.27046	1.0000000000	1.0000000000	3.17808	-0.06284	174	13	3	0	7	0	1.67398	4.07754
33	429007001	History of cardiac arrest (situation)	106	24079001	Atopic dermatitis	1095	42	20	0	42	20	1033	0.00000	-0.02724	0.00000	0.00000	0.00000	1.0000000000	1.0000000000	0.76712	-0.82140	24	13	0	18	7	0	0.00000	0.00000
32	410429000	Cardiac Arrest	106	24079001	Atopic dermatitis	1095	42	20	0	42	20	1033	0.00000	-0.02724	0.00000	0.00000	0.00000	1.0000000000	1.0000000000	0.76712	-0.82140	24	13	0	18	7	0	0.00000	0.00000
30	399211009	History of myocardial infarction (situation)	106	24079001	Atopic dermatitis	1095	31	20	0	31	20	1044	0.00000	-0.02328	0.00000	0.00000	0.00000	1.0000000000	1.0000000000	0.56621	-0.64728	2	13	0	29	7	0	0.00000	0.00000
27	408512008	Body mass index 40+ - severely obese (finding)	106	24079001	Atopic dermatitis	1095	97	20	0	97	20	978	0.00000	-0.04252	0.00000	0.00000	0.00000	0.2468832020	0.9133257124	1.77169	-1.47077	67	13	0	30	7	0	0.00000	0.00000
24	162864005	Body mass index 30+ - obesity (finding)	106	24079001	Atopic dermatitis	1095	439	20	3	436	17	639	0.37415	-0.06983	0.25863	0.88786	0.07534	0.0211270143	0.2593847263	8.01826	-1.17285	226	13	2	213	7	1	-0.06454	-0.62978
23	36971009	Sinusitis (disorder)	106	24079001	Atopic dermatitis	1095	190	20	5	185	15	890	1.44079	0.02755	1.60360	4.46688	0.57569	0.3697725263	1.0000000000	3.47032	0.42458	84	13	3	106	7	2	0.16990	-0.62169
21	15777000	Prediabetes	106	24079001	Atopic dermatitis	1095	333	20	6	327	14	748	0.98649	-0.00122	0.98034	2.57358	0.37344	1.0000000000	1.0000000000	6.08219	-0.01684	159	13	4	174	7	2	-0.05716	-0.76988
20	80394007	Hyperglycemia (disorder)	106	24079001	Atopic dermatitis	1095	55	20	0	55	20	1020	0.00000	-0.03137	0.00000	0.00000	0.00000	0.6191825171	1.0000000000	1.00457	-1.00329	23	13	0	32	7	0	0.00000	0.00000
18	302870006	Hypertriglyceridemia (disorder)	106	24079001	Atopic dermatitis	1095	64	20	0	64	20	1011	0.00000	-0.03398	0.00000	0.00000	0.00000	0.6248676804	1.0000000000	1.16895	-1.11700	28	13	0	36	7	0	0.00000	0.00000
17	368581000119106	Neuropathy due to type 2 diabetes mellitus (disorder)	106	24079001	Atopic dermatitis	1095	28	20	0	28	20	1047	0.00000	-0.02210	0.00000	0.00000	0.00000	1.0000000000	1.0000000000	0.51142	-0.59590	7	13	0	21	7	0	0.00000	0.00000
129	47505003	Posttraumatic stress disorder	80	6072007	Bleeding from anus	1095	4	4	0	4	4	1087	0.00000	-0.00367	0.00000	0.00000	0.00000	1.0000000000	1.0000000000	0.01461	-0.02093	1	2	0	3	2	0	0.00000	0.00000
15	40055000	Chronic sinusitis (disorder)	106	24079001	Atopic dermatitis	1095	216	20	4	212	16	863	1.01389	0.00094	1.01769	3.07542	0.33676	1.0000000000	1.0000000000	3.94521	0.01590	104	13	3	112	7	1	-0.40547	-1.15317
14	10509002	Acute bronchitis (disorder)	106	24079001	Atopic dermatitis	1095	863	20	14	849	6	226	0.88818	-0.02942	0.62112	1.63448	0.23603	0.4041051779	1.0000000000	15.76256	-0.16028	418	13	8	445	7	6	0.19189	-0.34471
13	370247008	Facial laceration	106	24079001	Atopic dermatitis	1095	109	20	1	108	19	967	0.50229	-0.02257	0.47125	3.55487	0.06247	0.7121796267	1.0000000000	1.99087	-0.58056	55	13	0	54	7	1	-2.07944	-4.00733
125	1734006	Fracture of the vertebral column with spinal cord injury	80	6072007	Bleeding from anus	1095	5	4	0	5	4	1086	0.00000	-0.00410	0.00000	0.00000	0.00000	1.0000000000	1.0000000000	0.01826	-0.02611	3	2	0	2	2	0	0.00000	0.00000
124	1501000119109	Proliferative diabetic retinopathy due to type II diabetes mellitus (disorder)	80	6072007	Bleeding from anus	1095	1	4	0	1	4	1090	0.00000	-0.00183	0.00000	0.00000	0.00000	1.0000000000	1.0000000000	0.00365	-0.00526	1	2	0	0	2	0	0.00000	0.00000
10	62106007	Concussion with no loss of consciousness	106	24079001	Atopic dermatitis	1095	206	20	4	202	16	873	1.06311	0.00414	1.08045	3.26632	0.35739	0.7791189838	1.0000000000	3.76256	0.07019	96	13	3	110	7	1	-0.40547	-1.21302
7	75498004	Acute bacterial sinusitis (disorder)	106	24079001	Atopic dermatitis	1095	187	20	3	184	17	891	0.87834	-0.00753	0.85454	2.94587	0.24789	1.0000000000	1.0000000000	3.41553	-0.14259	89	13	3	98	7	0	1.67398	3.42318
6	39848009	Whiplash injury to neck	106	24079001	Atopic dermatitis	1095	182	20	1	181	19	894	0.30082	-0.04258	0.25996	1.95421	0.03458	0.2279514360	0.8865563602	3.32420	-1.11243	92	13	1	90	7	0	2.63906	4.53260
5	284549007	Laceration of hand	106	24079001	Atopic dermatitis	1095	104	20	1	103	19	972	0.52644	-0.02092	0.49668	3.74829	0.06581	0.7129039389	1.0000000000	1.89954	-0.53583	54	13	1	50	7	0	2.63906	4.00733
117	230265002	Familial Alzheimer's disease of early onset (disorder)	80	6072007	Bleeding from anus	1095	6	4	0	6	4	1085	0.00000	-0.00449	0.00000	0.00000	0.00000	1.0000000000	1.0000000000	0.02192	-0.03128	2	2	0	4	2	0	0.00000	0.00000
115	36923009	Major depression  single episode	80	6072007	Bleeding from anus	1095	6	4	0	6	4	1085	0.00000	-0.00449	0.00000	0.00000	0.00000	1.0000000000	1.0000000000	0.02192	-0.03128	3	2	0	3	2	0	0.00000	0.00000
114	449868002	Smokes tobacco daily	80	6072007	Bleeding from anus	1095	9	4	0	9	4	1082	0.00000	-0.00551	0.00000	0.00000	0.00000	1.0000000000	1.0000000000	0.03288	-0.04667	2	2	0	7	2	0	0.00000	0.00000
111	235919008	Cholelithiasis	80	6072007	Bleeding from anus	1095	9	4	0	9	4	1082	0.00000	-0.00551	0.00000	0.00000	0.00000	1.0000000000	1.0000000000	0.03288	-0.04667	7	2	0	2	2	0	0.00000	0.00000
124	1501000119109	Proliferative diabetic retinopathy due to type II diabetes mellitus (disorder)	22	70704007	Sprain of wrist	1095	1	195	0	1	195	899	0.00000	-0.01407	0.00000	0.00000	0.00000	1.0000000000	1.0000000000	0.17808	-0.23644	1	90	0	0	105	0	0.00000	0.00000
109	90560007	Gout	80	6072007	Bleeding from anus	1095	4	4	0	4	4	1087	0.00000	-0.00367	0.00000	0.00000	0.00000	1.0000000000	1.0000000000	0.01461	-0.02093	0	2	0	4	2	0	0.00000	0.00000
108	40930008	Hypothyroidism (disorder)	80	6072007	Bleeding from anus	1095	13	4	0	13	4	1078	0.00000	-0.00664	0.00000	0.00000	0.00000	1.0000000000	1.0000000000	0.04749	-0.06693	11	2	0	2	2	0	0.00000	0.00000
107	40275004	Contact dermatitis	80	6072007	Bleeding from anus	1095	18	4	0	18	4	1073	0.00000	-0.00783	0.00000	0.00000	0.00000	1.0000000000	1.0000000000	0.06575	-0.09187	9	2	0	9	2	0	0.00000	0.00000
106	24079001	Atopic dermatitis	80	6072007	Bleeding from anus	1095	20	4	0	20	4	1071	0.00000	-0.00826	0.00000	0.00000	0.00000	1.0000000000	1.0000000000	0.07306	-0.10173	13	2	0	7	2	0	0.00000	0.00000
105	363406005	Malignant tumor of colon	80	6072007	Bleeding from anus	1095	6	4	0	6	4	1085	0.00000	-0.00449	0.00000	0.00000	0.00000	1.0000000000	1.0000000000	0.02192	-0.03128	4	2	0	2	2	0	0.00000	0.00000
102	90781000119102	Microalbuminuria due to type 2 diabetes mellitus (disorder)	80	6072007	Bleeding from anus	1095	6	4	0	6	4	1085	0.00000	-0.00449	0.00000	0.00000	0.00000	1.0000000000	1.0000000000	0.02192	-0.03128	3	2	0	3	2	0	0.00000	0.00000
101	433144002	Chronic kidney disease stage 3 (disorder)	80	6072007	Bleeding from anus	1095	3	4	0	3	4	1088	0.00000	-0.00317	0.00000	0.00000	0.00000	1.0000000000	1.0000000000	0.01096	-0.01572	1	2	0	2	2	0	0.00000	0.00000
100	161622006	History of lower limb amputation (situation)	80	6072007	Bleeding from anus	1095	1	4	0	1	4	1090	0.00000	-0.00183	0.00000	0.00000	0.00000	1.0000000000	1.0000000000	0.00365	-0.00526	0	2	0	1	2	0	0.00000	0.00000
98	1551000119108	Nonproliferative diabetic retinopathy due to type 2 diabetes mellitus (disorder)	80	6072007	Bleeding from anus	1095	12	4	1	11	3	1080	22.81250	0.13903	32.72727	339.68704	3.15312	0.0431785002	0.3985498161	0.04384	0.93811	7	2	0	5	2	1	-1.09861	-1.79176
97	403192003	Third degree burn	80	6072007	Bleeding from anus	1095	8	4	0	8	4	1083	0.00000	-0.00519	0.00000	0.00000	0.00000	1.0000000000	1.0000000000	0.02922	-0.04156	3	2	0	5	2	0	0.00000	0.00000
96	283371005	Laceration of forearm	80	6072007	Bleeding from anus	1095	75	4	0	75	4	1016	0.00000	-0.01642	0.00000	0.00000	0.00000	1.0000000000	1.0000000000	0.27397	-0.34933	39	2	0	36	2	0	0.00000	0.00000
94	703151001	History of single seizure (situation)	80	6072007	Bleeding from anus	1095	39	4	0	39	4	1052	0.00000	-0.01164	0.00000	0.00000	0.00000	1.0000000000	1.0000000000	0.14247	-0.19215	14	2	0	25	2	0	0.00000	0.00000
93	128613002	Seizure disorder	80	6072007	Bleeding from anus	1095	39	4	0	39	4	1052	0.00000	-0.01164	0.00000	0.00000	0.00000	1.0000000000	1.0000000000	0.14247	-0.19215	14	2	0	25	2	0	0.00000	0.00000
89	47693006	Rupture of appendix	80	6072007	Bleeding from anus	1095	20	4	0	20	4	1071	0.00000	-0.00826	0.00000	0.00000	0.00000	1.0000000000	1.0000000000	0.07306	-0.10173	10	2	0	10	2	0	0.00000	0.00000
86	713197008	Recurrent rectal polyp	80	6072007	Bleeding from anus	1095	22	4	0	22	4	1069	0.00000	-0.00867	0.00000	0.00000	0.00000	1.0000000000	1.0000000000	0.08037	-0.11152	12	2	0	10	2	0	0.00000	0.00000
82	94260004	Secondary malignant neoplasm of colon	80	6072007	Bleeding from anus	1095	4	4	4	0	0	1091	273.75000	1.00000	0.00000	0.00000	0.00000	0.0000000000	0.0000000015	0.01461	2.30100	2	2	2	2	2	2	0.00000	0.00000
78	239872002	Osteoarthritis of hip	80	6072007	Bleeding from anus	1095	21	4	0	21	4	1070	0.00000	-0.00847	0.00000	0.00000	0.00000	1.0000000000	1.0000000000	0.07671	-0.10663	13	2	0	8	2	0	0.00000	0.00000
76	127013003	Diabetic renal disease (disorder)	80	6072007	Bleeding from anus	1095	28	4	1	27	3	1064	9.77679	0.08609	13.13580	130.38871	1.32335	0.0985562783	0.6237397336	0.10228	0.85951	10	2	0	18	2	1	-1.09861	-2.94444
75	431855005	Chronic kidney disease stage 1 (disorder)	80	6072007	Bleeding from anus	1095	28	4	1	27	3	1064	9.77679	0.08609	13.13580	130.38871	1.32335	0.0985562783	0.6237397336	0.10228	0.85951	10	2	0	18	2	1	-1.09861	-2.94444
73	196416002	Impacted molars	80	6072007	Bleeding from anus	1095	49	4	0	49	4	1042	0.00000	-0.01311	0.00000	0.00000	0.00000	1.0000000000	1.0000000000	0.17900	-0.23756	25	2	0	24	2	0	0.00000	0.00000
72	35999006	Blighted ovum	80	6072007	Bleeding from anus	1095	53	4	1	52	3	1039	5.16509	0.05688	6.66026	65.13132	0.68107	0.1802279749	0.8113031609	0.19361	0.74467	53	2	1	0	2	0	1.09861	3.98898
71	201834006	Localized  primary osteoarthritis of the hand	80	6072007	Bleeding from anus	1095	28	4	0	28	4	1063	0.00000	-0.00981	0.00000	0.00000	0.00000	1.0000000000	1.0000000000	0.10228	-0.14049	19	2	0	9	2	0	0.00000	0.00000
70	87433001	Pulmonary emphysema (disorder)	80	6072007	Bleeding from anus	1095	17	4	0	17	4	1074	0.00000	-0.00760	0.00000	0.00000	0.00000	1.0000000000	1.0000000000	0.06210	-0.08692	9	2	0	8	2	0	0.00000	0.00000
69	233604007	Pneumonia	80	6072007	Bleeding from anus	1095	7	4	0	7	4	1084	0.00000	-0.00486	0.00000	0.00000	0.00000	1.0000000000	1.0000000000	0.02557	-0.03643	3	2	0	4	2	0	0.00000	0.00000
68	26929004	Alzheimer's disease (disorder)	80	6072007	Bleeding from anus	1095	23	4	0	23	4	1068	0.00000	-0.00887	0.00000	0.00000	0.00000	1.0000000000	1.0000000000	0.08402	-0.11639	15	2	0	8	2	0	0.00000	0.00000
67	403191005	Second degree burn	80	6072007	Bleeding from anus	1095	49	4	1	48	3	1043	5.58673	0.06011	7.24306	70.92601	0.73967	0.1675492660	0.7942848378	0.17900	0.76244	23	2	0	26	2	1	-1.09861	-3.29584
65	239873007	Osteoarthritis of knee	80	6072007	Bleeding from anus	1095	57	4	2	55	2	1036	9.60526	0.12210	18.83636	136.24169	2.60426	0.0149348054	0.2058049008	0.20822	1.31208	30	2	1	27	2	1	0.00000	0.10178
64	444448004	Injury of medial collateral ligament of knee	80	6072007	Bleeding from anus	1095	32	4	0	32	4	1059	0.00000	-0.01051	0.00000	0.00000	0.00000	1.0000000000	1.0000000000	0.11689	-0.15949	17	2	0	15	2	0	0.00000	0.00000
63	68496003	Polyp of colon	80	6072007	Bleeding from anus	1095	91	4	0	91	4	1000	0.00000	-0.01823	0.00000	0.00000	0.00000	1.0000000000	1.0000000000	0.33242	-0.41405	43	2	0	48	2	0	0.00000	0.00000
59	262574004	Bullet wound	80	6072007	Bleeding from anus	1095	20	4	0	20	4	1071	0.00000	-0.00826	0.00000	0.00000	0.00000	1.0000000000	1.0000000000	0.07306	-0.10173	9	2	0	11	2	0	0.00000	0.00000
58	239720000	Tear of meniscus of knee	80	6072007	Bleeding from anus	1095	20	4	0	20	4	1071	0.00000	-0.00826	0.00000	0.00000	0.00000	1.0000000000	1.0000000000	0.07306	-0.10173	10	2	0	10	2	0	0.00000	0.00000
57	192127007	Child attention deficit disorder	80	6072007	Bleeding from anus	1095	76	4	1	75	3	1016	3.60197	0.04303	4.51556	43.93983	0.46405	0.2503433784	0.9133257124	0.27763	0.64653	24	2	0	52	2	1	-1.09861	-3.97029
56	92691004	Carcinoma in situ of prostate (disorder)	80	6072007	Bleeding from anus	1095	23	4	1	22	3	1069	11.90217	0.09669	16.19697	161.90868	1.62031	0.0815162066	0.5629813232	0.08402	0.88361	0	2	0	23	2	1	-1.09861	-3.17805
54	5602001	Opioid abuse (disorder)	80	6072007	Bleeding from anus	1095	7	4	0	7	4	1084	0.00000	-0.00486	0.00000	0.00000	0.00000	1.0000000000	1.0000000000	0.02557	-0.03643	0	2	0	7	2	0	0.00000	0.00000
52	124171000119105	Chronic intractable migraine without aura	80	6072007	Bleeding from anus	1095	51	4	1	50	3	1041	5.36765	0.05845	6.94000	67.91084	0.70922	0.1739068632	0.7996618359	0.18630	0.75353	21	2	0	30	2	1	-1.09861	-3.43399
50	446096008	Perennial allergic rhinitis	80	6072007	Bleeding from anus	1095	26	4	0	26	4	1065	0.00000	-0.00944	0.00000	0.00000	0.00000	1.0000000000	1.0000000000	0.09498	-0.13090	14	2	0	12	2	0	0.00000	0.00000
49	88805009	Chronic congestive heart failure (disorder)	80	6072007	Bleeding from anus	1095	10	4	0	10	4	1081	0.00000	-0.00581	0.00000	0.00000	0.00000	1.0000000000	1.0000000000	0.03653	-0.05176	5	2	0	5	2	0	0.00000	0.00000
47	359817006	Closed fracture of hip	80	6072007	Bleeding from anus	1095	29	4	0	29	4	1062	0.00000	-0.00999	0.00000	0.00000	0.00000	1.0000000000	1.0000000000	0.10594	-0.14527	11	2	0	18	2	0	0.00000	0.00000
45	263102004	Fracture subluxation of wrist	80	6072007	Bleeding from anus	1095	109	4	0	109	4	982	0.00000	-0.02013	0.00000	0.00000	0.00000	1.0000000000	1.0000000000	0.39817	-0.48354	51	2	0	58	2	0	0.00000	0.00000
44	58150001	Fracture of clavicle	80	6072007	Bleeding from anus	1095	112	4	0	112	4	979	0.00000	-0.02044	0.00000	0.00000	0.00000	1.0000000000	1.0000000000	0.40913	-0.49481	55	2	0	57	2	0	0.00000	0.00000
43	307731004	Injury of tendon of the rotator cuff of shoulder	80	6072007	Bleeding from anus	1095	51	4	1	50	3	1041	5.36765	0.05845	6.94000	67.91084	0.70922	0.1739068632	0.7996618359	0.18630	0.75353	26	2	1	25	2	0	1.09861	3.29584
42	16114001	Fracture of ankle	80	6072007	Bleeding from anus	1095	108	4	1	107	3	984	2.53472	0.03074	3.06542	29.72939	0.31608	0.3402929047	1.0000000000	0.39452	0.52023	48	2	1	60	2	0	1.09861	3.89182
41	283385000	Laceration of thigh	80	6072007	Bleeding from anus	1095	105	4	0	105	4	986	0.00000	-0.01972	0.00000	0.00000	0.00000	1.0000000000	1.0000000000	0.38356	-0.46839	50	2	0	55	2	0	0.00000	0.00000
39	74400008	Appendicitis	80	6072007	Bleeding from anus	1095	51	4	0	51	4	1040	0.00000	-0.01338	0.00000	0.00000	0.00000	1.0000000000	1.0000000000	0.18630	-0.24647	27	2	0	24	2	0	0.00000	0.00000
38	398254007	Preeclampsia	80	6072007	Bleeding from anus	1095	101	4	0	101	4	990	0.00000	-0.01930	0.00000	0.00000	0.00000	1.0000000000	1.0000000000	0.36895	-0.45307	101	2	0	0	2	0	0.00000	0.00000
35	19169002	Miscarriage in first trimester	80	6072007	Bleeding from anus	1095	174	4	2	172	2	919	3.14655	0.05649	5.34302	38.18758	0.74757	0.1209931534	0.6887664724	0.63562	0.87513	174	2	2	0	2	0	0.69315	4.47734
33	429007001	History of cardiac arrest (situation)	80	6072007	Bleeding from anus	1095	42	4	0	42	4	1049	0.00000	-0.01209	0.00000	0.00000	0.00000	1.0000000000	1.0000000000	0.15342	-0.20592	24	2	0	18	2	0	0.00000	0.00000
32	410429000	Cardiac Arrest	80	6072007	Bleeding from anus	1095	42	4	0	42	4	1049	0.00000	-0.01209	0.00000	0.00000	0.00000	1.0000000000	1.0000000000	0.15342	-0.20592	24	2	0	18	2	0	0.00000	0.00000
30	399211009	History of myocardial infarction (situation)	80	6072007	Bleeding from anus	1095	31	4	0	31	4	1060	0.00000	-0.01034	0.00000	0.00000	0.00000	1.0000000000	1.0000000000	0.11324	-0.15477	2	2	0	29	2	0	0.00000	0.00000
29	22298006	Myocardial Infarction	80	6072007	Bleeding from anus	1095	31	4	0	31	4	1060	0.00000	-0.01034	0.00000	0.00000	0.00000	1.0000000000	1.0000000000	0.11324	-0.15477	2	2	0	29	2	0	0.00000	0.00000
27	408512008	Body mass index 40+ - severely obese (finding)	80	6072007	Bleeding from anus	1095	97	4	0	97	4	994	0.00000	-0.01888	0.00000	0.00000	0.00000	1.0000000000	1.0000000000	0.35434	-0.43759	67	2	0	30	2	0	0.00000	0.00000
24	162864005	Body mass index 30+ - obesity (finding)	80	6072007	Bleeding from anus	1095	439	4	4	435	0	656	2.49431	0.07402	0.00000	0.00000	0.00000	0.0256231380	0.2905941929	1.60365	0.94139	226	2	2	213	2	2	0.00000	0.05871
23	36971009	Sinusitis (disorder)	80	6072007	Bleeding from anus	1095	190	4	0	190	4	901	0.00000	-0.02774	0.00000	0.00000	0.00000	1.0000000000	1.0000000000	0.69406	-0.76049	84	2	0	106	2	0	0.00000	0.00000
21	15777000	Prediabetes	80	6072007	Bleeding from anus	1095	333	4	1	332	3	759	0.82207	-0.00712	0.76205	7.35294	0.07898	1.0000000000	1.0000000000	1.21644	-0.14824	159	2	1	174	2	0	1.09861	5.07517
20	80394007	Hyperglycemia (disorder)	80	6072007	Bleeding from anus	1095	55	4	1	54	3	1037	4.97727	0.05538	6.40123	62.56087	0.65497	0.1865127411	0.8181443419	0.20091	0.73587	23	2	0	32	2	1	-1.09861	-3.49651
19	237602007	Metabolic syndrome X (disorder)	80	6072007	Bleeding from anus	1095	64	4	1	63	3	1028	4.27734	0.04944	5.43915	53.04017	0.55777	0.2143481492	0.8672161313	0.23379	0.69690	28	2	0	36	2	1	-1.09861	-3.61092
18	302870006	Hypertriglyceridemia (disorder)	80	6072007	Bleeding from anus	1095	64	4	1	63	3	1028	4.27734	0.04944	5.43915	53.04017	0.55777	0.2143481492	0.8672161313	0.23379	0.69690	28	2	0	36	2	1	-1.09861	-3.61092
17	368581000119106	Neuropathy due to type 2 diabetes mellitus (disorder)	80	6072007	Bleeding from anus	1095	28	4	0	28	4	1063	0.00000	-0.00981	0.00000	0.00000	0.00000	1.0000000000	1.0000000000	0.10228	-0.14049	7	2	0	21	2	0	0.00000	0.00000
129	47505003	Posttraumatic stress disorder	54	5602001	Opioid abuse (disorder)	1095	4	7	1	3	6	1085	39.10714	0.18508	60.27778	665.24780	5.46174	0.0253610543	0.2905941929	0.02557	0.96357	1	0	0	3	7	1	-2.07944	-1.38629
15	40055000	Chronic sinusitis (disorder)	80	6072007	Bleeding from anus	1095	216	4	2	214	2	877	2.53472	0.04607	4.09813	29.25896	0.57400	0.1763210047	0.8029498763	0.78904	0.74578	104	2	1	112	2	1	0.00000	-0.07343
14	10509002	Acute bronchitis (disorder)	80	6072007	Bleeding from anus	1095	863	4	4	859	0	232	1.26883	0.03139	0.00000	0.00000	0.00000	0.5842857155	1.0000000000	3.15251	0.26794	418	2	2	445	2	2	0.00000	-0.06230
13	370247008	Facial laceration	80	6072007	Bleeding from anus	1095	109	4	0	109	4	982	0.00000	-0.02013	0.00000	0.00000	0.00000	1.0000000000	1.0000000000	0.39817	-0.48354	55	2	0	54	2	0	0.00000	0.00000
125	1734006	Fracture of the vertebral column with spinal cord injury	54	5602001	Opioid abuse (disorder)	1095	5	7	0	5	7	1083	0.00000	-0.00543	0.00000	0.00000	0.00000	1.0000000000	1.0000000000	0.03196	-0.04539	3	0	0	2	7	0	0.00000	0.00000
10	62106007	Concussion with no loss of consciousness	80	6072007	Bleeding from anus	1095	206	4	3	203	1	888	3.98665	0.08705	13.12315	126.80911	1.35808	0.0226490157	0.2721606699	0.75251	1.19058	96	2	1	110	2	2	0.40547	0.54936
8	233678006	Childhood asthma	80	6072007	Bleeding from anus	1095	45	4	0	45	4	1046	0.00000	-0.01254	0.00000	0.00000	0.00000	1.0000000000	1.0000000000	0.16438	-0.21957	25	2	0	20	2	0	0.00000	0.00000
7	75498004	Acute bacterial sinusitis (disorder)	80	6072007	Bleeding from anus	1095	187	4	2	185	2	906	2.92781	0.05297	4.89730	34.98846	0.68547	0.1373791614	0.7296699408	0.68311	0.83384	89	2	1	98	2	1	0.00000	-0.09531
6	39848009	Whiplash injury to neck	80	6072007	Bleeding from anus	1095	182	4	1	181	3	910	1.50412	0.01363	1.67587	16.20183	0.17335	0.5172179176	1.0000000000	0.66484	0.26462	92	2	1	90	2	0	1.09861	4.53260
5	284549007	Laceration of hand	80	6072007	Bleeding from anus	1095	104	4	1	103	3	988	2.63221	0.03202	3.19741	31.01888	0.32959	0.3295168874	1.0000000000	0.37991	0.53543	54	2	1	50	2	0	1.09861	4.00733
117	230265002	Familial Alzheimer's disease of early onset (disorder)	54	5602001	Opioid abuse (disorder)	1095	6	7	0	6	7	1082	0.00000	-0.00595	0.00000	0.00000	0.00000	1.0000000000	1.0000000000	0.03836	-0.05430	2	0	0	4	7	0	0.00000	0.00000
1	444814009	Viral sinusitis (disorder)	80	6072007	Bleeding from anus	1095	993	4	4	989	0	102	1.10272	0.01941	0.00000	0.00000	0.00000	1.0000000000	1.0000000000	3.62740	0.11173	478	2	2	515	2	2	0.00000	-0.07426
109	90560007	Gout	54	5602001	Opioid abuse (disorder)	1095	4	7	0	4	7	1084	0.00000	-0.00486	0.00000	0.00000	0.00000	1.0000000000	1.0000000000	0.02557	-0.03643	0	0	0	4	7	0	0.00000	0.00000
102	90781000119102	Microalbuminuria due to type 2 diabetes mellitus (disorder)	54	5602001	Opioid abuse (disorder)	1095	6	7	0	6	7	1082	0.00000	-0.00595	0.00000	0.00000	0.00000	1.0000000000	1.0000000000	0.03836	-0.05430	3	0	0	3	7	0	0.00000	0.00000
98	1551000119108	Nonproliferative diabetic retinopathy due to type 2 diabetes mellitus (disorder)	54	5602001	Opioid abuse (disorder)	1095	12	7	0	12	7	1076	0.00000	-0.00844	0.00000	0.00000	0.00000	1.0000000000	1.0000000000	0.07671	-0.10663	7	0	0	5	7	0	0.00000	0.00000
97	403192003	Third degree burn	54	5602001	Opioid abuse (disorder)	1095	8	7	0	8	7	1080	0.00000	-0.00688	0.00000	0.00000	0.00000	1.0000000000	1.0000000000	0.05114	-0.07196	3	0	0	5	7	0	0.00000	0.00000
96	283371005	Laceration of forearm	54	5602001	Opioid abuse (disorder)	1095	75	7	0	75	7	1013	0.00000	-0.02175	0.00000	0.00000	0.00000	1.0000000000	1.0000000000	0.47945	-0.56506	39	0	0	36	7	0	0.00000	0.00000
94	703151001	History of single seizure (situation)	54	5602001	Opioid abuse (disorder)	1095	39	7	0	39	7	1049	0.00000	-0.01541	0.00000	0.00000	0.00000	1.0000000000	1.0000000000	0.24932	-0.32114	14	0	0	25	7	0	0.00000	0.00000
93	128613002	Seizure disorder	54	5602001	Opioid abuse (disorder)	1095	39	7	0	39	7	1049	0.00000	-0.01541	0.00000	0.00000	0.00000	1.0000000000	1.0000000000	0.24932	-0.32114	14	0	0	25	7	0	0.00000	0.00000
89	47693006	Rupture of appendix	54	5602001	Opioid abuse (disorder)	1095	20	7	0	20	7	1068	0.00000	-0.01094	0.00000	0.00000	0.00000	1.0000000000	1.0000000000	0.12785	-0.17358	10	0	0	10	7	0	0.00000	0.00000
86	713197008	Recurrent rectal polyp	54	5602001	Opioid abuse (disorder)	1095	22	7	0	22	7	1066	0.00000	-0.01149	0.00000	0.00000	0.00000	1.0000000000	1.0000000000	0.14064	-0.18984	12	0	0	10	7	0	0.00000	0.00000
75	431855005	Chronic kidney disease stage 1 (disorder)	54	5602001	Opioid abuse (disorder)	1095	28	7	1	27	6	1061	5.58673	0.05960	6.54938	56.29236	0.76199	0.1662561273	0.7915572889	0.17900	0.76244	10	0	0	18	7	1	-2.07944	-2.94444
118	48333001	Burn injury(morphologic abnormality)	53	7200002	Alcoholism	1095	1	5	0	1	5	1089	0.00000	-0.00205	0.00000	0.00000	0.00000	1.0000000000	1.0000000000	0.00457	-0.00657	0	0	0	1	5	0	0.00000	0.00000
72	35999006	Blighted ovum	54	5602001	Opioid abuse (disorder)	1095	53	7	0	53	7	1035	0.00000	-0.01809	0.00000	0.00000	0.00000	1.0000000000	1.0000000000	0.33881	-0.42095	53	0	0	0	7	0	0.00000	0.00000
120	162573006	Suspected lung cancer (situation)	53	7200002	Alcoholism	1095	8	5	1	7	4	1083	27.37500	0.15325	38.67857	391.18956	3.82431	0.0360647676	0.3569070239	0.03653	0.94824	0	0	0	8	5	1	-1.79176	-2.19722
121	254637007	Non-small cell lung cancer (disorder)	53	7200002	Alcoholism	1095	8	5	1	7	4	1083	27.37500	0.15325	38.67857	391.18956	3.82431	0.0360647676	0.3569070239	0.03653	0.94824	0	0	0	8	5	1	-1.79176	-2.19722
69	233604007	Pneumonia	54	5602001	Opioid abuse (disorder)	1095	7	7	0	7	7	1081	0.00000	-0.00643	0.00000	0.00000	0.00000	1.0000000000	1.0000000000	0.04475	-0.06316	3	0	0	4	7	0	0.00000	0.00000
67	403191005	Second degree burn	54	5602001	Opioid abuse (disorder)	1095	49	7	0	49	7	1039	0.00000	-0.01736	0.00000	0.00000	0.00000	1.0000000000	1.0000000000	0.31324	-0.39313	23	0	0	26	7	0	0.00000	0.00000
64	444448004	Injury of medial collateral ligament of knee	54	5602001	Opioid abuse (disorder)	1095	32	7	1	31	6	1057	4.88839	0.05411	5.68280	48.63597	0.66400	0.1879509254	0.8187757931	0.20457	0.73149	17	0	0	15	7	1	-2.07944	-2.77259
63	68496003	Polyp of colon	54	5602001	Opioid abuse (disorder)	1095	91	7	0	91	7	997	0.00000	-0.02415	0.00000	0.00000	0.00000	1.0000000000	1.0000000000	0.58174	-0.66151	43	0	0	48	7	0	0.00000	0.00000
130	314994000	Metastasis from malignant tumor of prostate (disorder)	53	7200002	Alcoholism	1095	1	5	1	0	4	1090	219.00000	0.44640	0.00000	0.00000	0.00000	0.0045662100	0.0850094759	0.00457	0.99343	0	0	0	1	5	1	-1.79176	-0.69315
58	239720000	Tear of meniscus of knee	54	5602001	Opioid abuse (disorder)	1095	20	7	0	20	7	1068	0.00000	-0.01094	0.00000	0.00000	0.00000	1.0000000000	1.0000000000	0.12785	-0.17358	10	0	0	10	7	0	0.00000	0.00000
57	192127007	Child attention deficit disorder	54	5602001	Opioid abuse (disorder)	1095	76	7	0	76	7	1012	0.00000	-0.02191	0.00000	0.00000	0.00000	1.0000000000	1.0000000000	0.48584	-0.57128	24	0	0	52	7	0	0.00000	0.00000
50	446096008	Perennial allergic rhinitis	54	5602001	Opioid abuse (disorder)	1095	26	7	0	26	7	1062	0.00000	-0.01251	0.00000	0.00000	0.00000	1.0000000000	1.0000000000	0.16621	-0.22183	14	0	0	12	7	0	0.00000	0.00000
49	88805009	Chronic congestive heart failure (disorder)	54	5602001	Opioid abuse (disorder)	1095	10	7	0	10	7	1078	0.00000	-0.00770	0.00000	0.00000	0.00000	1.0000000000	1.0000000000	0.06393	-0.08940	5	0	0	5	7	0	0.00000	0.00000
47	359817006	Closed fracture of hip	54	5602001	Opioid abuse (disorder)	1095	29	7	1	28	6	1060	5.39409	0.05813	6.30952	54.16677	0.73495	0.1717258622	0.7972585288	0.18539	0.75464	11	0	0	18	7	1	-2.07944	-2.94444
44	58150001	Fracture of clavicle	54	5602001	Opioid abuse (disorder)	1095	112	7	1	111	6	977	1.39668	0.01074	1.46697	12.29614	0.17501	0.5311619735	1.0000000000	0.71598	0.22097	55	0	0	57	7	1	-2.07944	-4.06044
43	307731004	Injury of tendon of the rotator cuff of shoulder	54	5602001	Opioid abuse (disorder)	1095	51	7	1	50	6	1038	3.06723	0.03665	3.46000	29.28892	0.40874	0.2845222606	0.9659403678	0.32603	0.59289	26	0	0	25	7	1	-2.07944	-3.25810
42	16114001	Fracture of ankle	54	5602001	Opioid abuse (disorder)	1095	108	7	1	107	6	981	1.44841	0.01190	1.52804	12.81188	0.18224	0.5176013989	1.0000000000	0.69041	0.24263	48	0	0	60	7	1	-2.07944	-4.11087
41	283385000	Laceration of thigh	54	5602001	Opioid abuse (disorder)	1095	105	7	1	104	6	984	1.48980	0.01279	1.57692	13.22495	0.18803	0.5072116212	1.0000000000	0.67123	0.25909	50	0	0	55	7	1	-2.07944	-4.02535
39	74400008	Appendicitis	54	5602001	Opioid abuse (disorder)	1095	51	7	0	51	7	1037	0.00000	-0.01773	0.00000	0.00000	0.00000	1.0000000000	1.0000000000	0.32603	-0.40711	27	0	0	24	7	0	0.00000	0.00000
38	398254007	Preeclampsia	54	5602001	Opioid abuse (disorder)	1095	101	7	0	101	7	987	0.00000	-0.02557	0.00000	0.00000	0.00000	1.0000000000	1.0000000000	0.64566	-0.71867	101	0	0	0	7	0	0.00000	0.00000
35	19169002	Miscarriage in first trimester	54	5602001	Opioid abuse (disorder)	1095	174	7	0	174	7	914	0.00000	-0.03486	0.00000	0.00000	0.00000	0.6050297563	1.0000000000	1.11233	-1.07883	174	0	0	0	7	0	0.00000	0.00000
33	429007001	History of cardiac arrest (situation)	54	5602001	Opioid abuse (disorder)	1095	42	7	0	42	7	1046	0.00000	-0.01602	0.00000	0.00000	0.00000	1.0000000000	1.0000000000	0.26849	-0.34312	24	0	0	18	7	0	0.00000	0.00000
32	410429000	Cardiac Arrest	54	5602001	Opioid abuse (disorder)	1095	42	7	0	42	7	1046	0.00000	-0.01602	0.00000	0.00000	0.00000	1.0000000000	1.0000000000	0.26849	-0.34312	24	0	0	18	7	0	0.00000	0.00000
30	399211009	History of myocardial infarction (situation)	54	5602001	Opioid abuse (disorder)	1095	31	7	0	31	7	1057	0.00000	-0.01369	0.00000	0.00000	0.00000	1.0000000000	1.0000000000	0.19817	-0.26084	2	0	0	29	7	0	0.00000	0.00000
27	408512008	Body mass index 40+ - severely obese (finding)	54	5602001	Opioid abuse (disorder)	1095	97	7	1	96	6	992	1.61267	0.01532	1.72222	14.45386	0.20521	0.4785627484	1.0000000000	0.62009	0.30392	67	0	0	30	7	1	-2.07944	-3.43399
24	162864005	Body mass index 30+ - obesity (finding)	54	5602001	Opioid abuse (disorder)	1095	439	7	5	434	2	654	1.78165	0.05129	3.76728	19.50484	0.72764	0.1237735138	0.6913144812	2.80639	0.65654	226	0	0	213	7	5	-0.87547	-3.77506
114	449868002	Smokes tobacco daily	73	196416002	Impacted molars	1095	9	49	1	8	48	1038	2.48299	0.02922	2.70312	22.04992	0.33138	0.3387195832	1.0000000000	0.40274	0.51175	2	25	0	7	24	1	-3.21888	-2.07944
21	15777000	Prediabetes	54	5602001	Opioid abuse (disorder)	1095	333	7	3	330	4	758	1.40927	0.02170	1.72273	7.74021	0.38343	0.4404549969	1.0000000000	2.12877	0.35441	159	0	0	174	7	3	-1.20397	-4.07754
20	80394007	Hyperglycemia (disorder)	54	5602001	Opioid abuse (disorder)	1095	55	7	1	54	6	1034	2.84416	0.03402	3.19136	26.97898	0.37751	0.3035462664	0.9949586182	0.35160	0.56533	23	0	0	32	7	1	-2.07944	-3.49651
18	302870006	Hypertriglyceridemia (disorder)	54	5602001	Opioid abuse (disorder)	1095	64	7	1	63	6	1025	2.44420	0.02886	2.71164	22.86920	0.32152	0.3447716508	1.0000000000	0.40913	0.50519	28	0	0	36	7	1	-2.07944	-3.61092
17	368581000119106	Neuropathy due to type 2 diabetes mellitus (disorder)	54	5602001	Opioid abuse (disorder)	1095	28	7	1	27	6	1061	5.58673	0.05960	6.54938	56.29236	0.76199	0.1662561273	0.7915572889	0.17900	0.76244	7	0	0	21	7	1	-2.07944	-3.09104
129	47505003	Posttraumatic stress disorder	28	53741008	Coronary Heart Disease	1095	4	80	0	4	80	1011	0.00000	-0.01700	0.00000	0.00000	0.00000	1.0000000000	1.0000000000	0.29224	-0.36987	1	24	0	3	56	0	0.00000	0.00000
15	40055000	Chronic sinusitis (disorder)	54	5602001	Opioid abuse (disorder)	1095	216	7	1	215	6	873	0.72421	-0.01097	0.67674	5.65080	0.08105	1.0000000000	1.0000000000	1.38082	-0.25146	104	0	0	112	7	1	-2.07944	-4.72739
14	10509002	Acute bronchitis (disorder)	54	5602001	Opioid abuse (disorder)	1095	863	7	6	857	1	231	1.08757	0.01355	1.61727	13.50048	0.19374	1.0000000000	1.0000000000	5.51689	0.10317	418	0	0	445	7	6	-0.77319	-4.31971
13	370247008	Facial laceration	54	5602001	Opioid abuse (disorder)	1095	109	7	1	108	6	980	1.43512	0.01160	1.51235	12.67934	0.18039	0.5210226655	1.0000000000	0.69680	0.23718	55	0	0	54	7	1	-2.07944	-4.00733
125	1734006	Fracture of the vertebral column with spinal cord injury	28	53741008	Coronary Heart Disease	1095	5	80	0	5	80	1010	0.00000	-0.01901	0.00000	0.00000	0.00000	1.0000000000	1.0000000000	0.36530	-0.44921	3	24	0	2	56	0	0.00000	0.00000
124	1501000119109	Proliferative diabetic retinopathy due to type II diabetes mellitus (disorder)	28	53741008	Coronary Heart Disease	1095	1	80	0	1	80	1014	0.00000	-0.00849	0.00000	0.00000	0.00000	1.0000000000	1.0000000000	0.07306	-0.10173	1	24	0	0	56	0	0.00000	0.00000
10	62106007	Concussion with no loss of consciousness	54	5602001	Opioid abuse (disorder)	1095	206	7	1	205	6	883	0.75936	-0.00929	0.71789	5.99549	0.08596	1.0000000000	1.0000000000	1.31689	-0.21219	96	0	0	110	7	1	-2.07944	-4.70953
121	254637007	Non-small cell lung cancer (disorder)	28	53741008	Coronary Heart Disease	1095	8	80	0	8	80	1007	0.00000	-0.02408	0.00000	0.00000	0.00000	1.0000000000	1.0000000000	0.58447	-0.66400	0	24	0	8	56	0	0.00000	0.00000
7	75498004	Acute bacterial sinusitis (disorder)	54	5602001	Opioid abuse (disorder)	1095	187	7	1	186	6	902	0.83652	-0.00595	0.80824	6.75302	0.09674	1.0000000000	1.0000000000	1.19543	-0.13451	89	0	0	98	7	1	-2.07944	-4.59512
6	39848009	Whiplash injury to neck	54	5602001	Opioid abuse (disorder)	1095	182	7	0	182	7	906	0.00000	-0.03581	0.00000	0.00000	0.00000	0.6079953893	1.0000000000	1.16347	-1.11335	92	0	0	90	7	0	0.00000	0.00000
5	284549007	Laceration of hand	54	5602001	Opioid abuse (disorder)	1095	104	7	1	103	6	985	1.50412	0.01310	1.59385	13.36803	0.19003	0.5037060128	1.0000000000	0.66484	0.26462	54	0	0	50	7	1	-2.07944	-3.93183
117	230265002	Familial Alzheimer's disease of early onset (disorder)	28	53741008	Coronary Heart Disease	1095	6	80	1	5	79	1010	2.28125	0.02670	2.55696	22.15428	0.29511	0.3663623210	1.0000000000	0.43836	0.47558	2	24	1	4	56	0	3.21888	1.09861
115	36923009	Major depression  single episode	28	53741008	Coronary Heart Disease	1095	6	80	1	5	79	1010	2.28125	0.02670	2.55696	22.15428	0.29511	0.3663623210	1.0000000000	0.43836	0.47558	3	24	0	3	56	1	-4.04305	-1.38629
114	449868002	Smokes tobacco daily	28	53741008	Coronary Heart Disease	1095	9	80	1	8	79	1007	1.52083	0.01331	1.59335	12.90061	0.19680	0.4961098787	1.0000000000	0.65753	0.27096	2	24	0	7	56	1	-4.04305	-2.07944
112	49436004	Atrial Fibrillation	28	53741008	Coronary Heart Disease	1095	35	80	8	27	72	988	3.12857	0.10859	4.06584	9.27258	1.78279	0.0026559422	0.0544716371	2.55708	1.33923	9	24	2	26	56	6	0.22957	0.03077
111	235919008	Cholelithiasis	28	53741008	Coronary Heart Disease	1095	9	80	0	9	80	1006	0.00000	-0.02556	0.00000	0.00000	0.00000	1.0000000000	1.0000000000	0.65753	-0.72904	7	24	0	2	56	0	0.00000	0.00000
109	90560007	Gout	28	53741008	Coronary Heart Disease	1095	4	80	1	3	79	1012	3.42187	0.04117	4.27004	41.52726	0.43907	0.2620622740	0.9281913645	0.29224	0.63013	0	24	0	4	56	1	-4.04305	-1.60944
108	40930008	Hypothyroidism (disorder)	28	53741008	Coronary Heart Disease	1095	13	80	1	12	79	1003	1.05288	0.00163	1.05802	8.24173	0.13582	1.0000000000	1.0000000000	0.94977	0.03669	11	24	1	2	56	0	3.21888	2.48491
107	40275004	Contact dermatitis	28	53741008	Coronary Heart Disease	1095	18	80	3	15	77	1000	2.28125	0.04650	2.59740	9.16682	0.73597	0.1386035940	0.7307281372	1.31507	0.78895	9	24	0	9	56	3	-2.97893	-1.38629
106	24079001	Atopic dermatitis	28	53741008	Coronary Heart Disease	1095	20	80	0	20	80	995	0.00000	-0.03829	0.00000	0.00000	0.00000	0.3910139626	1.0000000000	1.46119	-1.29935	13	24	0	7	56	0	0.00000	0.00000
105	363406005	Malignant tumor of colon	28	53741008	Coronary Heart Disease	1095	6	80	0	6	80	1009	0.00000	-0.02084	0.00000	0.00000	0.00000	1.0000000000	1.0000000000	0.43836	-0.52442	4	24	0	2	56	0	0.00000	0.00000
104	367498001	Seasonal allergic rhinitis	28	53741008	Coronary Heart Disease	1095	20	80	1	19	79	996	0.68437	-0.01209	0.66356	5.02161	0.08768	1.0000000000	1.0000000000	1.46119	-0.29935	9	24	0	11	56	1	-4.04305	-2.48491
102	90781000119102	Microalbuminuria due to type 2 diabetes mellitus (disorder)	28	53741008	Coronary Heart Disease	1095	6	80	0	6	80	1009	0.00000	-0.02084	0.00000	0.00000	0.00000	1.0000000000	1.0000000000	0.43836	-0.52442	3	24	0	3	56	0	0.00000	0.00000
101	433144002	Chronic kidney disease stage 3 (disorder)	28	53741008	Coronary Heart Disease	1095	3	80	0	3	80	1012	0.00000	-0.01472	0.00000	0.00000	0.00000	1.0000000000	1.0000000000	0.21918	-0.28591	1	24	0	2	56	0	0.00000	0.00000
100	161622006	History of lower limb amputation (situation)	28	53741008	Coronary Heart Disease	1095	1	80	1	0	79	1015	13.68750	0.10769	0.00000	0.00000	0.00000	0.0730593607	0.5348749529	0.07306	0.89827	0	24	0	1	56	1	-4.04305	-0.69315
98	1551000119108	Nonproliferative diabetic retinopathy due to type 2 diabetes mellitus (disorder)	28	53741008	Coronary Heart Disease	1095	12	80	5	7	75	1008	5.70312	0.13899	9.60000	30.97350	2.97545	0.0009700353	0.0243284847	0.87671	1.67675	7	24	3	5	56	2	-1.17007	-0.04879
97	403192003	Third degree burn	28	53741008	Coronary Heart Disease	1095	8	80	1	7	79	1008	1.71094	0.01712	1.82278	15.00125	0.22148	0.4560788859	1.0000000000	0.58447	0.33600	3	24	0	5	56	1	-4.04305	-1.79176
96	283371005	Laceration of forearm	28	53741008	Coronary Heart Disease	1095	75	80	11	64	69	951	2.00750	0.07670	2.36889	4.69842	1.19436	0.0190497168	0.2409487231	5.47945	0.88909	39	24	6	36	56	5	-0.89200	-0.08923
95	84757009	Epilepsy	28	53741008	Coronary Heart Disease	1095	30	80	1	29	79	986	0.45625	-0.02562	0.43038	3.20117	0.05786	0.7189960738	1.0000000000	2.19178	-0.67436	13	24	0	17	56	1	-4.04305	-2.89037
94	703151001	History of single seizure (situation)	28	53741008	Coronary Heart Disease	1095	39	80	2	37	78	978	0.70192	-0.01608	0.67775	2.86470	0.16035	1.0000000000	1.0000000000	2.84932	-0.35964	14	24	0	25	56	2	-3.36730	-2.60269
93	128613002	Seizure disorder	28	53741008	Coronary Heart Disease	1095	39	80	2	37	78	978	0.70192	-0.01608	0.67775	2.86470	0.16035	1.0000000000	1.0000000000	2.84932	-0.35964	14	24	0	25	56	2	-3.36730	-2.60269
89	47693006	Rupture of appendix	28	53741008	Coronary Heart Disease	1095	20	80	1	19	79	996	0.68437	-0.01209	0.66356	5.02161	0.08768	1.0000000000	1.0000000000	1.46119	-0.29935	10	24	0	10	56	1	-4.04305	-2.39790
86	713197008	Recurrent rectal polyp	28	53741008	Coronary Heart Disease	1095	22	80	4	18	76	997	2.48864	0.05984	2.91520	8.83016	0.96243	0.0703918033	0.5223155106	1.60731	0.93937	12	24	2	10	56	2	-0.80235	0.15415
82	94260004	Secondary malignant neoplasm of colon	28	53741008	Coronary Heart Disease	1095	4	80	1	3	79	1012	3.42187	0.04117	4.27004	41.52726	0.43907	0.2620622740	0.9281913645	0.29224	0.63013	2	24	0	2	56	1	-4.04305	-1.09861
80	6072007	Bleeding from anus	28	53741008	Coronary Heart Disease	1095	4	80	1	3	79	1012	3.42187	0.04117	4.27004	41.52726	0.43907	0.2620622740	0.9281913645	0.29224	0.63013	2	24	0	2	56	1	-4.04305	-1.09861
78	239872002	Osteoarthritis of hip	28	53741008	Coronary Heart Disease	1095	21	80	5	16	75	999	3.25893	0.08868	4.16250	11.67387	1.48420	0.0147470822	0.2045021916	1.53425	1.24341	13	24	3	8	56	2	-1.17007	0.06454
76	127013003	Diabetic renal disease (disorder)	28	53741008	Coronary Heart Disease	1095	28	80	4	24	76	991	1.95536	0.04345	2.17325	6.42455	0.73515	0.1418318403	0.7403058513	2.04566	0.71517	10	24	1	18	56	3	0.23995	0.45199
75	431855005	Chronic kidney disease stage 1 (disorder)	28	53741008	Coronary Heart Disease	1095	28	80	4	24	76	991	1.95536	0.04345	2.17325	6.42455	0.73515	0.1418318403	0.7403058513	2.04566	0.71517	10	24	1	18	56	3	0.23995	0.45199
73	196416002	Impacted molars	28	53741008	Coronary Heart Disease	1095	49	80	2	47	78	968	0.55867	-0.02682	0.52810	2.21508	0.12590	0.5735457081	1.0000000000	3.57991	-0.61036	25	24	0	24	56	2	-3.36730	-2.56495
72	35999006	Blighted ovum	28	53741008	Coronary Heart Disease	1095	53	80	5	48	75	967	1.29127	0.01844	1.34306	3.47461	0.51914	0.5834089372	1.0000000000	3.87215	0.30041	53	24	5	0	56	0	1.75786	2.45101
71	201834006	Localized  primary osteoarthritis of the hand	28	53741008	Coronary Heart Disease	1095	28	80	4	24	76	991	1.95536	0.04345	2.17325	6.42455	0.73515	0.1418318403	0.7403058513	2.04566	0.71517	19	24	2	9	56	2	-0.80235	0.64663
70	87433001	Pulmonary emphysema (disorder)	28	53741008	Coronary Heart Disease	1095	17	80	2	15	78	1000	1.61029	0.02152	1.70940	7.60979	0.38399	0.3562031978	1.0000000000	1.24201	0.42017	9	24	1	8	56	1	-0.82418	0.10536
69	233604007	Pneumonia	28	53741008	Coronary Heart Disease	1095	7	80	1	6	79	1009	1.95536	0.02151	2.12869	17.90108	0.25313	0.4129105436	1.0000000000	0.51142	0.40410	3	24	1	4	56	0	3.21888	1.38629
68	26929004	Alzheimer's disease (disorder)	28	53741008	Coronary Heart Disease	1095	23	80	5	18	75	997	2.97554	0.08124	3.69259	10.22211	1.33390	0.0217208788	0.2655079578	1.68037	1.16253	15	24	2	8	56	3	-0.41398	0.84078
67	403191005	Second degree burn	28	53741008	Coronary Heart Disease	1095	49	80	7	42	73	973	1.95536	0.05805	2.22146	5.11880	0.96407	0.0820252948	0.5647200295	3.57991	0.80468	23	24	2	26	56	5	0.06351	0.70118
65	239873007	Osteoarthritis of knee	28	53741008	Coronary Heart Disease	1095	57	80	10	47	70	968	2.40132	0.09219	2.94225	6.07119	1.42589	0.0062406975	0.1078363043	4.16438	1.09084	30	24	2	27	56	8	0.48551	1.29668
64	444448004	Injury of medial collateral ligament of knee	28	53741008	Coronary Heart Disease	1095	32	80	3	29	77	986	1.28320	0.01379	1.32468	4.44712	0.39458	0.5034730156	1.0000000000	2.33790	0.26106	17	24	2	15	56	1	-1.47810	-0.52130
63	68496003	Polyp of colon	28	53741008	Coronary Heart Disease	1095	91	80	11	80	69	935	1.65453	0.05532	1.86322	3.66323	0.94769	0.0881179107	0.5877652129	6.64840	0.64980	43	24	2	48	56	9	0.58779	1.26769
62	185086009	Chronic obstructive bronchitis (disorder)	28	53741008	Coronary Heart Disease	1095	6	80	0	6	80	1009	0.00000	-0.02084	0.00000	0.00000	0.00000	1.0000000000	1.0000000000	0.43836	-0.52442	4	24	0	2	56	0	0.00000	0.00000
59	262574004	Bullet wound	28	53741008	Coronary Heart Disease	1095	20	80	1	19	79	996	0.68437	-0.01209	0.66356	5.02161	0.08768	1.0000000000	1.0000000000	1.46119	-0.29935	9	24	0	11	56	1	-4.04305	-2.48491
58	239720000	Tear of meniscus of knee	28	53741008	Coronary Heart Disease	1095	20	80	1	19	79	996	0.68437	-0.01209	0.66356	5.02161	0.08768	1.0000000000	1.0000000000	1.46119	-0.29935	10	24	0	10	56	1	-4.04305	-2.39790
57	192127007	Child attention deficit disorder	28	53741008	Coronary Heart Disease	1095	76	80	6	70	74	945	1.08059	0.00618	1.09459	2.60399	0.46012	0.8185323547	1.0000000000	5.55251	0.09531	24	24	0	52	56	6	-2.33537	-2.26868
56	92691004	Carcinoma in situ of prostate (disorder)	28	53741008	Coronary Heart Disease	1095	23	80	5	18	75	997	2.97554	0.08124	3.69259	10.22211	1.33390	0.0217208788	0.2655079578	1.68037	1.16253	0	24	0	23	56	5	-2.50144	-1.72277
54	5602001	Opioid abuse (disorder)	28	53741008	Coronary Heart Disease	1095	7	80	0	7	80	1008	0.00000	-0.02252	0.00000	0.00000	0.00000	1.0000000000	1.0000000000	0.51142	-0.59590	0	24	0	7	56	0	0.00000	0.00000
52	124171000119105	Chronic intractable migraine without aura	28	53741008	Coronary Heart Disease	1095	51	80	3	48	77	967	0.80515	-0.01209	0.78490	2.57818	0.23896	1.0000000000	1.0000000000	3.72603	-0.24063	21	24	0	30	56	3	-2.97893	-2.39790
50	446096008	Perennial allergic rhinitis	28	53741008	Coronary Heart Disease	1095	26	80	0	26	80	989	0.00000	-0.04378	0.00000	0.00000	0.00000	0.2513204010	0.9133257124	1.89954	-1.53583	14	24	0	12	56	0	0.00000	0.00000
49	88805009	Chronic congestive heart failure (disorder)	28	53741008	Coronary Heart Disease	1095	10	80	1	9	79	1006	1.36875	0.00994	1.41491	11.31020	0.17701	0.5332288563	1.0000000000	0.73059	0.20873	5	24	1	5	56	0	3.21888	1.79176
47	359817006	Closed fracture of hip	28	53741008	Coronary Heart Disease	1095	29	80	4	25	76	990	1.88793	0.04112	2.08421	6.14316	0.70712	0.1558380662	0.7747075658	2.11872	0.68097	11	24	2	18	56	2	-0.80235	-0.43078
46	62564004	Concussion with loss of consciousness	28	53741008	Coronary Heart Disease	1095	67	80	6	61	74	954	1.22575	0.01618	1.26805	3.03066	0.53057	0.6246976657	1.0000000000	4.89498	0.24787	36	24	3	31	56	3	-0.78170	0.13720
45	263102004	Fracture subluxation of wrist	28	53741008	Coronary Heart Disease	1095	109	80	9	100	71	915	1.13016	0.01215	1.15986	2.39137	0.56255	0.6971342035	1.0000000000	7.96347	0.15787	51	24	4	58	56	5	-0.55553	0.08734
44	58150001	Fracture of clavicle	28	53741008	Coronary Heart Disease	1095	112	80	6	106	74	909	0.73326	-0.02528	0.69531	1.63646	0.29543	0.5639380433	1.0000000000	8.18265	-0.39156	55	24	2	57	56	4	-0.14310	0.62532
43	307731004	Injury of tendon of the rotator cuff of shoulder	28	53741008	Coronary Heart Disease	1095	51	80	5	46	75	969	1.34191	0.02122	1.40435	3.63981	0.54184	0.4132178667	1.0000000000	3.72603	0.34433	26	24	1	25	56	4	0.51083	1.31484
42	16114001	Fracture of ankle	28	53741008	Coronary Heart Disease	1095	108	80	8	100	72	915	1.01389	0.00129	1.01667	2.17184	0.47591	1.0000000000	1.0000000000	7.89041	0.01767	48	24	2	60	56	6	0.22957	0.82098
41	283385000	Laceration of thigh	28	53741008	Coronary Heart Disease	1095	105	80	9	96	71	919	1.17321	0.01584	1.21347	2.50463	0.58791	0.5559383183	1.0000000000	7.67123	0.20569	50	24	5	55	56	4	-0.95019	-0.29335
39	74400008	Appendicitis	28	53741008	Coronary Heart Disease	1095	51	80	2	49	78	966	0.53676	-0.02874	0.50549	2.11782	0.12065	0.5773495999	1.0000000000	3.72603	-0.65567	27	24	0	24	56	2	-3.36730	-2.56495
38	398254007	Preeclampsia	28	53741008	Coronary Heart Disease	1095	101	80	7	94	73	921	0.94864	-0.00460	0.93952	2.09936	0.42046	1.0000000000	1.0000000000	7.37900	-0.06678	101	24	7	0	56	0	1.48808	2.73622
35	19169002	Miscarriage in first trimester	28	53741008	Coronary Heart Disease	1095	174	80	17	157	63	858	1.33728	0.04116	1.47467	2.58694	0.84063	0.2020250634	0.8497164196	12.71233	0.39252	174	24	17	0	56	0	0.88036	2.41906
33	429007001	History of cardiac arrest (situation)	28	53741008	Coronary Heart Disease	1095	42	80	8	34	72	981	2.60714	0.09011	3.20588	7.18133	1.43117	0.0087246476	0.1389926625	3.06849	1.14543	24	24	5	18	56	3	-1.22107	-0.18805
32	410429000	Cardiac Arrest	28	53741008	Coronary Heart Disease	1095	42	80	8	34	72	981	2.60714	0.09011	3.20588	7.18133	1.43117	0.0087246476	0.1389926625	3.06849	1.14543	24	24	5	18	56	3	-1.22107	-0.18805
30	399211009	History of myocardial infarction (situation)	28	53741008	Coronary Heart Disease	1095	31	80	29	2	51	1013	12.80444	0.56568	288.00980	1240.46162	66.86998	0.0000000000	0.0000000000	2.26484	3.19988	2	24	2	29	56	27	1.44195	-0.03637
29	22298006	Myocardial Infarction	28	53741008	Coronary Heart Disease	1095	31	80	29	2	51	1013	12.80444	0.56568	288.00980	1240.46162	66.86998	0.0000000000	0.0000000000	2.26484	3.19988	2	24	2	29	56	27	1.44195	-0.03637
27	408512008	Body mass index 40+ - severely obese (finding)	28	53741008	Coronary Heart Disease	1095	97	80	10	87	70	928	1.41108	0.03598	1.52381	3.06270	0.75815	0.2222204302	0.8794911525	7.08676	0.44387	67	24	6	30	56	4	-1.09861	0.35863
24	162864005	Body mass index 30+ - obesity (finding)	28	53741008	Coronary Heart Disease	1095	439	80	37	402	43	613	1.15362	0.03528	1.31210	2.07254	0.83068	0.2861730364	0.9676528943	32.07306	0.20034	226	24	14	213	56	23	-0.23542	0.51324
23	36971009	Sinusitis (disorder)	28	53741008	Coronary Heart Disease	1095	190	80	18	172	62	843	1.29671	0.03817	1.42292	2.46575	0.82113	0.2195456209	0.8768098041	13.88128	0.35250	84	24	2	106	56	16	1.06087	1.72977
21	15777000	Prediabetes	28	53741008	Coronary Heart Disease	1095	333	80	43	290	37	725	1.76745	0.14243	2.90541	4.60290	1.83393	0.0000067916	0.0003010962	24.32877	0.79673	159	24	14	174	56	29	-0.07683	0.56832
20	80394007	Hyperglycemia (disorder)	28	53741008	Coronary Heart Disease	1095	55	80	13	42	67	973	3.23523	0.14431	4.49502	8.78005	2.30127	0.0000760983	0.0026935102	4.01826	1.48017	23	24	4	32	56	9	-0.03125	0.39320
19	237602007	Metabolic syndrome X (disorder)	28	53741008	Coronary Heart Disease	1095	64	80	13	51	67	964	2.78027	0.12453	3.66754	7.07733	1.90056	0.0003994294	0.0115335252	4.67580	1.30253	28	24	4	36	56	9	-0.03125	0.47000
18	302870006	Hypertriglyceridemia (disorder)	28	53741008	Coronary Heart Disease	1095	64	80	13	51	67	964	2.78027	0.12453	3.66754	7.07733	1.90056	0.0003994294	0.0115335252	4.67580	1.30253	28	24	4	36	56	9	-0.03125	0.47000
17	368581000119106	Neuropathy due to type 2 diabetes mellitus (disorder)	28	53741008	Coronary Heart Disease	1095	28	80	9	19	71	996	4.39955	0.15461	6.64492	15.22125	2.90088	0.0000837185	0.0029278120	2.04566	1.71517	7	24	3	21	56	6	-0.13815	-0.30010
129	47505003	Posttraumatic stress disorder	2	43878008	Streptococcal sore throat (disorder)	1095	4	523	3	1	520	571	1.57027	0.03302	3.29423	31.76812	0.34160	0.3534272870	1.0000000000	1.91050	0.45873	1	246	1	3	277	2	0.57132	-0.22314
15	40055000	Chronic sinusitis (disorder)	28	53741008	Coronary Heart Disease	1095	216	80	21	195	59	820	1.33073	0.04603	1.49674	2.52245	0.88812	0.1437103205	0.7404942507	15.78082	0.39069	104	24	4	112	56	17	0.48866	1.26924
14	10509002	Acute bronchitis (disorder)	28	53741008	Coronary Heart Disease	1095	863	80	71	792	9	223	1.12609	0.06827	2.22124	4.51452	1.09290	0.0227207850	0.2724631838	63.05023	0.16879	418	24	21	445	56	50	0.01072	0.74744
13	370247008	Facial laceration	28	53741008	Coronary Heart Disease	1095	109	80	11	98	69	917	1.38131	0.03559	1.49172	2.91384	0.76368	0.2435115005	0.9130344998	7.96347	0.42091	55	24	3	54	56	8	0.11778	0.91414
125	1734006	Fracture of the vertebral column with spinal cord injury	2	43878008	Streptococcal sore throat (disorder)	1095	5	523	1	4	522	568	0.41874	-0.03764	0.27203	2.44169	0.03031	0.3763655651	1.0000000000	2.38813	-0.76049	3	246	1	2	277	0	5.50939	1.38629
124	1501000119109	Proliferative diabetic retinopathy due to type II diabetes mellitus (disorder)	2	43878008	Streptococcal sore throat (disorder)	1095	1	523	0	1	523	571	0.00000	-0.02891	0.00000	0.00000	0.00000	1.0000000000	1.0000000000	0.47763	-0.56328	1	246	0	0	277	0	0.00000	0.00000
10	62106007	Concussion with no loss of consciousness	28	53741008	Coronary Heart Disease	1095	206	80	23	183	57	832	1.52822	0.07138	1.83453	3.05480	1.10171	0.0249525434	0.2905941929	15.05023	0.58044	96	24	7	110	56	16	-0.01600	0.62513
8	233678006	Childhood asthma	28	53741008	Coronary Heart Disease	1095	45	80	2	43	78	972	0.60833	-0.02276	0.57961	2.43757	0.13782	0.7670383584	1.0000000000	3.28767	-0.51523	25	24	1	20	56	1	-0.82418	0.21357
7	75498004	Acute bacterial sinusitis (disorder)	28	53741008	Coronary Heart Disease	1095	187	80	18	169	62	846	1.31751	0.04045	1.45333	2.51932	0.83839	0.2153466926	0.8672161313	13.66210	0.37391	89	24	5	98	56	13	0.08870	0.78928
6	39848009	Whiplash injury to neck	28	53741008	Coronary Heart Disease	1095	182	80	17	165	63	850	1.27850	0.03491	1.39009	2.43608	0.79322	0.2736438842	0.9491303271	13.29680	0.33230	92	24	5	90	56	12	0.02326	0.82521
5	284549007	Laceration of hand	28	53741008	Coronary Heart Disease	1095	104	80	12	92	68	923	1.57933	0.05269	1.77046	3.39147	0.92424	0.1089750750	0.6492584851	7.59817	0.59641	54	24	4	50	56	8	-0.13353	0.69315
117	230265002	Familial Alzheimer's disease of early onset (disorder)	2	43878008	Streptococcal sore throat (disorder)	1095	6	523	3	3	520	569	1.04685	0.00332	1.09423	5.44539	0.21988	1.0000000000	1.0000000000	2.86575	0.04925	2	246	0	4	277	3	-4.53618	-0.84730
116	370143000	Major depression disorder	2	43878008	Streptococcal sore throat (disorder)	1095	8	523	6	2	517	570	1.57027	0.04678	3.30754	16.45999	0.66463	0.1617672324	0.7862880696	3.82100	0.53802	3	246	3	5	277	3	-0.11734	-0.28768
115	36923009	Major depression  single episode	2	43878008	Streptococcal sore throat (disorder)	1095	6	523	4	2	519	570	1.39579	0.02809	2.19653	12.04224	0.40065	0.4333988087	1.0000000000	2.86575	0.37118	3	246	3	3	277	1	-1.20878	-0.69315
1	444814009	Viral sinusitis (disorder)	28	53741008	Coronary Heart Disease	1095	993	80	79	914	1	101	1.08894	0.07790	8.72976	63.41805	1.20169	0.0046555749	0.0860350236	72.54795	0.12131	478	24	24	515	56	55	-0.00905	0.70224
113	443165006	Pathological fracture due to osteoporosis (disorder)	2	43878008	Streptococcal sore throat (disorder)	1095	10	523	4	6	519	566	0.83748	-0.01492	0.72704	2.59082	0.20402	0.7552587816	1.0000000000	4.77626	-0.20821	7	246	2	3	277	2	-0.11778	0.58779
112	49436004	Atrial Fibrillation	2	43878008	Streptococcal sore throat (disorder)	1095	35	523	20	15	503	557	1.19639	0.03412	1.47647	2.91503	0.74784	0.3032886516	0.9949586182	16.71689	0.24526	9	246	3	26	277	17	1.56847	0.45831
111	235919008	Cholelithiasis	2	43878008	Streptococcal sore throat (disorder)	1095	9	523	4	5	519	567	0.93053	-0.00605	0.87399	3.27225	0.23343	1.0000000000	1.0000000000	4.29863	-0.08369	7	246	3	2	277	1	-1.20878	0.10536
110	65275009	Acute Cholecystitis	2	43878008	Streptococcal sore throat (disorder)	1095	9	523	4	5	519	567	0.93053	-0.00605	0.87399	3.27225	0.23343	1.0000000000	1.0000000000	4.29863	-0.08369	7	246	3	2	277	1	-1.20878	0.10536
109	90560007	Gout	2	43878008	Streptococcal sore throat (disorder)	1095	4	523	2	2	521	570	1.04685	0.00271	1.09405	7.79474	0.15356	1.0000000000	1.0000000000	1.91050	0.04369	0	246	0	4	277	2	-4.93806	-1.09861
108	40930008	Hypothyroidism (disorder)	2	43878008	Streptococcal sore throat (disorder)	1095	13	523	5	8	518	564	0.80527	-0.02041	0.68050	2.09337	0.22121	0.5838233991	1.0000000000	6.20913	-0.26486	11	246	4	2	277	1	-1.49245	0.22314
107	40275004	Contact dermatitis	2	43878008	Streptococcal sore throat (disorder)	1095	18	523	8	10	515	562	0.93053	-0.00859	0.87301	2.22897	0.34193	0.8163793949	1.0000000000	8.59726	-0.09270	9	246	3	9	277	5	0.38637	0.35667
106	24079001	Atopic dermatitis	2	43878008	Streptococcal sore throat (disorder)	1095	20	523	8	12	515	560	0.83748	-0.02120	0.72492	1.78759	0.29397	0.5082344991	1.0000000000	9.55251	-0.22959	13	246	6	7	277	2	-1.20039	-0.35140
105	363406005	Malignant tumor of colon	2	43878008	Streptococcal sore throat (disorder)	1095	6	523	1	5	522	567	0.34895	-0.04621	0.21724	1.86559	0.02530	0.2202852089	0.8777410641	2.86575	-0.95075	4	246	1	2	277	0	5.50939	1.60944
104	367498001	Seasonal allergic rhinitis	2	43878008	Streptococcal sore throat (disorder)	1095	20	523	8	12	515	560	0.83748	-0.02120	0.72492	1.78759	0.29397	0.5082344991	1.0000000000	9.55251	-0.22959	9	246	5	11	277	3	-0.62016	-0.51083
103	157141000119108	Proteinuria due to type 2 diabetes mellitus (disorder)	2	43878008	Streptococcal sore throat (disorder)	1095	3	523	2	1	521	571	1.39579	0.01984	2.19194	24.24427	0.19817	0.6086156305	1.0000000000	1.43288	0.30230	1	246	1	2	277	1	-0.11823	-0.40547
102	90781000119102	Microalbuminuria due to type 2 diabetes mellitus (disorder)	2	43878008	Streptococcal sore throat (disorder)	1095	6	523	4	2	519	570	1.39579	0.02809	2.19653	12.04224	0.40065	0.4333988087	1.0000000000	2.86575	0.37118	3	246	2	3	277	2	-0.11778	0.00000
101	433144002	Chronic kidney disease stage 3 (disorder)	2	43878008	Streptococcal sore throat (disorder)	1095	3	523	2	1	521	571	1.39579	0.01984	2.19194	24.24427	0.19817	0.6086156305	1.0000000000	1.43288	0.30230	1	246	1	2	277	1	-0.11823	-0.40547
100	161622006	History of lower limb amputation (situation)	2	43878008	Streptococcal sore throat (disorder)	1095	1	523	1	0	522	572	2.09369	0.03162	0.00000	0.00000	0.00000	0.4776255708	1.0000000000	0.47763	0.43672	0	246	0	1	277	1	-5.62762	-0.69315
99	30832001	Rupture of patellar tendon	2	43878008	Streptococcal sore throat (disorder)	1095	23	523	13	10	510	562	1.18339	0.02569	1.43255	3.29541	0.62274	0.4083612908	1.0000000000	10.98539	0.22415	14	246	8	9	277	5	-0.57458	-0.01802
98	1551000119108	Nonproliferative diabetic retinopathy due to type 2 diabetes mellitus (disorder)	2	43878008	Streptococcal sore throat (disorder)	1095	12	523	6	6	517	566	1.04685	0.00472	1.09478	3.41577	0.35088	1.0000000000	1.0000000000	5.73151	0.05643	7	246	2	5	277	4	0.56822	0.69315
97	403192003	Third degree burn	2	43878008	Streptococcal sore throat (disorder)	1095	8	523	4	4	519	568	1.04685	0.00384	1.09441	4.39833	0.27232	1.0000000000	1.0000000000	3.82100	0.05259	3	246	1	5	277	3	0.97321	0.40547
96	283371005	Laceration of forearm	2	43878008	Streptococcal sore throat (disorder)	1095	75	523	40	35	483	537	1.11663	0.03024	1.27063	2.03300	0.79415	0.3393794263	1.0000000000	35.82192	0.15506	39	246	23	36	277	17	-0.39115	-0.14544
95	84757009	Epilepsy	2	43878008	Streptococcal sore throat (disorder)	1095	30	523	13	17	510	555	0.90727	-0.01488	0.83218	1.73041	0.40021	0.7122541817	1.0000000000	14.32877	-0.13081	13	246	5	17	277	8	0.34297	0.14150
94	703151001	History of single seizure (situation)	2	43878008	Streptococcal sore throat (disorder)	1095	39	523	15	24	508	548	0.80527	-0.03578	0.67421	1.29965	0.34976	0.2566884306	0.9200535090	18.62740	-0.29480	14	246	5	25	277	10	0.55912	0.08224
93	128613002	Seizure disorder	2	43878008	Streptococcal sore throat (disorder)	1095	39	523	15	24	508	548	0.80527	-0.03578	0.67421	1.29965	0.34976	0.2566884306	0.9200535090	18.62740	-0.29480	14	246	5	25	277	10	0.55912	0.08224
92	82423001	Chronic pain	2	43878008	Streptococcal sore throat (disorder)	1095	52	523	27	25	496	547	1.08711	0.01860	1.19105	2.07974	0.68210	0.5713606535	1.0000000000	24.83653	0.11601	24	246	13	28	277	14	-0.04239	-0.05264
91	64859006	Osteoporosis (disorder)	2	43878008	Streptococcal sore throat (disorder)	1095	37	523	18	19	505	553	1.01855	0.00332	1.03742	1.99889	0.53841	1.0000000000	1.0000000000	17.67215	0.02511	24	246	10	13	277	8	-0.33046	0.25869
89	47693006	Rupture of appendix	2	43878008	Streptococcal sore throat (disorder)	1095	20	523	10	10	513	562	1.04685	0.00611	1.09552	2.65351	0.45229	1.0000000000	1.0000000000	9.55251	0.05992	10	246	6	10	277	4	-0.51439	-0.27193
88	197927001	Recurrent urinary tract infection	2	43878008	Streptococcal sore throat (disorder)	1095	8	523	2	6	521	566	0.52342	-0.03909	0.36212	1.80211	0.07277	0.2912162062	0.9768039197	3.82100	-0.68437	8	246	2	0	277	0	4.82028	1.60944
86	713197008	Recurrent rectal polyp	2	43878008	Streptococcal sore throat (disorder)	1095	22	523	7	15	516	557	0.66617	-0.04571	0.50375	1.24536	0.20376	0.1384738979	0.7306035772	10.50776	-0.52454	12	246	4	10	277	3	-0.40101	-0.08004
85	241929008	Acute allergic reaction	2	43878008	Streptococcal sore throat (disorder)	1095	47	523	21	26	502	546	0.93548	-0.01307	0.87849	1.58110	0.48810	0.7657201929	1.0000000000	22.44840	-0.09199	25	246	13	22	277	8	-0.58117	-0.24912
84	232353008	Perennial allergic rhinitis with seasonal variation	2	43878008	Streptococcal sore throat (disorder)	1095	29	523	16	13	507	559	1.15514	0.02447	1.35700	2.84887	0.64638	0.4552080044	1.0000000000	13.85114	0.19496	14	246	6	15	277	10	0.38077	0.28768
83	110030002	Concussion injury of brain	2	43878008	Streptococcal sore throat (disorder)	1095	7	523	3	4	520	568	0.89730	-0.00788	0.81923	3.67767	0.18249	1.0000000000	1.0000000000	3.34338	-0.11882	1	246	1	6	277	2	0.57132	-0.69315
82	94260004	Secondary malignant neoplasm of colon	2	43878008	Streptococcal sore throat (disorder)	1095	4	523	2	2	521	570	1.04685	0.00271	1.09405	7.79474	0.15356	1.0000000000	1.0000000000	1.91050	0.04369	2	246	1	2	277	1	-0.11823	0.00000
81	236077008	Protracted diarrhea	2	43878008	Streptococcal sore throat (disorder)	1095	4	523	2	2	521	570	1.04685	0.00271	1.09405	7.79474	0.15356	1.0000000000	1.0000000000	1.91050	0.04369	2	246	1	2	277	1	-0.11823	0.00000
80	6072007	Bleeding from anus	2	43878008	Streptococcal sore throat (disorder)	1095	4	523	2	2	521	570	1.04685	0.00271	1.09405	7.79474	0.15356	1.0000000000	1.0000000000	1.91050	0.04369	2	246	1	2	277	1	-0.11823	0.00000
79	45816000	Pyelonephritis	2	43878008	Streptococcal sore throat (disorder)	1095	1	523	0	1	523	571	0.00000	-0.02891	0.00000	0.00000	0.00000	1.0000000000	1.0000000000	0.47763	-0.56328	1	246	0	0	277	0	0.00000	0.00000
78	239872002	Osteoarthritis of hip	2	43878008	Streptococcal sore throat (disorder)	1095	21	523	10	11	513	561	0.99700	-0.00040	0.99415	2.36041	0.41871	1.0000000000	1.0000000000	10.03014	-0.00395	13	246	5	8	277	5	-0.11645	0.32542
77	422034002	Diabetic retinopathy associated with type II diabetes mellitus (disorder)	2	43878008	Streptococcal sore throat (disorder)	1095	20	523	10	10	513	562	1.04685	0.00611	1.09552	2.65351	0.45229	1.0000000000	1.0000000000	9.55251	0.05992	8	246	3	12	277	7	0.71578	0.30075
76	127013003	Diabetic renal disease (disorder)	2	43878008	Streptococcal sore throat (disorder)	1095	28	523	12	16	511	556	0.89730	-0.01591	0.81605	1.74154	0.38238	0.7026785066	1.0000000000	13.37352	-0.14490	10	246	2	18	277	10	1.46338	0.76214
75	431855005	Chronic kidney disease stage 1 (disorder)	2	43878008	Streptococcal sore throat (disorder)	1095	28	523	12	16	511	556	0.89730	-0.01591	0.81605	1.74154	0.38238	0.7026785066	1.0000000000	13.37352	-0.14490	10	246	2	18	277	10	1.46338	0.76214
73	196416002	Impacted molars	2	43878008	Streptococcal sore throat (disorder)	1095	49	523	20	29	503	543	0.85457	-0.03010	0.74450	1.33297	0.41582	0.3804541867	1.0000000000	23.40365	-0.21671	25	246	12	24	277	8	-0.50499	-0.26028
72	35999006	Blighted ovum	2	43878008	Streptococcal sore throat (disorder)	1095	53	523	32	21	491	551	1.26411	0.05696	1.71002	3.00481	0.97316	0.0670648032	0.5083720574	25.31416	0.32663	53	246	32	0	277	0	2.16189	0.97692
71	201834006	Localized  primary osteoarthritis of the hand	2	43878008	Streptococcal sore throat (disorder)	1095	28	523	15	13	508	559	1.12162	0.01884	1.26969	2.69425	0.59835	0.5696390275	1.0000000000	13.37352	0.15466	19	246	11	9	277	4	-1.10088	-0.17535
70	87433001	Pulmonary emphysema (disorder)	2	43878008	Streptococcal sore throat (disorder)	1095	17	523	6	11	517	561	0.73895	-0.03135	0.59188	1.61190	0.21733	0.3368819495	1.0000000000	8.11963	-0.38162	9	246	2	8	277	4	0.56822	0.60614
69	233604007	Pneumonia	2	43878008	Streptococcal sore throat (disorder)	1095	7	523	4	3	519	569	1.19639	0.01506	1.46179	6.56221	0.32562	0.7151974661	1.0000000000	3.34338	0.20311	3	246	1	4	277	3	0.97321	0.53900
68	26929004	Alzheimer's disease (disorder)	2	43878008	Streptococcal sore throat (disorder)	1095	23	523	13	10	510	562	1.18339	0.02569	1.43255	3.29541	0.62274	0.4083612908	1.0000000000	10.98539	0.22415	15	246	8	8	277	5	-0.57458	0.10054
67	403191005	Second degree burn	2	43878008	Streptococcal sore throat (disorder)	1095	49	523	25	24	498	548	1.06821	0.01412	1.14625	2.03317	0.64623	0.6631022365	1.0000000000	23.40365	0.09141	23	246	9	26	277	16	0.43646	0.30343
66	55822004	Hyperlipidemia	2	43878008	Streptococcal sore throat (disorder)	1095	119	523	50	69	473	503	0.87970	-0.04017	0.77060	1.13254	0.52433	0.2064967059	0.8561849853	56.83744	-0.18151	64	246	26	55	277	24	-0.18135	0.05032
65	239873007	Osteoarthritis of knee	2	43878008	Streptococcal sore throat (disorder)	1095	57	523	24	33	499	539	0.88155	-0.02654	0.78557	1.34766	0.45792	0.4155638113	1.0000000000	27.22466	-0.17503	30	246	11	27	277	13	0.04625	0.19175
64	444448004	Injury of medial collateral ligament of knee	2	43878008	Streptococcal sore throat (disorder)	1095	32	523	14	18	509	554	0.91599	-0.01394	0.84654	1.71966	0.41673	0.7209979655	1.0000000000	15.28402	-0.11849	17	246	8	15	277	6	-0.39579	-0.11333
63	68496003	Polyp of colon	2	43878008	Streptococcal sore throat (disorder)	1095	91	523	41	50	482	522	0.94331	-0.01632	0.88805	1.36667	0.57705	0.6613594985	1.0000000000	43.46393	-0.08225	43	246	17	48	277	24	0.20988	0.16252
62	185086009	Chronic obstructive bronchitis (disorder)	2	43878008	Streptococcal sore throat (disorder)	1095	6	523	0	6	523	566	0.00000	-0.07098	0.00000	0.00000	0.00000	0.0317589401	0.3282620135	2.86575	-1.95075	4	246	0	2	277	0	0.00000	0.00000
61	198992004	Antepartum eclampsia	2	43878008	Streptococcal sore throat (disorder)	1095	96	523	52	44	471	528	1.13408	0.03974	1.32484	2.01687	0.87026	0.2003121350	0.8449495057	45.85205	0.17788	96	246	52	0	277	0	1.74585	1.04597
60	301011002	Escherichia coli urinary tract infection	2	43878008	Streptococcal sore throat (disorder)	1095	92	523	44	48	479	524	1.00133	0.00039	1.00278	1.53756	0.65401	1.0000000000	1.0000000000	43.94155	0.00188	85	246	42	7	277	2	-3.01277	-0.39756
59	262574004	Bullet wound	2	43878008	Streptococcal sore throat (disorder)	1095	20	523	9	11	514	561	0.94216	-0.00754	0.89300	2.17245	0.36707	0.8257597241	1.0000000000	9.55251	-0.07759	9	246	4	11	277	5	0.10270	0.01550
58	239720000	Tear of meniscus of knee	2	43878008	Streptococcal sore throat (disorder)	1095	20	523	9	11	514	561	0.94216	-0.00754	0.89300	2.17245	0.36707	0.8257597241	1.0000000000	9.55251	-0.07759	10	246	5	10	277	4	-0.33605	-0.15415
57	192127007	Child attention deficit disorder	2	43878008	Streptococcal sore throat (disorder)	1095	76	523	37	39	486	533	1.01930	0.00504	1.04047	1.65859	0.65271	0.9055507431	1.0000000000	36.29954	0.02684	24	246	15	52	277	22	0.24707	-0.25751
56	92691004	Carcinoma in situ of prostate (disorder)	2	43878008	Streptococcal sore throat (disorder)	1095	23	523	11	12	512	560	1.00133	0.00019	1.00260	2.29210	0.43856	1.0000000000	1.0000000000	10.98539	0.00176	0	246	0	23	277	11	-3.26507	-1.12847
55	126906006	Neoplasm of prostate	2	43878008	Streptococcal sore throat (disorder)	1095	24	523	11	13	512	559	0.95961	-0.00578	0.92383	2.08052	0.41021	1.0000000000	1.0000000000	11.46301	-0.05462	0	246	0	24	277	11	-3.26507	-1.15745
54	5602001	Opioid abuse (disorder)	2	43878008	Streptococcal sore throat (disorder)	1095	7	523	3	4	520	568	0.89730	-0.00788	0.81923	3.67767	0.18249	1.0000000000	1.0000000000	3.34338	-0.11882	0	246	0	7	277	3	-4.53618	-1.20397
53	7200002	Alcoholism	2	43878008	Streptococcal sore throat (disorder)	1095	5	523	3	2	520	570	1.25621	0.01659	1.64423	9.87901	0.27366	0.6741781596	1.0000000000	2.38813	0.23951	0	246	0	5	277	3	-4.53618	-0.98083
52	124171000119105	Chronic intractable migraine without aura	2	43878008	Streptococcal sore throat (disorder)	1095	51	523	22	29	501	543	0.90316	-0.02047	0.82222	1.44997	0.46625	0.5666319003	1.0000000000	24.35890	-0.14086	21	246	12	30	277	10	-0.28884	-0.37469
51	403190006	First degree burn	2	43878008	Streptococcal sore throat (disorder)	1095	79	523	38	41	485	531	1.00709	0.00189	1.01473	1.60451	0.64174	1.0000000000	1.0000000000	37.73242	0.00993	43	246	19	36	277	19	-0.11063	0.11980
50	446096008	Perennial allergic rhinitis	2	43878008	Streptococcal sore throat (disorder)	1095	26	523	12	14	511	558	0.96632	-0.00502	0.93598	2.04249	0.42892	1.0000000000	1.0000000000	12.41826	-0.04569	14	246	7	12	277	5	-0.44499	-0.12516
49	88805009	Chronic congestive heart failure (disorder)	2	43878008	Streptococcal sore throat (disorder)	1095	10	523	6	4	517	568	1.25621	0.02352	1.64797	5.87258	0.46245	0.5324452446	1.0000000000	4.77626	0.27722	5	246	3	5	277	3	-0.11734	0.00000
48	55680006	Drug overdose	2	43878008	Streptococcal sore throat (disorder)	1095	50	523	24	26	499	546	1.00497	0.00104	1.01002	1.78229	0.57238	1.0000000000	1.0000000000	23.88128	0.00687	24	246	14	26	277	10	-0.43527	-0.28241
47	359817006	Closed fracture of hip	2	43878008	Streptococcal sore throat (disorder)	1095	29	523	17	12	506	560	1.22734	0.03585	1.56785	3.31481	0.74157	0.2618659647	0.9281913645	13.85114	0.27742	11	246	7	18	277	10	0.23058	-0.08516
46	62564004	Concussion with loss of consciousness	2	43878008	Streptococcal sore throat (disorder)	1095	67	523	38	29	485	543	1.18747	0.04576	1.46705	2.41524	0.89110	0.1323548500	0.7140816678	32.00091	0.24097	36	246	18	31	277	20	-0.01242	0.16252
45	263102004	Fracture subluxation of wrist	2	43878008	Streptococcal sore throat (disorder)	1095	109	523	59	50	464	522	1.13328	0.04237	1.32750	1.97439	0.89256	0.1888373695	0.8197895299	52.06119	0.17731	51	246	28	58	277	31	-0.01519	-0.01741
44	58150001	Fracture of clavicle	2	43878008	Streptococcal sore throat (disorder)	1095	112	523	66	46	457	526	1.23378	0.07546	1.65141	2.45566	1.11056	0.0162683323	0.2173568050	53.49406	0.29806	55	246	36	57	277	30	-0.26726	-0.13737
43	307731004	Injury of tendon of the rotator cuff of shoulder	2	43878008	Streptococcal sore throat (disorder)	1095	51	523	20	31	503	541	0.82105	-0.03782	0.69390	1.23326	0.39043	0.2510407786	0.9133257124	24.35890	-0.27210	26	246	7	25	277	13	0.48255	0.47796
42	16114001	Fracture of ankle	2	43878008	Streptococcal sore throat (disorder)	1095	108	523	54	54	469	518	1.04685	0.01482	1.10448	1.64332	0.74232	0.6850610343	1.0000000000	51.58356	0.06482	48	246	23	60	277	31	0.16310	0.05031
41	283385000	Laceration of thigh	2	43878008	Streptococcal sore throat (disorder)	1095	105	523	54	51	469	521	1.07675	0.02390	1.17622	1.75915	0.78646	0.4723525659	1.0000000000	50.15068	0.10468	50	246	25	55	277	29	0.02695	0.03509
40	428251008	History of appendectomy	2	43878008	Streptococcal sore throat (disorder)	1095	51	523	25	26	498	546	1.02632	0.00556	1.05422	1.84980	0.60081	0.8865508846	1.0000000000	24.35890	0.03602	27	246	13	24	277	12	-0.18964	0.02532
39	74400008	Appendicitis	2	43878008	Streptococcal sore throat (disorder)	1095	51	523	25	26	498	546	1.02632	0.00556	1.05422	1.84980	0.60081	0.8865508846	1.0000000000	24.35890	0.03602	27	246	13	24	277	12	-0.18964	0.02532
38	398254007	Preeclampsia	2	43878008	Streptococcal sore throat (disorder)	1095	101	523	53	48	470	524	1.09867	0.03007	1.23103	1.85474	0.81706	0.3473530571	1.0000000000	48.24018	0.13312	101	246	53	0	277	0	1.73015	1.06666
37	38822007	Cystitis	2	43878008	Streptococcal sore throat (disorder)	1095	71	523	33	38	490	534	0.97312	-0.00677	0.94640	1.53285	0.58432	0.9023624610	1.0000000000	33.91142	-0.03816	68	246	32	3	277	1	-3.46574	-0.24686
35	19169002	Miscarriage in first trimester	2	43878008	Streptococcal sore throat (disorder)	1095	174	523	93	81	430	491	1.11904	0.04948	1.31102	1.81412	0.94745	0.1157881199	0.6744446695	83.10685	0.16044	174	246	93	0	277	0	1.29340	1.05465
33	429007001	History of cardiac arrest (situation)	2	43878008	Streptococcal sore throat (disorder)	1095	42	523	20	22	503	550	0.99700	-0.00057	0.99404	1.84323	0.53607	1.0000000000	1.0000000000	20.06027	-0.00413	24	246	11	18	277	9	-0.30759	0.05884
32	410429000	Cardiac Arrest	2	43878008	Streptococcal sore throat (disorder)	1095	42	523	20	22	503	550	0.99700	-0.00057	0.99404	1.84323	0.53607	1.0000000000	1.0000000000	20.06027	-0.00413	24	246	11	18	277	9	-0.30759	0.05884
31	230690007	Stroke	2	43878008	Streptococcal sore throat (disorder)	1095	62	523	26	36	497	536	0.87800	-0.02858	0.77890	1.30880	0.46354	0.3623000121	1.0000000000	29.61279	-0.18117	32	246	13	30	277	13	-0.11305	0.04546
30	399211009	History of myocardial infarction (situation)	2	43878008	Streptococcal sore throat (disorder)	1095	31	523	16	15	507	557	1.08061	0.01316	1.17186	2.39456	0.57349	0.7173559707	1.0000000000	14.80639	0.10503	2	246	1	29	277	15	2.54068	0.02247
29	22298006	Myocardial Infarction	2	43878008	Streptococcal sore throat (disorder)	1095	31	523	16	15	507	557	1.08061	0.01316	1.17186	2.39456	0.57349	0.7173559707	1.0000000000	14.80639	0.10503	2	246	1	29	277	15	2.54068	0.02247
28	53741008	Coronary Heart Disease	2	43878008	Streptococcal sore throat (disorder)	1095	80	523	39	41	484	531	1.02067	0.00555	1.04359	1.64549	0.66186	0.9076329136	1.0000000000	38.21005	0.02878	24	246	14	56	277	25	0.43007	-0.17704
27	408512008	Body mass index 40+ - severely obese (finding)	2	43878008	Streptococcal sore throat (disorder)	1095	97	523	48	49	475	523	1.03605	0.01075	1.07858	1.63659	0.71083	0.7501228917	1.0000000000	46.32968	0.05004	67	246	31	30	277	17	-0.66034	0.13405
26	33737001	Fracture of rib	2	43878008	Streptococcal sore throat (disorder)	1095	54	523	30	24	493	548	1.16316	0.03553	1.38945	2.40917	0.80134	0.2650121941	0.9338727578	25.79178	0.21048	32	246	19	22	277	11	-0.62977	-0.11123
25	284551006	Laceration of foot	2	43878008	Streptococcal sore throat (disorder)	1095	118	523	57	61	466	511	1.01136	0.00377	1.02466	1.50175	0.69914	0.9225001163	1.0000000000	56.35982	0.01601	53	246	23	65	277	34	0.24578	0.12648
24	162864005	Body mass index 30+ - obesity (finding)	2	43878008	Streptococcal sore throat (disorder)	1095	439	523	217	222	306	350	1.03492	0.02732	1.11803	1.42406	0.87777	0.3876294979	1.0000000000	209.67763	0.04929	226	246	107	213	277	110	-0.06431	0.05814
23	36971009	Sinusitis (disorder)	2	43878008	Streptococcal sore throat (disorder)	1095	190	523	106	84	417	488	1.16806	0.07363	1.47676	2.02300	1.07801	0.0164949313	0.2190854429	90.74886	0.22185	84	246	44	106	277	62	0.18683	0.07101
22	70704007	Sprain of wrist	2	43878008	Streptococcal sore throat (disorder)	1095	195	523	104	91	419	481	1.11663	0.05191	1.31197	1.78936	0.96194	0.0967311242	0.6177968585	93.13699	0.15756	90	246	51	105	277	53	-0.06689	-0.07537
21	15777000	Prediabetes	2	43878008	Streptococcal sore throat (disorder)	1095	333	523	175	158	348	414	1.10029	0.06339	1.31766	1.70555	1.01798	0.0414228702	0.3887115745	159.04932	0.13706	159	246	80	174	277	95	0.03985	0.05360
20	80394007	Hyperglycemia (disorder)	2	43878008	Streptococcal sore throat (disorder)	1095	55	523	25	30	498	542	0.95168	-0.01063	0.90696	1.56341	0.52614	0.7825623857	1.0000000000	26.26941	-0.06877	23	246	7	32	277	18	0.79088	0.43364
19	237602007	Metabolic syndrome X (disorder)	2	43878008	Streptococcal sore throat (disorder)	1095	64	523	30	34	493	538	0.98142	-0.00443	0.96289	1.59698	0.58057	0.8981976937	1.0000000000	30.56804	-0.02620	28	246	9	36	277	21	0.69147	0.41516
18	302870006	Hypertriglyceridemia (disorder)	2	43878008	Streptococcal sore throat (disorder)	1095	64	523	30	34	493	538	0.98142	-0.00443	0.96289	1.59698	0.58057	0.8981976937	1.0000000000	30.56804	-0.02620	28	246	9	36	277	21	0.69147	0.41516
17	368581000119106	Neuropathy due to type 2 diabetes mellitus (disorder)	2	43878008	Streptococcal sore throat (disorder)	1095	28	523	17	11	506	561	1.27117	0.04200	1.71344	3.69277	0.79503	0.1830754554	0.8165835099	13.37352	0.32458	7	246	3	21	277	14	1.38457	0.28768
16	44054006	Diabetes	2	43878008	Streptococcal sore throat (disorder)	1095	68	523	33	35	490	537	1.01606	0.00395	1.03329	1.68848	0.63234	0.9010068295	1.0000000000	32.47854	0.02230	29	246	10	39	277	23	0.67430	0.36934
15	40055000	Chronic sinusitis (disorder)	2	43878008	Streptococcal sore throat (disorder)	1095	216	523	109	107	414	465	1.05654	0.02680	1.14418	1.54109	0.84950	0.4032080205	1.0000000000	103.16712	0.07860	104	246	50	112	277	59	0.03876	0.06080
14	10509002	Acute bronchitis (disorder)	2	43878008	Streptococcal sore throat (disorder)	1095	863	523	432	431	91	141	1.04806	0.08863	1.55305	2.08678	1.15582	0.0038394914	0.0733937795	412.19087	0.06756	418	246	202	445	277	230	0.00609	0.04482
13	370247008	Facial laceration	2	43878008	Streptococcal sore throat (disorder)	1095	109	523	50	59	473	513	0.96041	-0.01259	0.91912	1.36696	0.61801	0.6875050167	1.0000000000	52.06119	-0.05716	55	246	24	54	277	26	-0.03527	0.06746
12	65966004	Fracture of forearm	2	43878008	Streptococcal sore throat (disorder)	1095	123	523	65	58	458	514	1.10642	0.03620	1.25772	1.83135	0.86376	0.2507305213	0.9133257124	58.74795	0.14358	55	246	27	68	277	38	0.19865	0.08503
11	38341003	Hypertension	2	43878008	Streptococcal sore throat (disorder)	1095	278	523	152	126	371	446	1.14475	0.08074	1.45022	1.90614	1.10335	0.0082493693	0.1342392906	132.77991	0.19367	131	246	62	147	277	90	0.19741	0.16731
10	62106007	Concussion with no loss of consciousness	2	43878008	Streptococcal sore throat (disorder)	1095	206	523	103	103	420	469	1.04685	0.02156	1.11667	1.51217	0.82461	0.4868468282	1.0000000000	98.39087	0.06540	96	246	38	110	277	65	0.35096	0.26985
9	44465007	Sprain of ankle	2	43878008	Streptococcal sore throat (disorder)	1095	362	523	195	167	328	405	1.12782	0.08589	1.44178	1.85644	1.11974	0.0046886630	0.0864644610	172.90046	0.17259	185	246	92	177	277	103	-0.00418	0.10217
8	233678006	Childhood asthma	2	43878008	Streptococcal sore throat (disorder)	1095	45	523	24	21	499	551	1.11663	0.02309	1.26195	2.29494	0.69393	0.4511844383	1.0000000000	21.49315	0.15244	25	246	14	20	277	10	-0.43527	-0.07411
7	75498004	Acute bacterial sinusitis (disorder)	2	43878008	Streptococcal sore throat (disorder)	1095	187	523	86	101	437	471	0.96287	-0.01611	0.91773	1.25838	0.66930	0.6298372716	1.0000000000	89.31598	-0.05397	89	246	38	98	277	48	0.09876	0.09420
6	39848009	Whiplash injury to neck	2	43878008	Streptococcal sore throat (disorder)	1095	182	523	79	103	444	469	0.90880	-0.03894	0.81018	1.11635	0.58797	0.2228548125	0.8794911525	86.92785	-0.13632	92	246	31	90	277	48	0.27741	0.32214
5	284549007	Laceration of hand	2	43878008	Streptococcal sore throat (disorder)	1095	104	523	45	59	478	513	0.90592	-0.02914	0.81856	1.23026	0.54463	0.3543206840	1.0000000000	49.67306	-0.13959	54	246	28	50	277	17	-0.56944	-0.29696
4	195662009	Acute viral pharyngitis (disorder)	2	43878008	Streptococcal sore throat (disorder)	1095	890	523	450	440	73	132	1.05861	0.11677	1.84932	2.53310	1.35011	0.0001367197	0.0045877143	425.08676	0.08198	430	246	212	460	277	238	-0.00161	0.03205
3	65363002	Otitis media	2	43878008	Streptococcal sore throat (disorder)	1095	580	523	295	285	228	287	1.06489	0.06585	1.30294	1.65336	1.02679	0.0338525099	0.3419532016	277.02283	0.09039	277	246	139	303	277	156	-0.00211	0.01702
1	444814009	Viral sinusitis (disorder)	2	43878008	Streptococcal sore throat (disorder)	1095	993	523	497	496	26	76	1.04790	0.14291	2.92897	4.65063	1.84467	0.0000020132	0.0000987238	474.28219	0.06736	478	246	233	515	277	264	0.00319	0.03357
114	449868002	Smokes tobacco daily	77	422034002	Diabetic retinopathy associated with type II diabetes mellitus (disorder)	1095	9	20	0	9	20	1066	0.00000	-0.01242	0.00000	0.00000	0.00000	1.0000000000	1.0000000000	0.16438	-0.21957	2	8	0	7	12	0	0.00000	0.00000
114	449868002	Smokes tobacco daily	78	239872002	Osteoarthritis of hip	1095	9	21	0	9	21	1065	0.00000	-0.01273	0.00000	0.00000	0.00000	1.0000000000	1.0000000000	0.17260	-0.22971	2	13	0	7	8	0	0.00000	0.00000
117	230265002	Familial Alzheimer's disease of early onset (disorder)	62	185086009	Chronic obstructive bronchitis (disorder)	1095	6	6	0	6	6	1083	0.00000	-0.00551	0.00000	0.00000	0.00000	1.0000000000	1.0000000000	0.03288	-0.04667	2	4	0	4	2	0	0.00000	0.00000
118	48333001	Burn injury(morphologic abnormality)	62	185086009	Chronic obstructive bronchitis (disorder)	1095	1	6	0	1	6	1088	0.00000	-0.00224	0.00000	0.00000	0.00000	1.0000000000	1.0000000000	0.00548	-0.00788	0	4	0	1	2	0	0.00000	0.00000
120	162573006	Suspected lung cancer (situation)	62	185086009	Chronic obstructive bronchitis (disorder)	1095	8	6	0	8	6	1081	0.00000	-0.00637	0.00000	0.00000	0.00000	1.0000000000	1.0000000000	0.04384	-0.06189	0	4	0	8	2	0	0.00000	0.00000
121	254637007	Non-small cell lung cancer (disorder)	62	185086009	Chronic obstructive bronchitis (disorder)	1095	8	6	0	8	6	1081	0.00000	-0.00637	0.00000	0.00000	0.00000	1.0000000000	1.0000000000	0.04384	-0.06189	0	4	0	8	2	0	0.00000	0.00000
128	86849004	Suicidal deliberate poisoning	62	185086009	Chronic obstructive bronchitis (disorder)	1095	1	6	0	1	6	1088	0.00000	-0.00224	0.00000	0.00000	0.00000	1.0000000000	1.0000000000	0.00548	-0.00788	0	4	0	1	2	0	0.00000	0.00000
130	314994000	Metastasis from malignant tumor of prostate (disorder)	62	185086009	Chronic obstructive bronchitis (disorder)	1095	1	6	0	1	6	1088	0.00000	-0.00224	0.00000	0.00000	0.00000	1.0000000000	1.0000000000	0.00548	-0.00788	0	4	0	1	2	0	0.00000	0.00000
114	449868002	Smokes tobacco daily	79	45816000	Pyelonephritis	1095	9	1	0	9	1	1085	0.00000	-0.00275	0.00000	0.00000	0.00000	1.0000000000	1.0000000000	0.00822	-0.01181	2	1	0	7	0	0	0.00000	0.00000
130	314994000	Metastasis from malignant tumor of prostate (disorder)	8	233678006	Childhood asthma	1095	1	45	0	1	45	1049	0.00000	-0.00626	0.00000	0.00000	0.00000	1.0000000000	1.0000000000	0.04110	-0.05810	0	25	0	1	20	0	0.00000	0.00000
118	48333001	Burn injury(morphologic abnormality)	80	6072007	Bleeding from anus	1095	1	4	0	1	4	1090	0.00000	-0.00183	0.00000	0.00000	0.00000	1.0000000000	1.0000000000	0.00365	-0.00526	0	2	0	1	2	0	0.00000	0.00000
117	230265002	Familial Alzheimer's disease of early onset (disorder)	34	72892002	Normal pregnancy	1095	6	384	2	4	382	707	0.95052	-0.00270	0.92539	5.07537	0.16873	1.0000000000	1.0000000000	2.10411	-0.04922	2	384	2	4	0	0	5.26269	0.69315
130	314994000	Metastasis from malignant tumor of prostate (disorder)	115	36923009	Major depression  single episode	1095	1	6	0	1	6	1088	0.00000	-0.00224	0.00000	0.00000	0.00000	1.0000000000	1.0000000000	0.00548	-0.00788	0	3	0	1	3	0	0.00000	0.00000
129	47505003	Posttraumatic stress disorder	115	36923009	Major depression  single episode	1095	4	6	0	4	6	1085	0.00000	-0.00449	0.00000	0.00000	0.00000	1.0000000000	1.0000000000	0.02192	-0.03128	1	3	0	3	3	0	0.00000	0.00000
114	449868002	Smokes tobacco daily	81	236077008	Protracted diarrhea	1095	9	4	0	9	4	1082	0.00000	-0.00551	0.00000	0.00000	0.00000	1.0000000000	1.0000000000	0.03288	-0.04667	2	2	0	7	2	0	0.00000	0.00000
118	48333001	Burn injury(morphologic abnormality)	115	36923009	Major depression  single episode	1095	1	6	0	1	6	1088	0.00000	-0.00224	0.00000	0.00000	0.00000	1.0000000000	1.0000000000	0.00548	-0.00788	0	3	0	1	3	0	0.00000	0.00000
117	230265002	Familial Alzheimer's disease of early onset (disorder)	115	36923009	Major depression  single episode	1095	6	6	0	6	6	1083	0.00000	-0.00551	0.00000	0.00000	0.00000	1.0000000000	1.0000000000	0.03288	-0.04667	2	3	0	4	3	0	0.00000	0.00000
109	90560007	Gout	115	36923009	Major depression  single episode	1095	4	6	0	4	6	1085	0.00000	-0.00449	0.00000	0.00000	0.00000	1.0000000000	1.0000000000	0.02192	-0.03128	0	3	0	4	3	0	0.00000	0.00000
106	24079001	Atopic dermatitis	115	36923009	Major depression  single episode	1095	20	6	0	20	6	1069	0.00000	-0.01012	0.00000	0.00000	0.00000	1.0000000000	1.0000000000	0.10959	-0.15003	13	3	0	7	3	0	0.00000	0.00000
102	90781000119102	Microalbuminuria due to type 2 diabetes mellitus (disorder)	115	36923009	Major depression  single episode	1095	6	6	0	6	6	1083	0.00000	-0.00551	0.00000	0.00000	0.00000	1.0000000000	1.0000000000	0.03288	-0.04667	3	3	0	3	3	0	0.00000	0.00000
98	1551000119108	Nonproliferative diabetic retinopathy due to type 2 diabetes mellitus (disorder)	115	36923009	Major depression  single episode	1095	12	6	0	12	6	1077	0.00000	-0.00781	0.00000	0.00000	0.00000	1.0000000000	1.0000000000	0.06575	-0.09187	7	3	0	5	3	0	0.00000	0.00000
97	403192003	Third degree burn	115	36923009	Major depression  single episode	1095	8	6	0	8	6	1081	0.00000	-0.00637	0.00000	0.00000	0.00000	1.0000000000	1.0000000000	0.04384	-0.06189	3	3	0	5	3	0	0.00000	0.00000
96	283371005	Laceration of forearm	115	36923009	Major depression  single episode	1095	75	6	2	73	4	1016	4.86667	0.07783	6.95890	38.62644	1.25371	0.0580042805	0.4685406893	0.41096	1.08829	39	3	2	36	3	0	0.91629	3.02042
94	703151001	History of single seizure (situation)	115	36923009	Major depression  single episode	1095	39	6	0	39	6	1050	0.00000	-0.01426	0.00000	0.00000	0.00000	1.0000000000	1.0000000000	0.21370	-0.27941	14	3	0	25	3	0	0.00000	0.00000
93	128613002	Seizure disorder	115	36923009	Major depression  single episode	1095	39	6	0	39	6	1050	0.00000	-0.01426	0.00000	0.00000	0.00000	1.0000000000	1.0000000000	0.21370	-0.27941	14	3	0	25	3	0	0.00000	0.00000
89	47693006	Rupture of appendix	115	36923009	Major depression  single episode	1095	20	6	0	20	6	1069	0.00000	-0.01012	0.00000	0.00000	0.00000	1.0000000000	1.0000000000	0.10959	-0.15003	10	3	0	10	3	0	0.00000	0.00000
86	713197008	Recurrent rectal polyp	115	36923009	Major depression  single episode	1095	22	6	0	22	6	1067	0.00000	-0.01063	0.00000	0.00000	0.00000	1.0000000000	1.0000000000	0.12055	-0.16420	12	3	0	10	3	0	0.00000	0.00000
82	94260004	Secondary malignant neoplasm of colon	115	36923009	Major depression  single episode	1095	4	6	0	4	6	1085	0.00000	-0.00449	0.00000	0.00000	0.00000	1.0000000000	1.0000000000	0.02192	-0.03128	2	3	0	2	3	0	0.00000	0.00000
76	127013003	Diabetic renal disease (disorder)	115	36923009	Major depression  single episode	1095	28	6	1	27	5	1062	6.51786	0.06635	7.86667	69.64292	0.88860	0.1442534615	0.7404942507	0.15342	0.79408	10	3	0	18	3	1	-1.38629	-2.94444
75	431855005	Chronic kidney disease stage 1 (disorder)	115	36923009	Major depression  single episode	1095	28	6	1	27	5	1062	6.51786	0.06635	7.86667	69.64292	0.88860	0.1442534615	0.7404942507	0.15342	0.79408	10	3	0	18	3	1	-1.38629	-2.94444
72	35999006	Blighted ovum	115	36923009	Major depression  single episode	1095	53	6	1	52	5	1037	3.44340	0.04090	3.98846	34.75878	0.45766	0.2579759950	0.9227845495	0.29041	0.63217	53	3	1	0	3	0	1.38629	3.98898
69	233604007	Pneumonia	115	36923009	Major depression  single episode	1095	7	6	0	7	6	1082	0.00000	-0.00595	0.00000	0.00000	0.00000	1.0000000000	1.0000000000	0.03836	-0.05430	3	3	0	4	3	0	0.00000	0.00000
67	403191005	Second degree burn	115	36923009	Major depression  single episode	1095	49	6	1	48	5	1041	3.72449	0.04377	4.33750	37.85423	0.49701	0.2406784239	0.9095097439	0.26849	0.65688	23	3	1	26	3	0	1.38629	3.17805
64	444448004	Injury of medial collateral ligament of knee	115	36923009	Major depression  single episode	1095	32	6	0	32	6	1057	0.00000	-0.01288	0.00000	0.00000	0.00000	1.0000000000	1.0000000000	0.17534	-0.23308	17	3	0	15	3	0	0.00000	0.00000
63	68496003	Polyp of colon	115	36923009	Major depression  single episode	1095	91	6	0	91	6	998	0.00000	-0.02235	0.00000	0.00000	0.00000	1.0000000000	1.0000000000	0.49863	-0.58364	43	3	0	48	3	0	0.00000	0.00000
58	239720000	Tear of meniscus of knee	115	36923009	Major depression  single episode	1095	20	6	0	20	6	1069	0.00000	-0.01012	0.00000	0.00000	0.00000	1.0000000000	1.0000000000	0.10959	-0.15003	10	3	0	10	3	0	0.00000	0.00000
57	192127007	Child attention deficit disorder	115	36923009	Major depression  single episode	1095	76	6	1	75	5	1014	2.40132	0.02841	2.70400	23.44225	0.31190	0.3511935927	1.0000000000	0.41644	0.49773	24	3	0	52	3	1	-1.38629	-3.97029
54	5602001	Opioid abuse (disorder)	115	36923009	Major depression  single episode	1095	7	6	0	7	6	1082	0.00000	-0.00595	0.00000	0.00000	0.00000	1.0000000000	1.0000000000	0.03836	-0.05430	0	3	0	7	3	0	0.00000	0.00000
50	446096008	Perennial allergic rhinitis	115	36923009	Major depression  single episode	1095	26	6	0	26	6	1063	0.00000	-0.01158	0.00000	0.00000	0.00000	1.0000000000	1.0000000000	0.14247	-0.19215	14	3	0	12	3	0	0.00000	0.00000
49	88805009	Chronic congestive heart failure (disorder)	115	36923009	Major depression  single episode	1095	10	6	0	10	6	1079	0.00000	-0.00713	0.00000	0.00000	0.00000	1.0000000000	1.0000000000	0.05479	-0.07696	5	3	0	5	3	0	0.00000	0.00000
47	359817006	Closed fracture of hip	115	36923009	Major depression  single episode	1095	29	6	0	29	6	1060	0.00000	-0.01224	0.00000	0.00000	0.00000	1.0000000000	1.0000000000	0.15890	-0.21276	11	3	0	18	3	0	0.00000	0.00000
44	58150001	Fracture of clavicle	115	36923009	Major depression  single episode	1095	112	6	1	111	5	978	1.62946	0.01577	1.76216	15.21882	0.20404	0.4774159561	1.0000000000	0.61370	0.30963	55	3	1	57	3	0	1.38629	4.02535
43	307731004	Injury of tendon of the rotator cuff of shoulder	115	36923009	Major depression  single episode	1095	51	6	0	51	6	1038	0.00000	-0.01641	0.00000	0.00000	0.00000	1.0000000000	1.0000000000	0.27945	-0.35553	26	3	0	25	3	0	0.00000	0.00000
42	16114001	Fracture of ankle	115	36923009	Major depression  single episode	1095	108	6	1	107	5	982	1.68981	0.01694	1.83551	15.85701	0.21247	0.4644932960	1.0000000000	0.59178	0.32936	48	3	1	60	3	0	1.38629	3.89182
41	283385000	Laceration of thigh	115	36923009	Major depression  single episode	1095	105	6	1	104	5	985	1.73810	0.01784	1.89423	16.36815	0.21921	0.4546274954	1.0000000000	0.57534	0.34433	50	3	1	55	3	0	1.38629	3.93183
39	74400008	Appendicitis	115	36923009	Major depression  single episode	1095	51	6	0	51	6	1038	0.00000	-0.01641	0.00000	0.00000	0.00000	1.0000000000	1.0000000000	0.27945	-0.35553	27	3	0	24	3	0	0.00000	0.00000
38	398254007	Preeclampsia	115	36923009	Major depression  single episode	1095	101	6	0	101	6	988	0.00000	-0.02366	0.00000	0.00000	0.00000	1.0000000000	1.0000000000	0.55342	-0.63545	101	3	0	0	3	0	0.00000	0.00000
35	19169002	Miscarriage in first trimester	115	36923009	Major depression  single episode	1095	174	6	1	173	5	916	1.04885	0.00158	1.05896	9.11992	0.12296	1.0000000000	1.0000000000	0.95342	0.03399	174	3	1	0	3	0	1.38629	5.16479
33	429007001	History of cardiac arrest (situation)	115	36923009	Major depression  single episode	1095	42	6	0	42	6	1047	0.00000	-0.01482	0.00000	0.00000	0.00000	1.0000000000	1.0000000000	0.23014	-0.29882	24	3	0	18	3	0	0.00000	0.00000
32	410429000	Cardiac Arrest	115	36923009	Major depression  single episode	1095	42	6	0	42	6	1047	0.00000	-0.01482	0.00000	0.00000	0.00000	1.0000000000	1.0000000000	0.23014	-0.29882	24	3	0	18	3	0	0.00000	0.00000
30	399211009	History of myocardial infarction (situation)	115	36923009	Major depression  single episode	1095	31	6	1	30	5	1059	5.88710	0.06192	7.06000	62.29801	0.80008	0.1586220457	0.7768414475	0.16986	0.77366	2	3	0	29	3	1	-1.38629	-3.40120
27	408512008	Body mass index 40+ - severely obese (finding)	115	36923009	Major depression  single episode	1095	97	6	0	97	6	992	0.00000	-0.02314	0.00000	0.00000	0.00000	1.0000000000	1.0000000000	0.53151	-0.61495	67	3	0	30	3	0	0.00000	0.00000
24	162864005	Body mass index 30+ - obesity (finding)	115	36923009	Major depression  single episode	1095	439	6	2	437	4	652	0.83144	-0.01024	0.74600	4.09049	0.13605	1.0000000000	1.0000000000	2.40548	-0.18290	226	3	1	213	3	1	0.00000	0.05897
23	36971009	Sinusitis (disorder)	115	36923009	Major depression  single episode	1095	190	6	1	189	5	900	0.96053	-0.00134	0.95238	8.19861	0.11063	1.0000000000	1.0000000000	1.04110	-0.02934	84	3	1	106	3	0	1.38629	4.44265
21	15777000	Prediabetes	115	36923009	Major depression  single episode	1095	333	6	1	332	5	757	0.54805	-0.02218	0.45602	3.91846	0.05307	0.6737555874	1.0000000000	1.82466	-0.49808	159	3	1	174	3	0	1.38629	5.07517
20	80394007	Hyperglycemia (disorder)	115	36923009	Major depression  single episode	1095	55	6	0	55	6	1034	0.00000	-0.01707	0.00000	0.00000	0.00000	1.0000000000	1.0000000000	0.30137	-0.38003	23	3	0	32	3	0	0.00000	0.00000
18	302870006	Hypertriglyceridemia (disorder)	115	36923009	Major depression  single episode	1095	64	6	1	63	5	1026	2.85156	0.03424	3.25714	28.30123	0.37486	0.3038598319	0.9949586182	0.35068	0.56631	28	3	0	36	3	1	-1.38629	-3.61092
17	368581000119106	Neuropathy due to type 2 diabetes mellitus (disorder)	115	36923009	Major depression  single episode	1095	28	6	0	28	6	1061	0.00000	-0.01202	0.00000	0.00000	0.00000	1.0000000000	1.0000000000	0.15342	-0.20592	7	3	0	21	3	0	0.00000	0.00000
15	40055000	Chronic sinusitis (disorder)	115	36923009	Major depression  single episode	1095	216	6	1	215	5	874	0.84491	-0.00571	0.81302	6.99516	0.09449	1.0000000000	1.0000000000	1.18356	-0.12668	104	3	1	112	3	0	1.38629	4.65396
14	10509002	Acute bronchitis (disorder)	115	36923009	Major depression  single episode	1095	863	6	6	857	0	232	1.26883	0.03849	0.00000	0.00000	0.00000	0.3522028398	1.0000000000	4.72877	0.28913	418	3	3	445	3	3	0.00000	-0.06216
13	370247008	Facial laceration	115	36923009	Major depression  single episode	1095	109	6	0	109	6	980	0.00000	-0.02468	0.00000	0.00000	0.00000	1.0000000000	1.0000000000	0.59726	-0.67560	55	3	0	54	3	0	0.00000	0.00000
125	1734006	Fracture of the vertebral column with spinal cord injury	89	47693006	Rupture of appendix	1095	5	20	1	4	19	1071	10.95000	0.09192	14.09211	132.07666	1.50358	0.0882038970	0.5878920335	0.09132	0.87392	3	10	1	2	10	0	2.39790	1.38629
10	62106007	Concussion with no loss of consciousness	115	36923009	Major depression  single episode	1095	206	6	1	205	5	884	0.88592	-0.00408	0.86244	7.42174	0.10022	1.0000000000	1.0000000000	1.12877	-0.09002	96	3	0	110	3	1	-1.38629	-4.70953
7	75498004	Acute bacterial sinusitis (disorder)	115	36923009	Major depression  single episode	1095	187	6	0	187	6	902	0.00000	-0.03369	0.00000	0.00000	0.00000	0.5971849300	1.0000000000	1.02466	-1.01768	89	3	0	98	3	0	0.00000	0.00000
6	39848009	Whiplash injury to neck	115	36923009	Major depression  single episode	1095	182	6	2	180	4	909	2.00549	0.03332	2.52500	13.88955	0.45902	0.2619364224	0.9281913645	0.99726	0.58694	92	3	0	90	3	2	-0.91629	-3.82864
5	284549007	Laceration of hand	115	36923009	Major depression  single episode	1095	104	6	2	102	4	987	3.50962	0.06035	4.83824	26.73911	0.87544	0.1040585611	0.6338834486	0.56986	0.93432	54	3	0	50	3	2	-0.91629	-3.25810
117	230265002	Familial Alzheimer's disease of early onset (disorder)	89	47693006	Rupture of appendix	1095	6	20	0	6	20	1069	0.00000	-0.01012	0.00000	0.00000	0.00000	1.0000000000	1.0000000000	0.10959	-0.15003	2	10	0	4	10	0	0.00000	0.00000
109	90560007	Gout	89	47693006	Rupture of appendix	1095	4	20	0	4	20	1071	0.00000	-0.00826	0.00000	0.00000	0.00000	1.0000000000	1.0000000000	0.07306	-0.10173	0	10	0	4	10	0	0.00000	0.00000
97	403192003	Third degree burn	89	47693006	Rupture of appendix	1095	8	20	0	8	20	1067	0.00000	-0.01170	0.00000	0.00000	0.00000	1.0000000000	1.0000000000	0.14612	-0.19676	3	10	0	5	10	0	0.00000	0.00000
96	283371005	Laceration of forearm	89	47693006	Rupture of appendix	1095	75	20	1	74	19	1001	0.73000	-0.00999	0.71195	5.39217	0.09400	1.0000000000	1.0000000000	1.36986	-0.24480	39	10	0	36	10	1	-2.39790	-3.61092
94	703151001	History of single seizure (situation)	89	47693006	Rupture of appendix	1095	39	20	0	39	20	1036	0.00000	-0.02621	0.00000	0.00000	0.00000	1.0000000000	1.0000000000	0.71233	-0.77596	14	10	0	25	10	0	0.00000	0.00000
93	128613002	Seizure disorder	89	47693006	Rupture of appendix	1095	39	20	0	39	20	1036	0.00000	-0.02621	0.00000	0.00000	0.00000	1.0000000000	1.0000000000	0.71233	-0.77596	14	10	0	25	10	0	0.00000	0.00000
86	713197008	Recurrent rectal polyp	89	47693006	Rupture of appendix	1095	22	20	1	21	19	1054	2.48864	0.02907	2.64160	20.65870	0.33778	0.3360303840	1.0000000000	0.40183	0.51269	12	10	0	10	10	1	-2.39790	-2.39790
127	431856006	Chronic kidney disease stage 2 (disorder)	83	110030002	Concussion injury of brain	1095	5	7	0	5	7	1083	0.00000	-0.00543	0.00000	0.00000	0.00000	1.0000000000	1.0000000000	0.03196	-0.04539	3	1	0	2	6	0	0.00000	0.00000
75	431855005	Chronic kidney disease stage 1 (disorder)	89	47693006	Rupture of appendix	1095	28	20	0	28	20	1047	0.00000	-0.02210	0.00000	0.00000	0.00000	1.0000000000	1.0000000000	0.51142	-0.59590	10	10	0	18	10	0	0.00000	0.00000
69	233604007	Pneumonia	89	47693006	Rupture of appendix	1095	7	20	0	7	20	1068	0.00000	-0.01094	0.00000	0.00000	0.00000	1.0000000000	1.0000000000	0.12785	-0.17358	3	10	0	4	10	0	0.00000	0.00000
64	444448004	Injury of medial collateral ligament of knee	89	47693006	Rupture of appendix	1095	32	20	1	31	19	1044	1.71094	0.01682	1.77250	13.66383	0.22993	0.4503494275	1.0000000000	0.58447	0.33600	17	10	1	15	10	0	2.39790	2.89037
49	88805009	Chronic congestive heart failure (disorder)	89	47693006	Rupture of appendix	1095	10	20	1	9	19	1066	5.47500	0.05860	6.23392	51.68709	0.75187	0.1689838786	0.7953568293	0.18265	0.75798	5	10	0	5	10	1	-2.39790	-1.79176
47	359817006	Closed fracture of hip	89	47693006	Rupture of appendix	1095	29	20	0	29	20	1046	0.00000	-0.02250	0.00000	0.00000	0.00000	1.0000000000	1.0000000000	0.52968	-0.61323	11	10	0	18	10	0	0.00000	0.00000
44	58150001	Fracture of clavicle	89	47693006	Rupture of appendix	1095	112	20	1	111	19	964	0.48884	-0.02353	0.45709	3.44726	0.06061	0.7124038989	1.0000000000	2.04566	-0.60676	55	10	1	57	10	0	2.39790	4.02535
43	307731004	Injury of tendon of the rotator cuff of shoulder	89	47693006	Rupture of appendix	1095	51	20	1	50	19	1025	1.07353	0.00222	1.07895	8.22193	0.14159	0.6180548828	1.0000000000	0.93151	0.05027	26	10	1	25	10	0	2.39790	3.29584
42	16114001	Fracture of ankle	89	47693006	Rupture of appendix	1095	108	20	0	108	20	967	0.00000	-0.04512	0.00000	0.00000	0.00000	0.2491789032	0.9133257124	1.97260	-1.57173	48	10	0	60	10	0	0.00000	0.00000
41	283385000	Laceration of thigh	89	47693006	Rupture of appendix	1095	105	20	5	100	15	975	2.60714	0.07139	3.25000	9.12930	1.15699	0.0354835702	0.3555648164	1.91781	1.04008	50	10	1	55	10	4	1.14513	1.24058
39	74400008	Appendicitis	89	47693006	Rupture of appendix	1095	51	20	20	31	0	1044	21.47059	0.61713	0.00000	0.00000	0.00000	0.0000000000	0.0000000000	0.93151	3.44259	27	10	10	24	10	10	0.00000	0.08456
38	398254007	Preeclampsia	89	47693006	Rupture of appendix	1095	101	20	1	100	19	975	0.54208	-0.01991	0.51316	3.87372	0.06798	1.0000000000	1.0000000000	1.84475	-0.50830	101	10	1	0	10	0	2.39790	4.62497
35	19169002	Miscarriage in first trimester	89	47693006	Rupture of appendix	1095	174	20	4	170	16	905	1.25862	0.01533	1.33088	4.02964	0.43955	0.5432513908	1.0000000000	3.17808	0.25909	174	10	4	0	10	0	1.25276	3.79549
33	429007001	History of cardiac arrest (situation)	89	47693006	Rupture of appendix	1095	42	20	2	40	18	1035	2.60714	0.04378	2.87500	12.81576	0.64496	0.1768262823	0.8029498763	0.76712	0.76356	24	10	1	18	10	1	0.00000	0.27444
32	410429000	Cardiac Arrest	89	47693006	Rupture of appendix	1095	42	20	2	40	18	1035	2.60714	0.04378	2.87500	12.81576	0.64496	0.1768262823	0.8029498763	0.76712	0.76356	24	10	1	18	10	1	0.00000	0.27444
27	408512008	Body mass index 40+ - severely obese (finding)	89	47693006	Rupture of appendix	1095	97	20	4	93	16	982	2.25773	0.05348	2.63978	8.05906	0.86468	0.0930990138	0.6037151703	1.77169	0.85116	67	10	3	30	10	1	-0.93156	-0.28410
21	15777000	Prediabetes	89	47693006	Rupture of appendix	1095	333	20	7	326	13	749	1.15090	0.01361	1.23714	3.12929	0.48909	0.6304850837	1.0000000000	6.08219	0.17580	159	10	1	174	10	6	1.41707	1.67398
130	314994000	Metastasis from malignant tumor of prostate (disorder)	63	68496003	Polyp of colon	1095	1	91	0	1	91	1003	0.00000	-0.00910	0.00000	0.00000	0.00000	1.0000000000	1.0000000000	0.08311	-0.11517	0	43	0	1	48	0	0.00000	0.00000
15	40055000	Chronic sinusitis (disorder)	89	47693006	Rupture of appendix	1095	216	20	5	211	15	864	1.26736	0.01808	1.36493	3.79754	0.49059	0.5700068331	1.0000000000	3.94521	0.27893	104	10	2	112	10	3	0.32542	0.32397
14	10509002	Acute bronchitis (disorder)	89	47693006	Rupture of appendix	1095	863	20	17	846	3	229	1.07851	0.02065	1.53388	5.27952	0.44565	0.7817760539	1.0000000000	15.76256	0.10275	418	10	9	445	10	8	-0.06372	-0.17689
125	1734006	Fracture of the vertebral column with spinal cord injury	63	68496003	Polyp of colon	1095	5	91	0	5	91	999	0.00000	-0.02039	0.00000	0.00000	0.00000	1.0000000000	1.0000000000	0.41553	-0.50134	3	43	0	2	48	0	0.00000	0.00000
118	48333001	Burn injury(morphologic abnormality)	26	33737001	Fracture of rib	1095	1	54	0	1	54	1040	0.00000	-0.00689	0.00000	0.00000	0.00000	1.0000000000	1.0000000000	0.04932	-0.06945	0	32	0	1	22	0	0.00000	0.00000
118	48333001	Burn injury(morphologic abnormality)	63	68496003	Polyp of colon	1095	1	91	0	1	91	1003	0.00000	-0.00910	0.00000	0.00000	0.00000	1.0000000000	1.0000000000	0.08311	-0.11517	0	43	0	1	48	0	0.00000	0.00000
114	449868002	Smokes tobacco daily	84	232353008	Perennial allergic rhinitis with seasonal variation	1095	9	29	0	9	29	1057	0.00000	-0.01502	0.00000	0.00000	0.00000	1.0000000000	1.0000000000	0.23836	-0.30843	2	14	0	7	15	0	0.00000	0.00000
109	90560007	Gout	63	68496003	Polyp of colon	1095	4	91	0	4	91	1000	0.00000	-0.01823	0.00000	0.00000	0.00000	1.0000000000	1.0000000000	0.33242	-0.41405	0	43	0	4	48	0	0.00000	0.00000
102	90781000119102	Microalbuminuria due to type 2 diabetes mellitus (disorder)	63	68496003	Polyp of colon	1095	6	91	2	4	89	1000	4.01099	0.06729	5.61798	31.09797	1.01491	0.0822182055	0.5656045519	0.49863	1.00132	3	43	1	3	48	1	-0.10763	0.00000
127	431856006	Chronic kidney disease stage 2 (disorder)	26	33737001	Fracture of rib	1095	5	54	0	5	54	1036	0.00000	-0.01543	0.00000	0.00000	0.00000	1.0000000000	1.0000000000	0.24658	-0.31797	3	32	0	2	22	0	0.00000	0.00000
128	86849004	Suicidal deliberate poisoning	26	33737001	Fracture of rib	1095	1	54	0	1	54	1040	0.00000	-0.00689	0.00000	0.00000	0.00000	1.0000000000	1.0000000000	0.04932	-0.06945	0	32	0	1	22	0	0.00000	0.00000
97	403192003	Third degree burn	63	68496003	Polyp of colon	1095	8	91	2	6	89	998	3.00824	0.05187	3.73783	18.79201	0.74347	0.1377378779	0.7296699408	0.66484	0.84958	3	43	1	5	48	1	-0.10763	-0.40547
96	283371005	Laceration of forearm	63	68496003	Polyp of colon	1095	75	91	9	66	82	938	1.44396	0.03624	1.55987	3.24367	0.75013	0.2736669922	0.9491303271	6.23288	0.46736	39	43	5	36	48	4	-0.30319	-0.12783
94	703151001	History of single seizure (situation)	63	68496003	Polyp of colon	1095	39	91	7	32	84	972	2.15976	0.06710	2.53125	5.90833	1.08444	0.0368534441	0.3602444677	3.24110	0.91556	14	43	3	25	48	4	0.16508	-0.24640
93	128613002	Seizure disorder	63	68496003	Polyp of colon	1095	39	91	7	32	84	972	2.15976	0.06710	2.53125	5.90833	1.08444	0.0368534441	0.3602444677	3.24110	0.91556	14	43	3	25	48	4	0.16508	-0.24640
89	47693006	Rupture of appendix	63	68496003	Polyp of colon	1095	20	91	2	18	89	986	1.20330	0.00835	1.23096	5.39076	0.28109	0.6792911859	1.0000000000	1.66210	0.17240	10	43	1	10	48	1	-0.10763	0.00000
86	713197008	Recurrent rectal polyp	63	68496003	Polyp of colon	1095	22	91	22	0	69	1004	12.03297	0.47562	0.00000	0.00000	0.00000	0.0000000000	0.0000000000	1.82831	3.02362	12	43	12	10	48	10	-0.23543	0.00000
75	431855005	Chronic kidney disease stage 1 (disorder)	63	68496003	Polyp of colon	1095	28	91	5	23	86	981	2.14874	0.05602	2.47978	6.68646	0.91966	0.0755592281	0.5414358400	2.32694	0.85077	10	43	1	18	48	4	1.21924	0.69315
69	233604007	Pneumonia	63	68496003	Polyp of colon	1095	7	91	2	5	89	999	3.43799	0.05887	4.48989	23.47472	0.85876	0.1090233546	0.6492584851	0.58174	0.92345	3	43	1	4	48	1	-0.10763	-0.22314
64	444448004	Injury of medial collateral ligament of knee	63	68496003	Polyp of colon	1095	32	91	5	27	86	977	1.88015	0.04597	2.10379	5.60194	0.79007	0.1790393200	0.8071942222	2.65936	0.71337	17	43	3	15	48	2	-0.48885	-0.24295
49	88805009	Chronic congestive heart failure (disorder)	63	68496003	Polyp of colon	1095	10	91	5	5	86	999	6.01648	0.14499	11.61628	40.91167	3.29828	0.0006422186	0.0174532338	0.83105	1.71229	5	43	3	5	48	2	-0.48885	-0.27193
47	359817006	Closed fracture of hip	63	68496003	Polyp of colon	1095	29	91	3	26	88	978	1.24479	0.01216	1.28234	4.32115	0.38055	0.7278122794	1.0000000000	2.41005	0.23021	11	43	1	18	48	2	0.56531	0.18232
44	58150001	Fracture of clavicle	63	68496003	Polyp of colon	1095	112	91	14	98	77	906	1.50412	0.05123	1.68089	3.08244	0.91661	0.1024139808	0.6291042150	9.30776	0.54123	55	43	5	57	48	9	0.41594	0.49248
43	307731004	Injury of tendon of the rotator cuff of shoulder	63	68496003	Polyp of colon	1095	51	91	7	44	84	960	1.65158	0.04336	1.81818	4.16193	0.79429	0.1857778174	0.8181443419	4.23836	0.61089	26	43	4	25	48	3	-0.36936	-0.21869
42	16114001	Fracture of ankle	63	68496003	Polyp of colon	1095	108	91	15	93	76	911	1.67125	0.06685	1.93336	3.49977	1.06804	0.0408255830	0.3862498006	8.97534	0.68163	48	43	5	60	48	10	0.50391	0.41494
41	283385000	Laceration of thigh	63	68496003	Polyp of colon	1095	105	91	13	92	78	912	1.48980	0.04802	1.65217	3.08689	0.88428	0.1338864426	0.7192732770	8.72603	0.52550	50	43	3	55	48	10	0.97217	0.99988
39	74400008	Appendicitis	63	68496003	Polyp of colon	1095	51	91	9	42	82	962	2.12346	0.07476	2.51394	5.34552	1.18228	0.0313855403	0.3268117118	4.23836	0.93281	27	43	4	24	48	5	0.10300	0.28983
38	398254007	Preeclampsia	63	68496003	Polyp of colon	1095	101	91	10	91	81	913	1.19138	0.01837	1.23864	2.47288	0.62042	0.5687037207	1.0000000000	8.39361	0.22775	101	43	10	0	48	0	1.66771	2.40695
35	19169002	Miscarriage in first trimester	63	68496003	Polyp of colon	1095	174	91	26	148	65	856	1.79803	0.10443	2.31351	3.76555	1.42140	0.0013980358	0.0322098635	14.46027	0.80439	174	43	26	0	48	0	0.97601	2.04022
33	429007001	History of cardiac arrest (situation)	63	68496003	Polyp of colon	1095	42	91	4	38	87	966	1.14600	0.00878	1.16878	3.35125	0.40763	0.7730061592	1.0000000000	3.49041	0.15508	24	43	2	18	48	2	-0.10536	0.26236
32	410429000	Cardiac Arrest	63	68496003	Polyp of colon	1095	42	91	4	38	87	966	1.14600	0.00878	1.16878	3.35125	0.40763	0.7730061592	1.0000000000	3.49041	0.15508	24	43	2	18	48	2	-0.10536	0.26236
27	408512008	Body mass index 40+ - severely obese (finding)	63	68496003	Polyp of colon	1095	97	91	15	82	76	922	1.86077	0.08079	2.21919	4.03573	1.22030	0.0118835177	0.1721476562	8.06119	0.82030	67	43	9	30	48	6	-0.44321	0.34175
21	15777000	Prediabetes	63	68496003	Polyp of colon	1095	333	91	51	282	40	722	1.84289	0.16775	3.26436	5.04956	2.11029	0.0000001483	0.0000084509	27.67397	0.85877	159	43	24	174	48	27	0.00499	0.02396
20	80394007	Hyperglycemia (disorder)	63	68496003	Polyp of colon	1095	55	91	6	49	85	955	1.31269	0.02165	1.37575	3.30446	0.57277	0.4504191085	1.0000000000	4.57078	0.32948	23	43	1	32	48	5	1.42334	1.17657
18	302870006	Hypertriglyceridemia (disorder)	63	68496003	Polyp of colon	1095	64	91	6	58	85	946	1.12809	0.00961	1.15132	2.74625	0.48267	0.6458562072	1.0000000000	5.31872	0.14772	28	43	1	36	48	5	1.42334	1.26316
130	314994000	Metastasis from malignant tumor of prostate (disorder)	37	38822007	Cystitis	1095	1	71	0	1	71	1023	0.00000	-0.00796	0.00000	0.00000	0.00000	1.0000000000	1.0000000000	0.06484	-0.09064	0	68	0	1	3	0	0.00000	0.00000
129	47505003	Posttraumatic stress disorder	37	38822007	Cystitis	1095	4	71	0	4	71	1020	0.00000	-0.01594	0.00000	0.00000	0.00000	1.0000000000	1.0000000000	0.25936	-0.33269	1	68	0	3	3	0	0.00000	0.00000
15	40055000	Chronic sinusitis (disorder)	63	68496003	Polyp of colon	1095	216	91	21	195	70	809	1.16987	0.02535	1.24462	2.07702	0.74581	0.4096250434	1.0000000000	17.95068	0.21525	104	43	10	112	48	11	-0.01194	0.01932
14	10509002	Acute bronchitis (disorder)	63	68496003	Polyp of colon	1095	863	91	79	784	12	220	1.10151	0.05894	1.84736	3.45267	0.98844	0.0598548692	0.4767749928	71.71963	0.13766	418	43	39	445	48	40	-0.04530	-0.03415
126	698754002	Chronic paralysis due to lesion of spinal cord	37	38822007	Cystitis	1095	2	71	1	1	70	1023	7.71127	0.07559	14.61429	236.12637	0.90450	0.1255315419	0.6945902319	0.12968	0.82409	2	68	1	0	3	0	4.23411	1.09861
125	1734006	Fracture of the vertebral column with spinal cord injury	37	38822007	Cystitis	1095	5	71	1	4	70	1020	3.08451	0.03718	3.64286	33.03005	0.40177	0.2852512444	0.9659403678	0.32420	0.59488	3	68	1	2	3	0	4.23411	1.38629
124	1501000119109	Proliferative diabetic retinopathy due to type II diabetes mellitus (disorder)	37	38822007	Cystitis	1095	1	71	1	0	70	1024	15.42254	0.11482	0.00000	0.00000	0.00000	0.0648401826	0.4962224266	0.06484	0.90936	1	68	1	0	3	0	4.23411	0.69315
10	62106007	Concussion with no loss of consciousness	63	68496003	Polyp of colon	1095	206	91	18	188	73	816	1.05142	0.00745	1.07024	1.83583	0.62392	0.7803086493	1.0000000000	17.11963	0.06845	96	43	8	110	48	10	0.09453	0.08004
121	254637007	Non-small cell lung cancer (disorder)	37	38822007	Cystitis	1095	8	71	0	8	71	1016	0.00000	-0.02259	0.00000	0.00000	0.00000	1.0000000000	1.0000000000	0.51872	-0.60286	0	68	0	8	3	0	0.00000	0.00000
120	162573006	Suspected lung cancer (situation)	37	38822007	Cystitis	1095	8	71	0	8	71	1016	0.00000	-0.02259	0.00000	0.00000	0.00000	1.0000000000	1.0000000000	0.51872	-0.60286	0	68	0	8	3	0	0.00000	0.00000
6	39848009	Whiplash injury to neck	63	68496003	Polyp of colon	1095	182	91	26	156	65	848	1.71900	0.09665	2.17436	3.53437	1.33767	0.0028934688	0.0582542871	15.12511	0.74365	92	43	14	90	48	12	-0.20544	-0.11568
118	48333001	Burn injury(morphologic abnormality)	37	38822007	Cystitis	1095	1	71	0	1	71	1023	0.00000	-0.00796	0.00000	0.00000	0.00000	1.0000000000	1.0000000000	0.06484	-0.09064	0	68	0	1	3	0	0.00000	0.00000
117	230265002	Familial Alzheimer's disease of early onset (disorder)	37	38822007	Cystitis	1095	6	71	0	6	71	1018	0.00000	-0.01955	0.00000	0.00000	0.00000	1.0000000000	1.0000000000	0.38904	-0.47409	2	68	0	4	3	0	0.00000	0.00000
115	36923009	Major depression  single episode	37	38822007	Cystitis	1095	6	71	1	5	70	1019	2.57042	0.03069	2.91143	25.26182	0.33554	0.3318082734	1.0000000000	0.38904	0.52591	3	68	1	3	3	0	4.23411	1.38629
114	449868002	Smokes tobacco daily	37	38822007	Cystitis	1095	9	71	0	9	71	1015	0.00000	-0.02397	0.00000	0.00000	0.00000	1.0000000000	1.0000000000	0.58356	-0.66317	2	68	0	7	3	0	0.00000	0.00000
112	49436004	Atrial Fibrillation	37	38822007	Cystitis	1095	35	71	0	35	71	989	0.00000	-0.04785	0.00000	0.00000	0.00000	0.1624224512	0.7879650300	2.26941	-1.70903	9	68	0	26	3	0	0.00000	0.00000
111	235919008	Cholelithiasis	37	38822007	Cystitis	1095	9	71	1	8	70	1016	1.71362	0.01711	1.81429	14.71123	0.22375	0.4542707727	1.0000000000	0.58356	0.33683	7	68	1	2	3	0	4.23411	2.07944
110	65275009	Acute Cholecystitis	37	38822007	Cystitis	1095	9	71	1	8	70	1016	1.71362	0.01711	1.81429	14.71123	0.22375	0.4542707727	1.0000000000	0.58356	0.33683	7	68	1	2	3	0	4.23411	2.07944
109	90560007	Gout	37	38822007	Cystitis	1095	4	71	0	4	71	1020	0.00000	-0.01594	0.00000	0.00000	0.00000	1.0000000000	1.0000000000	0.25936	-0.33269	0	68	0	4	3	0	0.00000	0.00000
108	40930008	Hypothyroidism (disorder)	37	38822007	Cystitis	1095	13	71	1	12	70	1012	1.18635	0.00538	1.20476	9.39906	0.15443	0.5837503642	1.0000000000	0.84292	0.11800	11	68	1	2	3	0	4.23411	2.48491
107	40275004	Contact dermatitis	37	38822007	Cystitis	1095	18	71	1	17	70	1007	0.85681	-0.00487	0.84622	6.45148	0.11100	1.0000000000	1.0000000000	1.16712	-0.11578	9	68	1	9	3	0	4.23411	2.30259
106	24079001	Atopic dermatitis	37	38822007	Cystitis	1095	20	71	0	20	71	1004	0.00000	-0.03592	0.00000	0.00000	0.00000	0.6347846695	1.0000000000	1.29680	-1.19963	13	68	0	7	3	0	0.00000	0.00000
105	363406005	Malignant tumor of colon	37	38822007	Cystitis	1095	6	71	0	6	71	1018	0.00000	-0.01955	0.00000	0.00000	0.00000	1.0000000000	1.0000000000	0.38904	-0.47409	4	68	0	2	3	0	0.00000	0.00000
104	367498001	Seasonal allergic rhinitis	37	38822007	Cystitis	1095	20	71	0	20	71	1004	0.00000	-0.03592	0.00000	0.00000	0.00000	0.6347846695	1.0000000000	1.29680	-1.19963	9	68	0	11	3	0	0.00000	0.00000
102	90781000119102	Microalbuminuria due to type 2 diabetes mellitus (disorder)	37	38822007	Cystitis	1095	6	71	1	5	70	1019	2.57042	0.03069	2.91143	25.26182	0.33554	0.3318082734	1.0000000000	0.38904	0.52591	3	68	1	3	3	0	4.23411	1.38629
101	433144002	Chronic kidney disease stage 3 (disorder)	37	38822007	Cystitis	1095	3	71	1	2	70	1022	5.14085	0.05715	7.30000	81.49290	0.65392	0.1823359889	0.8153567551	0.19452	0.74357	1	68	1	2	3	0	4.23411	0.69315
100	161622006	History of lower limb amputation (situation)	37	38822007	Cystitis	1095	1	71	0	1	71	1023	0.00000	-0.00796	0.00000	0.00000	0.00000	1.0000000000	1.0000000000	0.06484	-0.09064	0	68	0	1	3	0	0.00000	0.00000
99	30832001	Rupture of patellar tendon	37	38822007	Cystitis	1095	23	71	1	22	70	1002	0.67055	-0.01271	0.65065	4.89800	0.08643	1.0000000000	1.0000000000	1.49132	-0.31691	14	68	1	9	3	0	4.23411	2.70805
98	1551000119108	Nonproliferative diabetic retinopathy due to type 2 diabetes mellitus (disorder)	37	38822007	Cystitis	1095	12	71	3	9	68	1015	3.85563	0.07915	4.97549	18.80332	1.31655	0.0376409054	0.3663102750	0.77808	1.16968	7	68	3	5	3	0	3.16407	1.20397
97	403192003	Third degree burn	37	38822007	Cystitis	1095	8	71	1	7	70	1017	1.92782	0.02096	2.07551	17.10635	0.25182	0.4161341830	1.0000000000	0.51872	0.39714	3	68	1	5	3	0	4.23411	1.38629
96	283371005	Laceration of forearm	37	38822007	Cystitis	1095	75	71	8	67	63	957	1.64507	0.04606	1.81379	3.94178	0.83461	0.1406753986	0.7371027084	4.86301	0.61828	39	68	8	36	3	0	2.25129	1.77071
95	84757009	Epilepsy	37	38822007	Cystitis	1095	30	71	1	29	70	995	0.51408	-0.02147	0.49015	3.65137	0.06580	0.7161107733	1.0000000000	1.94521	-0.55837	13	68	1	17	3	0	4.23411	2.63906
94	703151001	History of single seizure (situation)	37	38822007	Cystitis	1095	39	71	1	38	70	986	0.39545	-0.03059	0.37068	2.73986	0.05015	0.5085633118	1.0000000000	2.52877	-0.81916	14	68	1	25	3	0	4.23411	2.70805
93	128613002	Seizure disorder	37	38822007	Cystitis	1095	39	71	1	38	70	986	0.39545	-0.03059	0.37068	2.73986	0.05015	0.5085633118	1.0000000000	2.52877	-0.81916	14	68	1	25	3	0	4.23411	2.70805
91	64859006	Osteoporosis (disorder)	37	38822007	Cystitis	1095	37	71	4	33	67	991	1.66730	0.03286	1.79285	5.20997	0.61696	0.2944073283	0.9811342172	2.39909	0.55678	24	68	4	13	3	0	2.89037	1.94591
89	47693006	Rupture of appendix	37	38822007	Cystitis	1095	20	71	1	19	70	1005	0.77113	-0.00822	0.75564	5.72725	0.09970	1.0000000000	1.0000000000	1.29680	-0.19963	10	68	1	10	3	0	4.23411	2.39790
86	713197008	Recurrent rectal polyp	37	38822007	Cystitis	1095	22	71	2	20	69	1004	1.40205	0.01516	1.45507	6.35302	0.33326	0.6489017105	1.0000000000	1.42648	0.30610	12	68	1	10	3	1	2.84781	0.16705
85	241929008	Acute allergic reaction	37	38822007	Cystitis	1095	47	71	4	43	67	981	1.31256	0.01743	1.36203	3.90787	0.47471	0.5396203335	1.0000000000	3.04749	0.30490	25	68	4	22	3	0	2.89037	1.98100
83	110030002	Concussion injury of brain	37	38822007	Cystitis	1095	7	71	0	7	71	1017	0.00000	-0.02112	0.00000	0.00000	0.00000	1.0000000000	1.0000000000	0.45388	-0.53991	1	68	0	6	3	0	0.00000	0.00000
82	94260004	Secondary malignant neoplasm of colon	37	38822007	Cystitis	1095	4	71	1	3	70	1021	3.85563	0.04553	4.86190	47.34793	0.49924	0.2354991251	0.8999613933	0.25936	0.66731	2	68	1	2	3	0	4.23411	1.09861
81	236077008	Protracted diarrhea	37	38822007	Cystitis	1095	4	71	1	3	70	1021	3.85563	0.04553	4.86190	47.34793	0.49924	0.2354991251	0.8999613933	0.25936	0.66731	2	68	1	2	3	0	4.23411	1.09861
80	6072007	Bleeding from anus	37	38822007	Cystitis	1095	4	71	1	3	70	1021	3.85563	0.04553	4.86190	47.34793	0.49924	0.2354991251	0.8999613933	0.25936	0.66731	2	68	1	2	3	0	4.23411	1.09861
79	45816000	Pyelonephritis	37	38822007	Cystitis	1095	1	71	0	1	71	1023	0.00000	-0.00796	0.00000	0.00000	0.00000	1.0000000000	1.0000000000	0.06484	-0.09064	1	68	0	0	3	0	0.00000	0.00000
78	239872002	Osteoarthritis of hip	37	38822007	Cystitis	1095	21	71	6	15	65	1009	4.40644	0.12543	6.20923	16.53451	2.33176	0.0015002860	0.0340297421	1.36164	1.56756	13	68	6	8	3	0	2.51231	1.15268
76	127013003	Diabetic renal disease (disorder)	37	38822007	Cystitis	1095	28	71	4	24	67	1000	2.20322	0.05132	2.48756	7.37665	0.83886	0.1020255407	0.6291042150	1.81553	0.82852	10	68	4	18	3	0	2.89037	1.25276
75	431855005	Chronic kidney disease stage 1 (disorder)	37	38822007	Cystitis	1095	28	71	4	24	67	1000	2.20322	0.05132	2.48756	7.37665	0.83886	0.1020255407	0.6291042150	1.81553	0.82852	10	68	4	18	3	0	2.89037	1.25276
118	48333001	Burn injury(morphologic abnormality)	86	713197008	Recurrent rectal polyp	1095	1	22	0	1	22	1072	0.00000	-0.00433	0.00000	0.00000	0.00000	1.0000000000	1.0000000000	0.02009	-0.02870	0	12	0	1	10	0	0.00000	0.00000
73	196416002	Impacted molars	37	38822007	Cystitis	1095	49	71	6	43	65	981	1.88847	0.05064	2.10590	5.12958	0.86456	0.1257758399	0.6946053535	3.17717	0.74483	25	68	5	24	3	1	1.29473	-1.42712
72	35999006	Blighted ovum	37	38822007	Cystitis	1095	53	71	13	40	58	984	3.78289	0.16526	5.51379	10.87771	2.79488	0.0000127385	0.0005299445	3.43653	1.65792	53	68	13	0	3	0	1.82950	1.62471
71	201834006	Localized  primary osteoarthritis of the hand	37	38822007	Cystitis	1095	28	71	2	26	69	998	1.10161	0.00433	1.11260	4.78490	0.25870	0.7021853127	1.0000000000	1.81553	0.09156	19	68	2	9	3	0	3.55535	2.35138
70	87433001	Pulmonary emphysema (disorder)	37	38822007	Cystitis	1095	17	71	1	16	70	1008	0.90721	-0.00307	0.90000	6.88538	0.11764	1.0000000000	1.0000000000	1.10228	-0.07196	9	68	1	8	3	0	4.23411	2.30259
69	233604007	Pneumonia	37	38822007	Cystitis	1095	7	71	1	6	70	1018	2.20322	0.02541	2.42381	20.41263	0.28780	0.3753726560	1.0000000000	0.45388	0.46009	3	68	1	4	3	0	4.23411	1.38629
68	26929004	Alzheimer's disease (disorder)	37	38822007	Cystitis	1095	23	71	1	22	70	1002	0.67055	-0.01271	0.65065	4.89800	0.08643	1.0000000000	1.0000000000	1.49132	-0.31691	15	68	1	8	3	0	4.23411	2.77259
67	403191005	Second degree burn	37	38822007	Cystitis	1095	49	71	2	47	69	977	0.62949	-0.02112	0.60253	2.53292	0.14333	0.7650641957	1.0000000000	3.17717	-0.47756	23	68	2	26	3	0	3.55535	2.52573
65	239873007	Osteoarthritis of knee	37	38822007	Cystitis	1095	57	71	4	53	67	971	1.08228	0.00508	1.09378	3.11319	0.38428	0.7824872938	1.0000000000	3.69589	0.09053	30	68	4	27	3	0	2.89037	2.14007
64	444448004	Injury of medial collateral ligament of knee	37	38822007	Cystitis	1095	32	71	4	28	67	996	1.92782	0.04239	2.12367	6.23139	0.72375	0.1478835452	0.7538453888	2.07489	0.70140	17	68	4	15	3	0	2.89037	1.65823
63	68496003	Polyp of colon	37	38822007	Cystitis	1095	91	71	6	85	65	939	1.01687	0.00134	1.01973	2.42243	0.42926	1.0000000000	1.0000000000	5.90046	0.02066	43	68	4	48	3	2	1.97408	-0.75502
62	185086009	Chronic obstructive bronchitis (disorder)	37	38822007	Cystitis	1095	6	71	2	4	69	1020	5.14085	0.08093	7.39130	41.06289	1.33043	0.0524660992	0.4428340566	0.38904	1.11087	4	68	2	2	3	0	3.55535	1.09861
59	262574004	Bullet wound	37	38822007	Cystitis	1095	20	71	1	19	70	1005	0.77113	-0.00822	0.75564	5.72725	0.09970	1.0000000000	1.0000000000	1.29680	-0.19963	9	68	1	11	3	0	4.23411	2.30259
58	239720000	Tear of meniscus of knee	37	38822007	Cystitis	1095	20	71	1	19	70	1005	0.77113	-0.00822	0.75564	5.72725	0.09970	1.0000000000	1.0000000000	1.29680	-0.19963	10	68	1	10	3	0	4.23411	2.39790
57	192127007	Child attention deficit disorder	37	38822007	Cystitis	1095	76	71	4	72	67	952	0.81171	-0.01354	0.78939	2.22636	0.27989	0.8118605032	1.0000000000	4.92785	-0.24558	24	68	4	52	3	0	2.89037	1.94591
56	92691004	Carcinoma in situ of prostate (disorder)	37	38822007	Cystitis	1095	23	71	0	23	71	1001	0.00000	-0.03857	0.00000	0.00000	0.00000	0.3934831337	1.0000000000	1.49132	-1.31691	0	68	0	23	3	0	0.00000	0.00000
54	5602001	Opioid abuse (disorder)	37	38822007	Cystitis	1095	7	71	0	7	71	1017	0.00000	-0.02112	0.00000	0.00000	0.00000	1.0000000000	1.0000000000	0.45388	-0.53991	0	68	0	7	3	0	0.00000	0.00000
53	7200002	Alcoholism	37	38822007	Cystitis	1095	5	71	0	5	71	1019	0.00000	-0.01783	0.00000	0.00000	0.00000	1.0000000000	1.0000000000	0.32420	-0.40512	0	68	0	5	3	0	0.00000	0.00000
52	124171000119105	Chronic intractable migraine without aura	37	38822007	Cystitis	1095	51	71	5	46	66	978	1.51201	0.02980	1.61067	4.18979	0.61919	0.3729580080	1.0000000000	3.30685	0.47833	21	68	4	30	3	1	1.50408	-1.60141
50	446096008	Perennial allergic rhinitis	37	38822007	Cystitis	1095	26	71	2	24	69	1000	1.18635	0.00765	1.20773	5.21595	0.27964	0.6833245787	1.0000000000	1.68584	0.15959	14	68	2	12	3	0	3.55535	2.07944
49	88805009	Chronic congestive heart failure (disorder)	37	38822007	Cystitis	1095	10	71	2	8	69	1016	3.08451	0.05269	3.68116	17.66853	0.76695	0.1331649014	0.7171297574	0.64840	0.86389	5	68	1	5	3	1	2.84781	0.00000
47	359817006	Closed fracture of hip	37	38822007	Cystitis	1095	29	71	2	27	69	997	1.06362	0.00276	1.07032	4.59444	0.24934	0.7117848423	1.0000000000	1.88037	0.05871	11	68	2	18	3	0	3.55535	1.87180
46	62564004	Concussion with loss of consciousness	37	38822007	Cystitis	1095	67	71	8	59	63	965	1.84150	0.05657	2.07694	4.53617	0.95096	0.0711717275	0.5245934178	4.34429	0.75193	36	68	7	31	3	1	0.98528	-1.65045
45	263102004	Fracture subluxation of wrist	37	38822007	Cystitis	1095	109	71	9	100	62	924	1.27342	0.02394	1.34129	2.78035	0.64706	0.4123416604	1.0000000000	7.06758	0.30979	51	68	8	58	3	1	0.86500	-2.07944
44	58150001	Fracture of clavicle	37	38822007	Cystitis	1095	112	71	10	102	61	922	1.37701	0.03351	1.48184	2.98182	0.73641	0.3075475184	0.9977249576	7.26210	0.41292	55	68	10	57	3	0	2.05412	1.87180
43	307731004	Injury of tendon of the rotator cuff of shoulder	37	38822007	Cystitis	1095	51	71	5	46	66	978	1.51201	0.02980	1.61067	4.18979	0.61919	0.3729580080	1.0000000000	3.30685	0.47833	26	68	5	25	3	0	2.68102	1.82455
42	16114001	Fracture of ankle	37	38822007	Cystitis	1095	108	71	9	99	62	925	1.28521	0.02484	1.35630	2.81221	0.65413	0.4090575981	1.0000000000	7.00274	0.32143	48	68	8	60	3	1	0.86500	-2.16496
41	283385000	Laceration of thigh	37	38822007	Cystitis	1095	105	71	7	98	64	926	1.02817	0.00242	1.03348	2.31751	0.46088	0.8369302987	1.0000000000	6.80822	0.03501	50	68	6	55	3	1	1.12601	-1.79176
40	428251008	History of appendectomy	37	38822007	Cystitis	1095	51	71	1	50	70	974	0.30240	-0.04060	0.27829	2.04452	0.03788	0.2481061144	0.9133257124	3.30685	-1.10663	27	68	1	24	3	0	4.23411	3.33220
39	74400008	Appendicitis	37	38822007	Cystitis	1095	51	71	1	50	70	974	0.30240	-0.04060	0.27829	2.04452	0.03788	0.2481061144	0.9133257124	3.30685	-1.10663	27	68	1	24	3	0	4.23411	3.33220
38	398254007	Preeclampsia	37	38822007	Cystitis	1095	101	71	21	80	50	944	3.20667	0.18522	4.95600	8.66272	2.83536	0.0000003040	0.0000168916	6.54886	1.54317	101	68	21	0	3	0	1.44411	1.75950
35	19169002	Miscarriage in first trimester	37	38822007	Cystitis	1095	174	71	41	133	30	891	3.63405	0.30147	9.15564	15.16945	5.52596	0.0000000000	0.0000000000	11.28219	1.77382	174	68	41	0	3	0	0.97778	1.65707
33	429007001	History of cardiac arrest (situation)	37	38822007	Cystitis	1095	42	71	3	39	68	985	1.10161	0.00534	1.11425	3.69850	0.33569	0.7495615289	1.0000000000	2.72329	0.10342	24	68	3	18	3	0	3.16407	2.19722
32	410429000	Cardiac Arrest	37	38822007	Cystitis	1095	42	71	3	39	68	985	1.10161	0.00534	1.11425	3.69850	0.33569	0.7495615289	1.0000000000	2.72329	0.10342	24	68	3	18	3	0	3.16407	2.19722
30	399211009	History of myocardial infarction (situation)	37	38822007	Cystitis	1095	31	71	1	30	70	994	0.49750	-0.02259	0.47333	3.52224	0.06361	0.7161934997	1.0000000000	2.01005	-0.58979	2	68	1	29	3	0	4.23411	1.09861
29	22298006	Myocardial Infarction	37	38822007	Cystitis	1095	31	71	1	30	70	994	0.49750	-0.02259	0.47333	3.52224	0.06361	0.7161934997	1.0000000000	2.01005	-0.58979	2	68	1	29	3	0	4.23411	1.09861
28	53741008	Coronary Heart Disease	37	38822007	Cystitis	1095	80	71	9	71	62	953	1.73504	0.05434	1.94843	4.08193	0.93005	0.0931913939	0.6037151703	5.18721	0.69264	24	68	9	56	3	0	2.14658	1.29928
27	408512008	Body mass index 40+ - severely obese (finding)	37	38822007	Cystitis	1095	97	71	15	82	56	942	2.38493	0.11369	3.07709	5.67950	1.66713	0.0007872072	0.0204440974	6.28950	1.13418	67	68	15	30	3	0	1.71079	1.69867
26	33737001	Fracture of rib	37	38822007	Cystitis	1095	54	71	4	50	67	974	1.14241	0.00854	1.16299	3.31704	0.40775	0.7741431255	1.0000000000	3.50137	0.15156	32	68	4	22	3	0	2.89037	2.19722
24	162864005	Body mass index 30+ - obesity (finding)	37	38822007	Cystitis	1095	439	71	43	396	28	628	1.51064	0.10999	2.43543	3.98450	1.48859	0.0003936379	0.0114415680	28.46484	0.57851	226	68	42	213	3	1	-0.42348	-3.51266
23	36971009	Sinusitis (disorder)	37	38822007	Cystitis	1095	190	71	11	179	60	845	0.89288	-0.01292	0.86546	1.67911	0.44608	0.7481346382	1.0000000000	12.31963	-0.15052	84	68	10	106	3	1	0.66783	-2.43212
21	15777000	Prediabetes	37	38822007	Cystitis	1095	333	71	35	298	36	726	1.62099	0.10810	2.36857	3.84467	1.45919	0.0007237970	0.0192530010	21.59178	0.67220	159	68	33	174	3	2	0.20232	-2.71635
20	80394007	Hyperglycemia (disorder)	37	38822007	Cystitis	1095	55	71	7	48	64	976	1.96287	0.05831	2.22396	5.11213	0.96750	0.0817236545	0.5636501052	3.56621	0.80900	23	68	7	32	3	0	2.37158	1.45529
19	237602007	Metabolic syndrome X (disorder)	37	38822007	Cystitis	1095	64	71	7	57	64	967	1.68684	0.04506	1.85554	4.23295	0.81339	0.1820918791	0.8150956220	4.14977	0.63549	28	68	7	36	3	0	2.37158	1.60944
18	302870006	Hypertriglyceridemia (disorder)	37	38822007	Cystitis	1095	64	71	7	57	64	967	1.68684	0.04506	1.85554	4.23295	0.81339	0.1820918791	0.8150956220	4.14977	0.63549	28	68	7	36	3	0	2.37158	1.60944
17	368581000119106	Neuropathy due to type 2 diabetes mellitus (disorder)	37	38822007	Cystitis	1095	28	71	3	25	68	999	1.65241	0.02783	1.76294	5.98631	0.51918	0.4201864355	1.0000000000	1.81553	0.50660	7	68	3	21	3	0	3.16407	1.20397
129	47505003	Posttraumatic stress disorder	11	38341003	Hypertension	1095	4	278	2	2	276	815	1.96942	0.03424	2.95290	21.06264	0.41398	0.2680998009	0.9388450812	1.01553	0.57381	1	131	0	3	147	2	-4.31080	-0.91629
15	40055000	Chronic sinusitis (disorder)	37	38822007	Cystitis	1095	216	71	16	200	55	824	1.14241	0.01859	1.19855	2.13586	0.67257	0.5381578144	1.0000000000	14.00548	0.18005	104	68	14	112	3	2	0.85137	-1.91142
14	10509002	Acute bronchitis (disorder)	37	38822007	Cystitis	1095	863	71	68	795	3	229	1.21522	0.10930	6.52914	20.94417	2.03540	0.0000660176	0.0023750118	55.95708	0.27672	418	68	65	445	3	3	0.02281	-3.00055
13	370247008	Facial laceration	37	38822007	Cystitis	1095	109	71	8	101	63	923	1.13193	0.01155	1.16046	2.49077	0.54066	0.6815370537	1.0000000000	7.06758	0.15779	55	68	7	54	3	1	0.98528	-1.82611
125	1734006	Fracture of the vertebral column with spinal cord injury	11	38341003	Hypertension	1095	5	278	0	5	278	812	0.00000	-0.03951	0.00000	0.00000	0.00000	0.3376741133	1.0000000000	1.26941	-1.18231	3	131	0	2	147	0	0.00000	0.00000
124	1501000119109	Proliferative diabetic retinopathy due to type II diabetes mellitus (disorder)	11	38341003	Hypertension	1095	1	278	0	1	278	816	0.00000	-0.01764	0.00000	0.00000	0.00000	1.0000000000	1.0000000000	0.25388	-0.32640	1	131	0	0	147	0	0.00000	0.00000
10	62106007	Concussion with no loss of consciousness	37	38822007	Cystitis	1095	206	71	19	187	52	837	1.42247	0.05355	1.63544	2.83125	0.94469	0.0841804943	0.5728188986	13.35708	0.47824	96	68	18	110	3	1	0.17768	-2.86370
9	44465007	Sprain of ankle	37	38822007	Cystitis	1095	362	71	25	337	46	687	1.06509	0.01205	1.10792	1.83424	0.66921	0.6967570571	1.0000000000	23.47215	0.08737	185	68	24	177	3	1	-0.04256	-3.01750
8	233678006	Childhood asthma	37	38822007	Cystitis	1095	45	71	1	44	70	980	0.34272	-0.03583	0.31818	2.34376	0.04320	0.3565963674	1.0000000000	2.91781	-0.97005	25	68	1	20	3	0	4.23411	3.25810
7	75498004	Acute bacterial sinusitis (disorder)	37	38822007	Cystitis	1095	187	71	14	173	57	851	1.15463	0.01848	1.20819	2.21704	0.65842	0.5164058646	1.0000000000	12.12511	0.19263	89	68	13	98	3	1	0.44321	-2.53510
6	39848009	Whiplash injury to neck	37	38822007	Cystitis	1095	182	71	16	166	55	858	1.35583	0.04183	1.50361	2.68819	0.84103	0.1858455237	0.8181443419	11.80091	0.40929	92	68	16	90	3	0	1.65823	1.90954
5	284549007	Laceration of hand	37	38822007	Cystitis	1095	104	71	11	93	60	931	1.63123	0.05385	1.83530	3.61275	0.93235	0.0908030046	0.5983999805	6.74338	0.63200	54	68	11	50	3	0	1.97155	1.77649
117	230265002	Familial Alzheimer's disease of early onset (disorder)	11	38341003	Hypertension	1095	6	278	2	4	276	813	1.31295	0.01355	1.47283	8.08529	0.26829	0.6472594962	1.0000000000	1.52329	0.24966	2	131	2	4	147	0	4.19720	0.69315
3	65363002	Otitis media	37	38822007	Cystitis	1095	580	71	30	550	41	474	0.79772	-0.05653	0.63060	1.02590	0.38762	0.0657787185	0.5022081753	37.60731	-0.31661	277	68	30	303	3	0	1.18377	2.32565
115	36923009	Major depression  single episode	11	38341003	Hypertension	1095	6	278	0	6	278	811	0.00000	-0.04330	0.00000	0.00000	0.00000	0.3468009491	1.0000000000	1.52329	-1.33530	3	131	0	3	147	0	0.00000	0.00000
1	444814009	Viral sinusitis (disorder)	37	38822007	Cystitis	1095	993	71	71	922	0	102	1.10272	0.08439	0.00000	0.00000	0.00000	0.0011837537	0.0284684661	64.38630	0.13901	478	68	68	515	3	3	0.00000	-3.06825
113	443165006	Pathological fracture due to osteoporosis (disorder)	11	38341003	Hypertension	1095	10	278	7	3	271	814	2.75719	0.09840	7.00861	27.29249	1.79978	0.0036977169	0.0711810496	2.53881	1.17673	7	131	5	3	147	2	-1.00758	-0.04082
112	49436004	Atrial Fibrillation	11	38341003	Hypertension	1095	35	278	16	19	262	798	1.80062	0.08486	2.56489	5.06035	1.30004	0.0089894773	0.1424361580	8.88584	0.78210	9	131	1	26	147	15	2.50326	1.29706
111	235919008	Cholelithiasis	11	38341003	Hypertension	1095	9	278	2	7	276	810	0.87530	-0.00662	0.83851	4.06034	0.17316	1.0000000000	1.0000000000	2.28493	-0.13090	7	131	2	2	147	0	4.19720	1.50408
110	65275009	Acute Cholecystitis	11	38341003	Hypertension	1095	9	278	2	7	276	810	0.87530	-0.00662	0.83851	4.06034	0.17316	1.0000000000	1.0000000000	2.28493	-0.13090	7	131	2	2	147	0	4.19720	1.50408
109	90560007	Gout	11	38341003	Hypertension	1095	4	278	2	2	276	815	1.96942	0.03424	2.95290	21.06264	0.41398	0.2680998009	0.9388450812	1.01553	0.57381	0	131	0	4	147	2	-4.31080	-1.09861
108	40930008	Hypothyroidism (disorder)	11	38341003	Hypertension	1095	13	278	1	12	277	805	0.30299	-0.04457	0.24218	1.87101	0.03135	0.2032390890	0.8521851499	3.30046	-1.10449	11	131	1	2	147	0	4.88280	2.48491
107	40275004	Contact dermatitis	11	38341003	Hypertension	1095	18	278	6	12	272	805	1.31295	0.02360	1.47978	3.98075	0.55008	0.4203953860	1.0000000000	4.56986	0.32971	9	131	2	9	147	4	0.56622	0.52609
106	24079001	Atopic dermatitis	11	38341003	Hypertension	1095	20	278	2	18	276	799	0.39388	-0.04823	0.32166	1.39515	0.07416	0.1265588496	0.6972941899	5.07763	-1.01855	13	131	1	7	147	1	-0.11441	0.55962
105	363406005	Malignant tumor of colon	11	38341003	Hypertension	1095	6	278	1	5	277	812	0.65647	-0.01487	0.58628	5.04001	0.06820	1.0000000000	1.0000000000	1.52329	-0.33530	4	131	1	2	147	0	4.88280	1.60944
104	367498001	Seasonal allergic rhinitis	11	38341003	Hypertension	1095	20	278	3	17	275	800	0.59083	-0.03256	0.51337	1.76516	0.14931	0.4359652031	1.0000000000	5.07763	-0.60351	9	131	2	11	147	1	-0.80001	-0.78016
102	90781000119102	Microalbuminuria due to type 2 diabetes mellitus (disorder)	11	38341003	Hypertension	1095	6	278	1	5	277	812	0.65647	-0.01487	0.58628	5.04001	0.06820	1.0000000000	1.0000000000	1.52329	-0.33530	3	131	0	3	147	1	-4.99721	-1.38629
101	433144002	Chronic kidney disease stage 3 (disorder)	11	38341003	Hypertension	1095	3	278	0	3	278	814	0.00000	-0.03057	0.00000	0.00000	0.00000	0.5753543664	1.0000000000	0.76164	-0.81692	1	131	0	2	147	0	0.00000	0.00000
100	161622006	History of lower limb amputation (situation)	11	38341003	Hypertension	1095	1	278	0	1	278	816	0.00000	-0.01764	0.00000	0.00000	0.00000	1.0000000000	1.0000000000	0.25388	-0.32640	0	131	0	1	147	0	0.00000	0.00000
99	30832001	Rupture of patellar tendon	11	38341003	Hypertension	1095	23	278	6	17	272	800	1.02753	0.00235	1.03806	2.65959	0.40516	1.0000000000	1.0000000000	5.83927	0.03351	14	131	4	9	147	2	-0.79182	-0.20067
98	1551000119108	Nonproliferative diabetic retinopathy due to type 2 diabetes mellitus (disorder)	11	38341003	Hypertension	1095	12	278	6	6	272	811	1.96942	0.05953	2.98162	9.32180	0.95368	0.0863648781	0.5823623432	3.04658	0.79065	7	131	4	5	147	2	-0.79182	-0.24116
97	403192003	Third degree burn	11	38341003	Hypertension	1095	8	278	3	5	275	812	1.47707	0.02387	1.77164	7.46166	0.42064	0.4261012226	1.0000000000	2.03105	0.40018	3	131	0	5	147	3	-3.91202	-0.98083
96	283371005	Laceration of forearm	11	38341003	Hypertension	1095	75	278	19	56	259	761	0.99784	-0.00034	0.99690	1.70919	0.58145	1.0000000000	1.0000000000	19.04110	-0.00296	39	131	9	36	147	10	-0.00924	0.14792
95	84757009	Epilepsy	11	38341003	Hypertension	1095	30	278	7	23	271	794	0.91906	-0.00792	0.89171	2.10138	0.37839	1.0000000000	1.0000000000	7.61644	-0.10709	13	131	4	17	147	3	-0.39304	-0.45020
94	703151001	History of single seizure (situation)	11	38341003	Hypertension	1095	39	278	9	30	269	787	0.90897	-0.01021	0.87770	1.87236	0.41143	0.8524523944	1.0000000000	9.90137	-0.12451	14	131	4	25	147	5	0.10454	-0.28768
93	128613002	Seizure disorder	11	38341003	Hypertension	1095	39	278	9	30	269	787	0.90897	-0.01021	0.87770	1.87236	0.41143	0.8524523944	1.0000000000	9.90137	-0.12451	14	131	4	25	147	5	0.10454	-0.28768
91	64859006	Osteoporosis (disorder)	11	38341003	Hypertension	1095	37	278	14	23	264	794	1.49038	0.05349	1.83070	3.60932	0.92856	0.0846966772	0.5754391891	9.39361	0.52927	24	131	9	13	147	5	-0.67002	0.01835
89	47693006	Rupture of appendix	11	38341003	Hypertension	1095	20	278	7	13	271	804	1.37860	0.03012	1.59750	4.04525	0.63087	0.3080700780	0.9989417613	5.07763	0.39649	10	131	3	10	147	4	0.16824	0.21357
88	197927001	Recurrent urinary tract infection	11	38341003	Hypertension	1095	8	278	2	6	276	811	0.98471	-0.00077	0.97947	4.88114	0.19654	1.0000000000	1.0000000000	2.03105	-0.01486	8	131	2	0	147	0	4.19720	1.60944
86	713197008	Recurrent rectal polyp	11	38341003	Hypertension	1095	22	278	4	18	274	799	0.71615	-0.02371	0.64801	1.93136	0.21742	0.6209935239	1.0000000000	5.58539	-0.39734	12	131	2	10	147	2	-0.11360	0.15415
85	241929008	Acute allergic reaction	11	38341003	Hypertension	1095	47	278	10	37	268	780	0.83805	-0.02001	0.78661	1.60348	0.38588	0.6086822458	1.0000000000	11.93242	-0.23349	25	131	5	22	147	5	-0.11123	0.10536
83	110030002	Concussion injury of brain	11	38341003	Hypertension	1095	7	278	3	4	275	813	1.68808	0.03219	2.21727	9.96878	0.49317	0.3791140904	1.0000000000	1.77717	0.52639	1	131	1	6	147	2	0.57200	-0.69315
82	94260004	Secondary malignant neoplasm of colon	11	38341003	Hypertension	1095	4	278	1	3	277	814	0.98471	-0.00054	0.97954	9.45560	0.10147	1.0000000000	1.0000000000	1.01553	-0.01116	2	131	1	2	147	0	4.88280	1.09861
81	236077008	Protracted diarrhea	11	38341003	Hypertension	1095	4	278	1	3	277	814	0.98471	-0.00054	0.97954	9.45560	0.10147	1.0000000000	1.0000000000	1.01553	-0.01116	2	131	1	2	147	0	4.88280	1.09861
80	6072007	Bleeding from anus	11	38341003	Hypertension	1095	4	278	1	3	277	814	0.98471	-0.00054	0.97954	9.45560	0.10147	1.0000000000	1.0000000000	1.01553	-0.01116	2	131	1	2	147	0	4.88280	1.09861
79	45816000	Pyelonephritis	11	38341003	Hypertension	1095	1	278	1	0	277	817	3.93885	0.05183	0.00000	0.00000	0.00000	0.2538812785	0.9133257124	0.25388	0.67360	1	131	1	0	147	0	4.88280	0.69315
78	239872002	Osteoarthritis of hip	11	38341003	Hypertension	1095	21	278	8	13	270	804	1.50051	0.04083	1.83248	4.46881	0.75143	0.2044571789	0.8533859271	5.33151	0.50738	13	131	6	8	147	2	-1.18258	-0.45676
76	127013003	Diabetic renal disease (disorder)	11	38341003	Hypertension	1095	28	278	12	16	266	801	1.68808	0.06502	2.25846	4.83509	1.05492	0.0451371219	0.4084765375	7.10868	0.68097	10	131	4	18	147	8	0.55500	0.07411
75	431855005	Chronic kidney disease stage 1 (disorder)	11	38341003	Hypertension	1095	28	278	12	16	266	801	1.68808	0.06502	2.25846	4.83509	1.05492	0.0451371219	0.4084765375	7.10868	0.68097	10	131	4	18	147	8	0.55500	0.07411
73	196416002	Impacted molars	11	38341003	Hypertension	1095	49	278	19	30	259	787	1.52731	0.06657	1.92445	3.47711	1.06511	0.0421173641	0.3928865271	12.44018	0.57345	25	131	11	24	147	8	-0.40605	-0.20067
72	35999006	Blighted ovum	11	38341003	Hypertension	1095	53	278	20	33	258	784	1.48636	0.06398	1.84167	3.26619	1.03845	0.0505373350	0.4336429389	13.45571	0.53875	53	131	20	0	147	0	2.02155	1.29473
71	201834006	Localized  primary osteoarthritis of the hand	11	38341003	Hypertension	1095	28	278	10	18	268	799	1.40673	0.03843	1.65630	3.63239	0.75524	0.2692405726	0.9388450812	7.10868	0.43997	19	131	6	9	147	4	-0.50276	0.24846
70	87433001	Pulmonary emphysema (disorder)	11	38341003	Hypertension	1095	17	278	7	10	271	807	1.62188	0.04555	2.08450	5.52987	0.78576	0.1582583654	0.7765186874	4.31598	0.58966	9	131	3	8	147	4	0.16824	0.28768
69	233604007	Pneumonia	11	38341003	Hypertension	1095	7	278	2	5	276	812	1.12539	0.00587	1.17681	6.10013	0.22703	1.0000000000	1.0000000000	1.77717	0.11135	3	131	1	4	147	1	-0.11441	-0.22314
68	26929004	Alzheimer's disease (disorder)	11	38341003	Hypertension	1095	23	278	7	16	271	801	1.19878	0.01698	1.29313	3.17677	0.52638	0.6282603038	1.0000000000	5.83927	0.22616	15	131	5	8	147	2	-1.00758	-0.22314
67	403191005	Second degree burn	11	38341003	Hypertension	1095	49	278	10	39	268	778	0.80385	-0.02477	0.74436	1.51168	0.36652	0.5028873485	1.0000000000	12.44018	-0.28905	23	131	5	26	147	5	-0.11123	-0.10178
65	239873007	Osteoarthritis of knee	11	38341003	Hypertension	1095	57	278	24	33	254	784	1.65846	0.09001	2.24481	3.86953	1.30227	0.0045710267	0.0850094759	14.47123	0.69234	30	131	11	27	147	13	0.04771	0.19175
64	444448004	Injury of medial collateral ligament of knee	11	38341003	Hypertension	1095	32	278	14	18	264	799	1.72325	0.07320	2.35396	4.79825	1.15482	0.0220863933	0.2681526419	8.12420	0.71719	17	131	7	15	147	7	-0.10970	0.08701
63	68496003	Polyp of colon	11	38341003	Hypertension	1095	91	278	25	66	253	751	1.08210	0.01442	1.12439	1.82042	0.69448	0.6167299129	1.0000000000	23.10320	0.10929	43	131	10	48	147	15	0.26663	0.23262
62	185086009	Chronic obstructive bronchitis (disorder)	11	38341003	Hypertension	1095	6	278	4	2	274	815	2.62590	0.07040	5.94891	32.65824	1.08363	0.0392493104	0.3768817329	1.52329	0.98662	4	131	3	2	147	1	-1.19798	-0.25131
60	301011002	Escherichia coli urinary tract infection	11	38341003	Hypertension	1095	92	278	29	63	249	754	1.24159	0.04268	1.39389	2.21369	0.87769	0.1688692847	0.7953568293	23.35708	0.30062	85	131	26	7	147	3	-2.11387	0.24746
59	262574004	Bullet wound	11	38341003	Hypertension	1095	20	278	3	17	275	800	0.59083	-0.03256	0.51337	1.76516	0.14931	0.4359652031	1.0000000000	5.07763	-0.60351	9	131	2	11	147	1	-0.80001	-0.78016
58	239720000	Tear of meniscus of knee	11	38341003	Hypertension	1095	20	278	8	12	270	805	1.57554	0.04579	1.98765	4.91411	0.80396	0.1907427357	0.8254734124	5.07763	0.56642	10	131	5	10	147	3	-0.60881	-0.36772
57	192127007	Child attention deficit disorder	11	38341003	Hypertension	1095	76	278	15	61	263	756	0.77740	-0.03546	0.70685	1.26503	0.39496	0.2757411938	0.9505356881	19.29498	-0.34305	24	131	6	52	147	9	0.27559	-0.30421
56	92691004	Carcinoma in situ of prostate (disorder)	11	38341003	Hypertension	1095	23	278	11	12	267	805	1.88380	0.07551	2.76373	6.33662	1.20541	0.0256112577	0.2905941929	5.83927	0.81112	0	131	0	23	147	11	-2.66470	-1.12847
54	5602001	Opioid abuse (disorder)	11	38341003	Hypertension	1095	7	278	1	6	277	811	0.56269	-0.02046	0.48797	4.07099	0.05849	0.6859670171	1.0000000000	1.77717	-0.47361	0	131	0	7	147	1	-4.99721	-2.07944
53	7200002	Alcoholism	11	38341003	Hypertension	1095	5	278	2	3	276	814	1.57554	0.02274	1.96618	11.82826	0.32683	0.6058967312	1.0000000000	1.26941	0.40265	0	131	0	5	147	2	-4.31080	-1.25276
52	124171000119105	Chronic intractable migraine without aura	11	38341003	Hypertension	1095	51	278	16	35	262	782	1.23572	0.03039	1.36445	2.50566	0.74301	0.3242040244	1.0000000000	12.94795	0.28548	21	131	9	30	147	7	-0.34662	-0.46103
50	446096008	Perennial allergic rhinitis	11	38341003	Hypertension	1095	26	278	6	20	272	797	0.90897	-0.00828	0.87904	2.21160	0.34939	1.0000000000	1.0000000000	6.60091	-0.11882	14	131	1	12	147	5	1.46836	1.48427
49	88805009	Chronic congestive heart failure (disorder)	11	38341003	Hypertension	1095	10	278	4	6	274	811	1.57554	0.03223	1.97324	7.04430	0.55274	0.2851995771	0.9659403678	2.53881	0.49866	5	131	2	5	147	2	-0.11360	0.00000
47	359817006	Closed fracture of hip	11	38341003	Hypertension	1095	29	278	7	22	271	795	0.95076	-0.00474	0.93341	2.20939	0.39434	1.0000000000	1.0000000000	7.36256	-0.06394	11	131	3	18	147	4	0.16824	-0.16430
46	62564004	Concussion with loss of consciousness	11	38341003	Hypertension	1095	67	278	18	49	260	768	1.05820	0.00867	1.08509	1.89622	0.62093	0.7728208086	1.0000000000	17.01005	0.07720	36	131	12	31	147	6	-0.76074	-0.43286
45	263102004	Fracture subluxation of wrist	11	38341003	Hypertension	1095	109	278	23	86	255	731	0.83113	-0.03275	0.76667	1.24106	0.47361	0.2989031617	0.9871226309	27.67306	-0.25666	51	131	11	58	147	12	-0.02607	-0.03435
44	58150001	Fracture of clavicle	11	38341003	Hypertension	1095	112	278	35	77	243	740	1.23089	0.04546	1.38421	2.11733	0.90493	0.1371947254	0.7296699408	28.43470	0.29048	55	131	14	57	147	21	0.25823	0.28286
43	307731004	Injury of tendon of the rotator cuff of shoulder	11	38341003	Hypertension	1095	51	278	13	38	265	779	1.00402	0.00052	1.00566	1.91676	0.52764	1.0000000000	1.0000000000	12.94795	0.00537	26	131	7	25	147	6	-0.25733	-0.09163
42	16114001	Fracture of ankle	11	38341003	Hypertension	1095	108	278	31	77	247	740	1.13060	0.02520	1.20616	1.87484	0.77597	0.4156768113	1.0000000000	27.41918	0.17121	48	131	14	60	147	17	0.07102	-0.02252
41	283385000	Laceration of thigh	11	38341003	Hypertension	1095	105	278	33	72	245	745	1.23792	0.04520	1.39371	2.15662	0.90068	0.1564719417	0.7747075658	26.65753	0.29786	50	131	13	55	147	20	0.28260	0.25643
40	428251008	History of appendectomy	11	38341003	Hypertension	1095	51	278	13	38	265	779	1.00402	0.00052	1.00566	1.91676	0.52764	1.0000000000	1.0000000000	12.94795	0.00537	27	131	6	24	147	7	0.03718	0.21667
39	74400008	Appendicitis	11	38341003	Hypertension	1095	51	278	13	38	265	779	1.00402	0.00052	1.00566	1.91676	0.52764	1.0000000000	1.0000000000	12.94795	0.00537	27	131	6	24	147	7	0.03718	0.21667
38	398254007	Preeclampsia	11	38341003	Hypertension	1095	101	278	29	72	249	745	1.13096	0.02435	1.20510	1.89814	0.76510	0.4039093411	1.0000000000	25.64201	0.17126	101	131	29	0	147	0	1.70788	1.50024
37	38822007	Cystitis	11	38341003	Hypertension	1095	71	278	21	50	257	767	1.16501	0.02535	1.25346	2.12716	0.73862	0.3995474257	1.0000000000	18.02557	0.20956	68	131	20	3	147	1	-2.97566	0.09531
35	19169002	Miscarriage in first trimester	11	38341003	Hypertension	1095	174	278	55	119	223	698	1.24504	0.06213	1.44666	2.05980	1.01603	0.0459271516	0.4105382250	44.17534	0.30989	174	131	55	0	147	0	1.21841	1.42639
33	429007001	History of cardiac arrest (situation)	11	38341003	Hypertension	1095	42	278	5	37	273	780	0.46891	-0.06187	0.38610	0.99236	0.15022	0.0456279747	0.4094197322	10.66301	-0.95891	24	131	4	18	147	1	-1.47823	-0.99853
32	410429000	Cardiac Arrest	11	38341003	Hypertension	1095	42	278	5	37	273	780	0.46891	-0.06187	0.38610	0.99236	0.15022	0.0456279747	0.4094197322	10.66301	-0.95891	24	131	4	18	147	1	-1.47823	-0.99853
114	449868002	Smokes tobacco daily	88	197927001	Recurrent urinary tract infection	1095	9	8	0	9	8	1078	0.00000	-0.00781	0.00000	0.00000	0.00000	1.0000000000	1.0000000000	0.06575	-0.09187	2	8	0	7	0	0	0.00000	0.00000
30	399211009	History of myocardial infarction (situation)	11	38341003	Hypertension	1095	31	278	5	26	273	791	0.63530	-0.03631	0.55720	1.46537	0.21187	0.2968006057	0.9846242317	7.87032	-0.56402	2	131	0	29	147	5	-3.41444	-1.91692
29	22298006	Myocardial Infarction	11	38341003	Hypertension	1095	31	278	5	26	273	791	0.63530	-0.03631	0.55720	1.46537	0.21187	0.2968006057	0.9846242317	7.87032	-0.56402	2	131	0	29	147	5	-3.41444	-1.91692
28	53741008	Coronary Heart Disease	11	38341003	Hypertension	1095	80	278	26	54	252	763	1.28013	0.04588	1.45782	2.37735	0.89395	0.1421039405	0.7404942507	20.31050	0.34139	24	131	9	56	147	17	0.47776	-0.15796
27	408512008	Body mass index 40+ - severely obese (finding)	11	38341003	Hypertension	1095	97	278	30	67	248	750	1.21820	0.03968	1.35412	2.13191	0.86009	0.2211288098	0.8794911525	24.62648	0.27463	67	131	20	30	147	10	-0.73211	0.08388
26	33737001	Fracture of rib	11	38341003	Hypertension	1095	54	278	14	40	264	777	1.02118	0.00281	1.03011	1.92342	0.55169	0.8741162166	1.0000000000	13.70959	0.02821	32	131	8	22	147	6	-0.38365	0.06899
24	162864005	Body mass index 30+ - obesity (finding)	11	38341003	Hypertension	1095	439	278	131	308	147	509	1.17537	0.08369	1.47272	1.93836	1.11894	0.0070363903	0.1189073325	111.45388	0.23120	226	131	67	213	147	64	-0.10940	0.01035
23	36971009	Sinusitis (disorder)	11	38341003	Hypertension	1095	190	278	50	140	228	677	1.03654	0.00977	1.06046	1.51404	0.74277	0.7833345499	1.0000000000	48.23744	0.05074	84	131	22	106	147	28	0.10681	0.00676
22	70704007	Sprain of wrist	11	38341003	Hypertension	1095	195	278	58	137	220	680	1.17156	0.04658	1.30856	1.84327	0.92897	0.1239549089	0.6913144812	49.50685	0.22424	90	131	26	105	147	32	0.07650	0.04125
21	15777000	Prediabetes	11	38341003	Hypertension	1095	333	278	103	230	175	587	1.21832	0.08419	1.50214	2.00192	1.12713	0.0065244015	0.1117754624	84.54247	0.28187	159	131	44	174	147	59	0.13026	0.15552
20	80394007	Hyperglycemia (disorder)	11	38341003	Hypertension	1095	55	278	31	24	247	793	2.22008	0.16367	4.14693	7.19993	2.38850	0.0000005588	0.0000299101	13.96347	1.09663	23	131	11	32	147	20	0.43567	0.17295
19	237602007	Metabolic syndrome X (disorder)	11	38341003	Hypertension	1095	64	278	33	31	245	786	2.03097	0.14984	3.41514	5.69163	2.04918	0.0000043278	0.0001978604	16.24840	0.97907	28	131	12	36	147	21	0.39850	0.20544
18	302870006	Hypertriglyceridemia (disorder)	11	38341003	Hypertension	1095	64	278	33	31	245	786	2.03097	0.14984	3.41514	5.69163	2.04918	0.0000043278	0.0001978604	16.24840	0.97907	28	131	12	36	147	21	0.39850	0.20544
17	368581000119106	Neuropathy due to type 2 diabetes mellitus (disorder)	11	38341003	Hypertension	1095	28	278	15	13	263	804	2.11010	0.10490	3.52735	7.50957	1.65684	0.0013896794	0.0321015942	7.10868	0.98053	7	131	3	21	147	12	1.21523	0.19237
15	40055000	Chronic sinusitis (disorder)	11	38341003	Hypertension	1095	216	278	63	153	215	664	1.14883	0.04304	1.27168	1.77111	0.91309	0.1630006740	0.7879650300	54.83836	0.19682	104	131	28	112	147	35	0.08804	0.11551
14	10509002	Acute bronchitis (disorder)	11	38341003	Hypertension	1095	863	278	244	619	34	198	1.11365	0.12786	2.29554	3.40017	1.54978	0.0000132749	0.0005496566	219.09954	0.15463	418	131	114	445	147	130	0.00858	0.05361
13	370247008	Facial laceration	11	38341003	Hypertension	1095	109	278	36	73	242	744	1.30090	0.05836	1.51613	2.31836	0.99150	0.0630756773	0.4891136942	27.67306	0.36783	55	131	18	54	147	18	-0.10200	0.01379
12	65966004	Fracture of forearm	11	38341003	Hypertension	1095	123	278	35	88	243	729	1.12081	0.02507	1.19318	1.81184	0.78577	0.4414191338	1.0000000000	31.22740	0.15971	55	131	14	68	147	21	0.25823	0.15094
10	62106007	Concussion with no loss of consciousness	11	38341003	Hypertension	1095	206	278	62	144	216	673	1.18548	0.05208	1.34150	1.87507	0.95976	0.0915411347	0.5998476181	52.29954	0.24123	96	131	28	110	147	34	0.06456	0.04462
9	44465007	Sprain of ankle	11	38341003	Hypertension	1095	362	278	99	263	179	554	1.07720	0.03165	1.16503	1.55078	0.87523	0.3021296353	0.9944109257	91.90502	0.10617	185	131	45	177	147	54	0.04950	0.17798
8	233678006	Childhood asthma	11	38341003	Hypertension	1095	45	278	7	38	271	779	0.61271	-0.04677	0.52952	1.19977	0.23371	0.1605212273	0.7819917697	11.42466	-0.63513	25	131	5	20	147	2	-1.00758	-0.60614
7	75498004	Acute bacterial sinusitis (disorder)	11	38341003	Hypertension	1095	187	278	61	126	217	691	1.28487	0.07541	1.54162	2.16947	1.09547	0.0162112146	0.2172550256	47.47580	0.35500	89	131	27	98	147	34	0.09462	0.10131
6	39848009	Whiplash injury to neck	11	38341003	Hypertension	1095	182	278	58	124	220	693	1.25524	0.06647	1.47339	2.08399	1.04169	0.0318618273	0.3286523152	46.20639	0.32173	92	131	26	90	147	32	0.07650	0.17430
5	284549007	Laceration of hand	11	38341003	Hypertension	1095	104	278	34	70	244	747	1.28770	0.05437	1.48700	2.29611	0.96301	0.0762932312	0.5462097970	26.40365	0.35299	54	131	20	50	147	14	-0.42080	-0.21149
4	195662009	Acute viral pharyngitis (disorder)	11	38341003	Hypertension	1095	890	278	244	646	34	171	1.07986	0.09707	1.89965	2.82379	1.27796	0.0012945903	0.0302231752	225.95434	0.11038	430	131	117	460	147	127	-0.01769	0.01144
3	65363002	Otitis media	11	38341003	Hypertension	1095	580	278	137	443	141	374	0.93038	-0.04310	0.82029	1.07719	0.62467	0.1643568141	0.7905337612	147.25114	-0.10337	277	131	63	303	147	74	0.03063	0.05763
1	444814009	Viral sinusitis (disorder)	11	38341003	Hypertension	1095	993	278	272	721	6	96	1.07892	0.14364	6.03606	13.93270	2.61500	0.0000001479	0.0000084509	252.10411	0.10917	478	131	127	515	147	145	0.00875	0.04554
118	48333001	Burn injury(morphologic abnormality)	89	47693006	Rupture of appendix	1095	1	20	0	1	20	1074	0.00000	-0.00412	0.00000	0.00000	0.00000	1.0000000000	1.0000000000	0.01826	-0.02611	0	10	0	1	10	0	0.00000	0.00000
120	162573006	Suspected lung cancer (situation)	80	6072007	Bleeding from anus	1095	8	4	0	8	4	1083	0.00000	-0.00519	0.00000	0.00000	0.00000	1.0000000000	1.0000000000	0.02922	-0.04156	0	2	0	8	2	0	0.00000	0.00000
128	86849004	Suicidal deliberate poisoning	80	6072007	Bleeding from anus	1095	1	4	0	1	4	1090	0.00000	-0.00183	0.00000	0.00000	0.00000	1.0000000000	1.0000000000	0.00365	-0.00526	0	2	0	1	2	0	0.00000	0.00000
130	314994000	Metastasis from malignant tumor of prostate (disorder)	80	6072007	Bleeding from anus	1095	1	4	0	1	4	1090	0.00000	-0.00183	0.00000	0.00000	0.00000	1.0000000000	1.0000000000	0.00365	-0.00526	0	2	0	1	2	0	0.00000	0.00000
114	449868002	Smokes tobacco daily	90	444470001	Injury of anterior cruciate ligament	1095	9	19	0	9	19	1067	0.00000	-0.01210	0.00000	0.00000	0.00000	1.0000000000	1.0000000000	0.15616	-0.20935	2	10	0	7	9	0	0.00000	0.00000
127	431856006	Chronic kidney disease stage 2 (disorder)	91	64859006	Osteoporosis (disorder)	1095	5	37	0	5	37	1053	0.00000	-0.01267	0.00000	0.00000	0.00000	1.0000000000	1.0000000000	0.16895	-0.22521	3	24	0	2	13	0	0.00000	0.00000
116	370143000	Major depression disorder	25	284551006	Laceration of foot	1095	8	118	2	6	116	971	2.31992	0.03935	2.79023	13.98480	0.55670	0.2099292978	0.8627150637	0.86210	0.68803	3	53	0	5	65	2	-3.51155	-1.25276
117	230265002	Familial Alzheimer's disease of early onset (disorder)	25	284551006	Laceration of foot	1095	6	118	1	5	117	972	1.54661	0.01410	1.66154	14.34396	0.19246	0.4963120407	1.0000000000	0.64658	0.28053	2	53	0	4	65	1	-4.18965	-1.60944
118	48333001	Burn injury(morphologic abnormality)	25	284551006	Laceration of foot	1095	1	118	0	1	118	976	0.00000	-0.01051	0.00000	0.00000	0.00000	1.0000000000	1.0000000000	0.10776	-0.14765	0	53	0	1	65	0	0.00000	0.00000
119	275272006	Brain damage - traumatic	25	284551006	Laceration of foot	1095	4	118	0	4	118	973	0.00000	-0.02104	0.00000	0.00000	0.00000	1.0000000000	1.0000000000	0.43105	-0.51707	0	53	0	4	65	0	0.00000	0.00000
120	162573006	Suspected lung cancer (situation)	25	284551006	Laceration of foot	1095	8	118	0	8	118	969	0.00000	-0.02981	0.00000	0.00000	0.00000	1.0000000000	1.0000000000	0.86210	-0.89693	0	53	0	8	65	0	0.00000	0.00000
121	254637007	Non-small cell lung cancer (disorder)	25	284551006	Laceration of foot	1095	8	118	0	8	118	969	0.00000	-0.02981	0.00000	0.00000	0.00000	1.0000000000	1.0000000000	0.86210	-0.89693	0	53	0	8	65	0	0.00000	0.00000
123	195967001	Asthma	25	284551006	Laceration of foot	1095	2	118	0	2	118	975	0.00000	-0.01487	0.00000	0.00000	0.00000	1.0000000000	1.0000000000	0.21553	-0.28158	1	53	0	1	65	0	0.00000	0.00000
124	1501000119109	Proliferative diabetic retinopathy due to type II diabetes mellitus (disorder)	25	284551006	Laceration of foot	1095	1	118	0	1	118	976	0.00000	-0.01051	0.00000	0.00000	0.00000	1.0000000000	1.0000000000	0.10776	-0.14765	1	53	0	0	65	0	0.00000	0.00000
125	1734006	Fracture of the vertebral column with spinal cord injury	25	284551006	Laceration of foot	1095	5	118	0	5	118	972	0.00000	-0.02354	0.00000	0.00000	0.00000	1.0000000000	1.0000000000	0.53881	-0.62182	3	53	0	2	65	0	0.00000	0.00000
126	698754002	Chronic paralysis due to lesion of spinal cord	25	284551006	Laceration of foot	1095	2	118	0	2	118	975	0.00000	-0.01487	0.00000	0.00000	0.00000	1.0000000000	1.0000000000	0.21553	-0.28158	2	53	0	0	65	0	0.00000	0.00000
127	431856006	Chronic kidney disease stage 2 (disorder)	25	284551006	Laceration of foot	1095	5	118	1	4	117	973	1.85593	0.02015	2.07906	18.75764	0.23044	0.4351647370	1.0000000000	0.53881	0.37818	3	53	1	2	65	0	3.98898	1.38629
128	86849004	Suicidal deliberate poisoning	25	284551006	Laceration of foot	1095	1	118	1	0	117	977	9.27966	0.08700	0.00000	0.00000	0.00000	0.1077625571	0.6461336926	0.10776	0.85235	0	53	0	1	65	1	-4.18965	-0.69315
129	47505003	Posttraumatic stress disorder	25	284551006	Laceration of foot	1095	4	118	1	3	117	974	2.31992	0.02778	2.77493	26.89418	0.28632	0.3666646743	1.0000000000	0.43105	0.48293	1	53	0	3	65	1	-4.18965	-1.38629
130	314994000	Metastasis from malignant tumor of prostate (disorder)	25	284551006	Laceration of foot	1095	1	118	1	0	117	977	9.27966	0.08700	0.00000	0.00000	0.00000	0.1077625571	0.6461336926	0.10776	0.85235	0	53	0	1	65	1	-4.18965	-0.69315
131	93761005	Primary malignant neoplasm of colon	25	284551006	Laceration of foot	1095	5	118	0	5	118	972	0.00000	-0.02354	0.00000	0.00000	0.00000	1.0000000000	1.0000000000	0.53881	-0.62182	3	53	0	2	65	0	0.00000	0.00000
132	69896004	Rheumatoid arthritis	25	284551006	Laceration of foot	1095	3	118	0	3	118	974	0.00000	-0.01822	0.00000	0.00000	0.00000	1.0000000000	1.0000000000	0.32329	-0.40413	2	53	0	1	65	0	0.00000	0.00000
127	431856006	Chronic kidney disease stage 2 (disorder)	53	7200002	Alcoholism	1095	5	5	1	4	4	1086	43.80000	0.19633	67.87500	749.09304	6.15012	0.0226645534	0.2721606699	0.02283	0.96743	3	0	0	2	5	1	-1.79176	-1.09861
128	86849004	Suicidal deliberate poisoning	53	7200002	Alcoholism	1095	1	5	1	0	4	1090	219.00000	0.44640	0.00000	0.00000	0.00000	0.0045662100	0.0850094759	0.00457	0.99343	0	0	0	1	5	1	-1.79176	-0.69315
118	48333001	Burn injury(morphologic abnormality)	93	128613002	Seizure disorder	1095	1	39	0	1	39	1055	0.00000	-0.00581	0.00000	0.00000	0.00000	1.0000000000	1.0000000000	0.03562	-0.05049	0	14	0	1	25	0	0.00000	0.00000
130	314994000	Metastasis from malignant tumor of prostate (disorder)	124	1501000119109	Proliferative diabetic retinopathy due to type II diabetes mellitus (disorder)	1095	1	1	0	1	1	1093	0.00000	-0.00091	0.00000	0.00000	0.00000	1.0000000000	1.0000000000	0.00091	-0.00132	0	1	0	1	0	0	0.00000	0.00000
129	47505003	Posttraumatic stress disorder	124	1501000119109	Proliferative diabetic retinopathy due to type II diabetes mellitus (disorder)	1095	4	1	0	4	1	1090	0.00000	-0.00183	0.00000	0.00000	0.00000	1.0000000000	1.0000000000	0.00365	-0.00526	1	1	0	3	0	0	0.00000	0.00000
125	1734006	Fracture of the vertebral column with spinal cord injury	124	1501000119109	Proliferative diabetic retinopathy due to type II diabetes mellitus (disorder)	1095	5	1	0	5	1	1089	0.00000	-0.00205	0.00000	0.00000	0.00000	1.0000000000	1.0000000000	0.00457	-0.00657	3	1	0	2	0	0	0.00000	0.00000
118	48333001	Burn injury(morphologic abnormality)	124	1501000119109	Proliferative diabetic retinopathy due to type II diabetes mellitus (disorder)	1095	1	1	0	1	1	1093	0.00000	-0.00091	0.00000	0.00000	0.00000	1.0000000000	1.0000000000	0.00091	-0.00132	0	1	0	1	0	0	0.00000	0.00000
117	230265002	Familial Alzheimer's disease of early onset (disorder)	124	1501000119109	Proliferative diabetic retinopathy due to type II diabetes mellitus (disorder)	1095	6	1	0	6	1	1088	0.00000	-0.00224	0.00000	0.00000	0.00000	1.0000000000	1.0000000000	0.00548	-0.00788	2	1	0	4	0	0	0.00000	0.00000
115	36923009	Major depression  single episode	124	1501000119109	Proliferative diabetic retinopathy due to type II diabetes mellitus (disorder)	1095	6	1	0	6	1	1088	0.00000	-0.00224	0.00000	0.00000	0.00000	1.0000000000	1.0000000000	0.00548	-0.00788	3	1	0	3	0	0	0.00000	0.00000
114	449868002	Smokes tobacco daily	124	1501000119109	Proliferative diabetic retinopathy due to type II diabetes mellitus (disorder)	1095	9	1	0	9	1	1085	0.00000	-0.00275	0.00000	0.00000	0.00000	1.0000000000	1.0000000000	0.00822	-0.01181	2	1	0	7	0	0	0.00000	0.00000
111	235919008	Cholelithiasis	124	1501000119109	Proliferative diabetic retinopathy due to type II diabetes mellitus (disorder)	1095	9	1	0	9	1	1085	0.00000	-0.00275	0.00000	0.00000	0.00000	1.0000000000	1.0000000000	0.00822	-0.01181	7	1	0	2	0	0	0.00000	0.00000
109	90560007	Gout	124	1501000119109	Proliferative diabetic retinopathy due to type II diabetes mellitus (disorder)	1095	4	1	0	4	1	1090	0.00000	-0.00183	0.00000	0.00000	0.00000	1.0000000000	1.0000000000	0.00365	-0.00526	0	1	0	4	0	0	0.00000	0.00000
107	40275004	Contact dermatitis	124	1501000119109	Proliferative diabetic retinopathy due to type II diabetes mellitus (disorder)	1095	18	1	0	18	1	1076	0.00000	-0.00391	0.00000	0.00000	0.00000	1.0000000000	1.0000000000	0.01644	-0.02352	9	1	0	9	0	0	0.00000	0.00000
106	24079001	Atopic dermatitis	124	1501000119109	Proliferative diabetic retinopathy due to type II diabetes mellitus (disorder)	1095	20	1	0	20	1	1074	0.00000	-0.00412	0.00000	0.00000	0.00000	1.0000000000	1.0000000000	0.01826	-0.02611	13	1	0	7	0	0	0.00000	0.00000
102	90781000119102	Microalbuminuria due to type 2 diabetes mellitus (disorder)	124	1501000119109	Proliferative diabetic retinopathy due to type II diabetes mellitus (disorder)	1095	6	1	0	6	1	1088	0.00000	-0.00224	0.00000	0.00000	0.00000	1.0000000000	1.0000000000	0.00548	-0.00788	3	1	0	3	0	0	0.00000	0.00000
98	1551000119108	Nonproliferative diabetic retinopathy due to type 2 diabetes mellitus (disorder)	124	1501000119109	Proliferative diabetic retinopathy due to type II diabetes mellitus (disorder)	1095	12	1	1	11	0	1083	91.25000	0.28722	0.00000	0.00000	0.00000	0.0109589041	0.1636007828	0.01096	0.98428	7	1	1	5	0	0	0.69315	2.07944
97	403192003	Third degree burn	124	1501000119109	Proliferative diabetic retinopathy due to type II diabetes mellitus (disorder)	1095	8	1	0	8	1	1086	0.00000	-0.00259	0.00000	0.00000	0.00000	1.0000000000	1.0000000000	0.00731	-0.01050	3	1	0	5	0	0	0.00000	0.00000
96	283371005	Laceration of forearm	124	1501000119109	Proliferative diabetic retinopathy due to type II diabetes mellitus (disorder)	1095	75	1	0	75	1	1019	0.00000	-0.00820	0.00000	0.00000	0.00000	1.0000000000	1.0000000000	0.06849	-0.09558	39	1	0	36	0	0	0.00000	0.00000
94	703151001	History of single seizure (situation)	124	1501000119109	Proliferative diabetic retinopathy due to type II diabetes mellitus (disorder)	1095	39	1	0	39	1	1055	0.00000	-0.00581	0.00000	0.00000	0.00000	1.0000000000	1.0000000000	0.03562	-0.05049	14	1	0	25	0	0	0.00000	0.00000
93	128613002	Seizure disorder	124	1501000119109	Proliferative diabetic retinopathy due to type II diabetes mellitus (disorder)	1095	39	1	0	39	1	1055	0.00000	-0.00581	0.00000	0.00000	0.00000	1.0000000000	1.0000000000	0.03562	-0.05049	14	1	0	25	0	0	0.00000	0.00000
89	47693006	Rupture of appendix	124	1501000119109	Proliferative diabetic retinopathy due to type II diabetes mellitus (disorder)	1095	20	1	0	20	1	1074	0.00000	-0.00412	0.00000	0.00000	0.00000	1.0000000000	1.0000000000	0.01826	-0.02611	10	1	0	10	0	0	0.00000	0.00000
86	713197008	Recurrent rectal polyp	124	1501000119109	Proliferative diabetic retinopathy due to type II diabetes mellitus (disorder)	1095	22	1	0	22	1	1072	0.00000	-0.00433	0.00000	0.00000	0.00000	1.0000000000	1.0000000000	0.02009	-0.02870	12	1	0	10	0	0	0.00000	0.00000
82	94260004	Secondary malignant neoplasm of colon	124	1501000119109	Proliferative diabetic retinopathy due to type II diabetes mellitus (disorder)	1095	4	1	0	4	1	1090	0.00000	-0.00183	0.00000	0.00000	0.00000	1.0000000000	1.0000000000	0.00365	-0.00526	2	1	0	2	0	0	0.00000	0.00000
78	239872002	Osteoarthritis of hip	124	1501000119109	Proliferative diabetic retinopathy due to type II diabetes mellitus (disorder)	1095	21	1	0	21	1	1073	0.00000	-0.00423	0.00000	0.00000	0.00000	1.0000000000	1.0000000000	0.01918	-0.02741	13	1	0	8	0	0	0.00000	0.00000
76	127013003	Diabetic renal disease (disorder)	124	1501000119109	Proliferative diabetic retinopathy due to type II diabetes mellitus (disorder)	1095	28	1	1	27	0	1067	39.10714	0.18664	0.00000	0.00000	0.00000	0.0255707763	0.2905941929	0.02557	0.96357	10	1	1	18	0	0	0.69315	2.39790
75	431855005	Chronic kidney disease stage 1 (disorder)	124	1501000119109	Proliferative diabetic retinopathy due to type II diabetes mellitus (disorder)	1095	28	1	1	27	0	1067	39.10714	0.18664	0.00000	0.00000	0.00000	0.0255707763	0.2905941929	0.02557	0.96357	10	1	1	18	0	0	0.69315	2.39790
72	35999006	Blighted ovum	124	1501000119109	Proliferative diabetic retinopathy due to type II diabetes mellitus (disorder)	1095	53	1	0	53	1	1041	0.00000	-0.00682	0.00000	0.00000	0.00000	1.0000000000	1.0000000000	0.04840	-0.06819	53	1	0	0	0	0	0.00000	0.00000
71	201834006	Localized  primary osteoarthritis of the hand	124	1501000119109	Proliferative diabetic retinopathy due to type II diabetes mellitus (disorder)	1095	28	1	0	28	1	1066	0.00000	-0.00490	0.00000	0.00000	0.00000	1.0000000000	1.0000000000	0.02557	-0.03643	19	1	0	9	0	0	0.00000	0.00000
69	233604007	Pneumonia	124	1501000119109	Proliferative diabetic retinopathy due to type II diabetes mellitus (disorder)	1095	7	1	0	7	1	1087	0.00000	-0.00243	0.00000	0.00000	0.00000	1.0000000000	1.0000000000	0.00639	-0.00919	3	1	0	4	0	0	0.00000	0.00000
67	403191005	Second degree burn	124	1501000119109	Proliferative diabetic retinopathy due to type II diabetes mellitus (disorder)	1095	49	1	0	49	1	1045	0.00000	-0.00654	0.00000	0.00000	0.00000	1.0000000000	1.0000000000	0.04475	-0.06316	23	1	0	26	0	0	0.00000	0.00000
64	444448004	Injury of medial collateral ligament of knee	124	1501000119109	Proliferative diabetic retinopathy due to type II diabetes mellitus (disorder)	1095	32	1	0	32	1	1062	0.00000	-0.00525	0.00000	0.00000	0.00000	1.0000000000	1.0000000000	0.02922	-0.04156	17	1	0	15	0	0	0.00000	0.00000
63	68496003	Polyp of colon	124	1501000119109	Proliferative diabetic retinopathy due to type II diabetes mellitus (disorder)	1095	91	1	0	91	1	1003	0.00000	-0.00910	0.00000	0.00000	0.00000	1.0000000000	1.0000000000	0.08311	-0.11517	43	1	0	48	0	0	0.00000	0.00000
59	262574004	Bullet wound	124	1501000119109	Proliferative diabetic retinopathy due to type II diabetes mellitus (disorder)	1095	20	1	0	20	1	1074	0.00000	-0.00412	0.00000	0.00000	0.00000	1.0000000000	1.0000000000	0.01826	-0.02611	9	1	0	11	0	0	0.00000	0.00000
58	239720000	Tear of meniscus of knee	124	1501000119109	Proliferative diabetic retinopathy due to type II diabetes mellitus (disorder)	1095	20	1	0	20	1	1074	0.00000	-0.00412	0.00000	0.00000	0.00000	1.0000000000	1.0000000000	0.01826	-0.02611	10	1	0	10	0	0	0.00000	0.00000
57	192127007	Child attention deficit disorder	124	1501000119109	Proliferative diabetic retinopathy due to type II diabetes mellitus (disorder)	1095	76	1	0	76	1	1018	0.00000	-0.00826	0.00000	0.00000	0.00000	1.0000000000	1.0000000000	0.06941	-0.09681	24	1	0	52	0	0	0.00000	0.00000
54	5602001	Opioid abuse (disorder)	124	1501000119109	Proliferative diabetic retinopathy due to type II diabetes mellitus (disorder)	1095	7	1	0	7	1	1087	0.00000	-0.00243	0.00000	0.00000	0.00000	1.0000000000	1.0000000000	0.00639	-0.00919	0	1	0	7	0	0	0.00000	0.00000
52	124171000119105	Chronic intractable migraine without aura	124	1501000119109	Proliferative diabetic retinopathy due to type II diabetes mellitus (disorder)	1095	51	1	0	51	1	1043	0.00000	-0.00668	0.00000	0.00000	0.00000	1.0000000000	1.0000000000	0.04658	-0.06568	21	1	0	30	0	0	0.00000	0.00000
50	446096008	Perennial allergic rhinitis	124	1501000119109	Proliferative diabetic retinopathy due to type II diabetes mellitus (disorder)	1095	26	1	0	26	1	1068	0.00000	-0.00472	0.00000	0.00000	0.00000	1.0000000000	1.0000000000	0.02374	-0.03386	14	1	0	12	0	0	0.00000	0.00000
49	88805009	Chronic congestive heart failure (disorder)	124	1501000119109	Proliferative diabetic retinopathy due to type II diabetes mellitus (disorder)	1095	10	1	0	10	1	1084	0.00000	-0.00290	0.00000	0.00000	0.00000	1.0000000000	1.0000000000	0.00913	-0.01312	5	1	0	5	0	0	0.00000	0.00000
47	359817006	Closed fracture of hip	124	1501000119109	Proliferative diabetic retinopathy due to type II diabetes mellitus (disorder)	1095	29	1	0	29	1	1065	0.00000	-0.00499	0.00000	0.00000	0.00000	1.0000000000	1.0000000000	0.02648	-0.03771	11	1	0	18	0	0	0.00000	0.00000
44	58150001	Fracture of clavicle	124	1501000119109	Proliferative diabetic retinopathy due to type II diabetes mellitus (disorder)	1095	112	1	0	112	1	982	0.00000	-0.01021	0.00000	0.00000	0.00000	1.0000000000	1.0000000000	0.10228	-0.14049	55	1	0	57	0	0	0.00000	0.00000
43	307731004	Injury of tendon of the rotator cuff of shoulder	124	1501000119109	Proliferative diabetic retinopathy due to type II diabetes mellitus (disorder)	1095	51	1	1	50	0	1044	21.47059	0.13679	0.00000	0.00000	0.00000	0.0465753425	0.4136336033	0.04658	0.93432	26	1	1	25	0	0	0.69315	3.29584
42	16114001	Fracture of ankle	124	1501000119109	Proliferative diabetic retinopathy due to type II diabetes mellitus (disorder)	1095	108	1	0	108	1	986	0.00000	-0.01000	0.00000	0.00000	0.00000	1.0000000000	1.0000000000	0.09863	-0.13571	48	1	0	60	0	0	0.00000	0.00000
41	283385000	Laceration of thigh	124	1501000119109	Proliferative diabetic retinopathy due to type II diabetes mellitus (disorder)	1095	105	1	1	104	0	990	10.42857	0.09284	0.00000	0.00000	0.00000	0.0958904110	0.6155535021	0.09589	0.86790	50	1	1	55	0	0	0.69315	3.93183
39	74400008	Appendicitis	124	1501000119109	Proliferative diabetic retinopathy due to type II diabetes mellitus (disorder)	1095	51	1	0	51	1	1043	0.00000	-0.00668	0.00000	0.00000	0.00000	1.0000000000	1.0000000000	0.04658	-0.06568	27	1	0	24	0	0	0.00000	0.00000
38	398254007	Preeclampsia	124	1501000119109	Proliferative diabetic retinopathy due to type II diabetes mellitus (disorder)	1095	101	1	0	101	1	993	0.00000	-0.00964	0.00000	0.00000	0.00000	1.0000000000	1.0000000000	0.09224	-0.12729	101	1	0	0	0	0	0.00000	0.00000
35	19169002	Miscarriage in first trimester	124	1501000119109	Proliferative diabetic retinopathy due to type II diabetes mellitus (disorder)	1095	174	1	0	174	1	920	0.00000	-0.01314	0.00000	0.00000	0.00000	1.0000000000	1.0000000000	0.15890	-0.21276	174	1	0	0	0	0	0.00000	0.00000
33	429007001	History of cardiac arrest (situation)	124	1501000119109	Proliferative diabetic retinopathy due to type II diabetes mellitus (disorder)	1095	42	1	0	42	1	1052	0.00000	-0.00604	0.00000	0.00000	0.00000	1.0000000000	1.0000000000	0.03836	-0.05430	24	1	0	18	0	0	0.00000	0.00000
32	410429000	Cardiac Arrest	124	1501000119109	Proliferative diabetic retinopathy due to type II diabetes mellitus (disorder)	1095	42	1	0	42	1	1052	0.00000	-0.00604	0.00000	0.00000	0.00000	1.0000000000	1.0000000000	0.03836	-0.05430	24	1	0	18	0	0	0.00000	0.00000
30	399211009	History of myocardial infarction (situation)	124	1501000119109	Proliferative diabetic retinopathy due to type II diabetes mellitus (disorder)	1095	31	1	0	31	1	1063	0.00000	-0.00516	0.00000	0.00000	0.00000	1.0000000000	1.0000000000	0.02831	-0.04028	2	1	0	29	0	0	0.00000	0.00000
27	408512008	Body mass index 40+ - severely obese (finding)	124	1501000119109	Proliferative diabetic retinopathy due to type II diabetes mellitus (disorder)	1095	97	1	0	97	1	997	0.00000	-0.00943	0.00000	0.00000	0.00000	1.0000000000	1.0000000000	0.08858	-0.12245	67	1	0	30	0	0	0.00000	0.00000
24	162864005	Body mass index 30+ - obesity (finding)	124	1501000119109	Proliferative diabetic retinopathy due to type II diabetes mellitus (disorder)	1095	439	1	1	438	0	656	2.49431	0.03696	0.00000	0.00000	0.00000	0.4009132420	1.0000000000	0.40091	0.51363	226	1	1	213	0	0	0.69315	5.42495
23	36971009	Sinusitis (disorder)	124	1501000119109	Proliferative diabetic retinopathy due to type II diabetes mellitus (disorder)	1095	190	1	0	190	1	904	0.00000	-0.01385	0.00000	0.00000	0.00000	1.0000000000	1.0000000000	0.17352	-0.23084	84	1	0	106	0	0	0.00000	0.00000
21	15777000	Prediabetes	124	1501000119109	Proliferative diabetic retinopathy due to type II diabetes mellitus (disorder)	1095	333	1	1	332	0	762	3.28829	0.04573	0.00000	0.00000	0.00000	0.3041095890	0.9949586182	0.30411	0.61693	159	1	1	174	0	0	0.69315	5.07517
20	80394007	Hyperglycemia (disorder)	124	1501000119109	Proliferative diabetic retinopathy due to type II diabetes mellitus (disorder)	1095	55	1	1	54	0	1040	19.90909	0.13147	0.00000	0.00000	0.00000	0.0502283105	0.4320205543	0.05023	0.92930	23	1	1	32	0	0	0.69315	3.17805
18	302870006	Hypertriglyceridemia (disorder)	124	1501000119109	Proliferative diabetic retinopathy due to type II diabetes mellitus (disorder)	1095	64	1	1	63	0	1031	17.10937	0.12135	0.00000	0.00000	0.00000	0.0584474886	0.4685406893	0.05845	0.91805	28	1	1	36	0	0	0.69315	3.36730
17	368581000119106	Neuropathy due to type 2 diabetes mellitus (disorder)	124	1501000119109	Proliferative diabetic retinopathy due to type II diabetes mellitus (disorder)	1095	28	1	1	27	0	1067	39.10714	0.18664	0.00000	0.00000	0.00000	0.0255707763	0.2905941929	0.02557	0.96357	7	1	1	21	0	0	0.69315	2.07944
15	40055000	Chronic sinusitis (disorder)	124	1501000119109	Proliferative diabetic retinopathy due to type II diabetes mellitus (disorder)	1095	216	1	0	216	1	878	0.00000	-0.01499	0.00000	0.00000	0.00000	1.0000000000	1.0000000000	0.19726	-0.25974	104	1	0	112	0	0	0.00000	0.00000
14	10509002	Acute bronchitis (disorder)	124	1501000119109	Proliferative diabetic retinopathy due to type II diabetes mellitus (disorder)	1095	863	1	1	862	0	232	1.26883	0.01568	0.00000	0.00000	0.00000	1.0000000000	1.0000000000	0.78813	0.16155	418	1	1	445	0	0	0.69315	6.03787
13	370247008	Facial laceration	124	1501000119109	Proliferative diabetic retinopathy due to type II diabetes mellitus (disorder)	1095	109	1	0	109	1	985	0.00000	-0.01005	0.00000	0.00000	0.00000	1.0000000000	1.0000000000	0.09954	-0.13690	55	1	0	54	0	0	0.00000	0.00000
125	1734006	Fracture of the vertebral column with spinal cord injury	98	1551000119108	Nonproliferative diabetic retinopathy due to type 2 diabetes mellitus (disorder)	1095	5	12	0	5	12	1078	0.00000	-0.00713	0.00000	0.00000	0.00000	1.0000000000	1.0000000000	0.05479	-0.07696	3	7	0	2	5	0	0.00000	0.00000
10	62106007	Concussion with no loss of consciousness	124	1501000119109	Proliferative diabetic retinopathy due to type II diabetes mellitus (disorder)	1095	206	1	1	205	0	889	5.31553	0.06281	0.00000	0.00000	0.00000	0.1881278539	0.8191400304	0.18813	0.75131	96	1	1	110	0	0	0.69315	4.57471
7	75498004	Acute bacterial sinusitis (disorder)	124	1501000119109	Proliferative diabetic retinopathy due to type II diabetes mellitus (disorder)	1095	187	1	0	187	1	907	0.00000	-0.01372	0.00000	0.00000	0.00000	1.0000000000	1.0000000000	0.17078	-0.22747	89	1	0	98	0	0	0.00000	0.00000
6	39848009	Whiplash injury to neck	124	1501000119109	Proliferative diabetic retinopathy due to type II diabetes mellitus (disorder)	1095	182	1	1	181	0	913	6.01648	0.06772	0.00000	0.00000	0.00000	0.1662100457	0.7915572889	0.16621	0.77817	92	1	1	90	0	0	0.69315	4.53260
5	284549007	Laceration of hand	124	1501000119109	Proliferative diabetic retinopathy due to type II diabetes mellitus (disorder)	1095	104	1	0	104	1	990	0.00000	-0.00979	0.00000	0.00000	0.00000	1.0000000000	1.0000000000	0.09498	-0.13090	54	1	0	50	0	0	0.00000	0.00000
117	230265002	Familial Alzheimer's disease of early onset (disorder)	98	1551000119108	Nonproliferative diabetic retinopathy due to type 2 diabetes mellitus (disorder)	1095	6	12	0	6	12	1077	0.00000	-0.00781	0.00000	0.00000	0.00000	1.0000000000	1.0000000000	0.06575	-0.09187	2	7	0	4	5	0	0.00000	0.00000
1	444814009	Viral sinusitis (disorder)	124	1501000119109	Proliferative diabetic retinopathy due to type II diabetes mellitus (disorder)	1095	993	1	1	992	0	102	1.10272	0.00969	0.00000	0.00000	0.00000	1.0000000000	1.0000000000	0.90685	0.06881	478	1	1	515	0	0	0.69315	6.17170
109	90560007	Gout	98	1551000119108	Nonproliferative diabetic retinopathy due to type 2 diabetes mellitus (disorder)	1095	4	12	0	4	12	1079	0.00000	-0.00637	0.00000	0.00000	0.00000	1.0000000000	1.0000000000	0.04384	-0.06189	0	7	0	4	5	0	0.00000	0.00000
102	90781000119102	Microalbuminuria due to type 2 diabetes mellitus (disorder)	98	1551000119108	Nonproliferative diabetic retinopathy due to type 2 diabetes mellitus (disorder)	1095	6	12	1	5	11	1078	15.20833	0.11101	19.60000	181.85463	2.11246	0.0641206121	0.4928640393	0.06575	0.90813	3	7	0	3	5	1	-1.79176	-1.38629
114	449868002	Smokes tobacco daily	95	84757009	Epilepsy	1095	9	30	0	9	30	1056	0.00000	-0.01528	0.00000	0.00000	0.00000	1.0000000000	1.0000000000	0.24658	-0.31797	2	13	0	7	17	0	0.00000	0.00000
97	403192003	Third degree burn	98	1551000119108	Nonproliferative diabetic retinopathy due to type 2 diabetes mellitus (disorder)	1095	8	12	0	8	12	1075	0.00000	-0.00903	0.00000	0.00000	0.00000	1.0000000000	1.0000000000	0.08767	-0.12124	3	7	0	5	5	0	0.00000	0.00000
96	283371005	Laceration of forearm	98	1551000119108	Nonproliferative diabetic retinopathy due to type 2 diabetes mellitus (disorder)	1095	75	12	1	74	11	1009	1.21667	0.00618	1.23956	9.73217	0.15788	0.5750930932	1.0000000000	0.82192	0.13454	39	7	1	36	5	0	2.07944	3.68888
94	703151001	History of single seizure (situation)	98	1551000119108	Nonproliferative diabetic retinopathy due to type 2 diabetes mellitus (disorder)	1095	39	12	0	39	12	1044	0.00000	-0.02023	0.00000	0.00000	0.00000	1.0000000000	1.0000000000	0.42740	-0.51339	14	7	0	25	5	0	0.00000	0.00000
93	128613002	Seizure disorder	98	1551000119108	Nonproliferative diabetic retinopathy due to type 2 diabetes mellitus (disorder)	1095	39	12	0	39	12	1044	0.00000	-0.02023	0.00000	0.00000	0.00000	1.0000000000	1.0000000000	0.42740	-0.51339	14	7	0	25	5	0	0.00000	0.00000
89	47693006	Rupture of appendix	98	1551000119108	Nonproliferative diabetic retinopathy due to type 2 diabetes mellitus (disorder)	1095	20	12	0	20	12	1063	0.00000	-0.01436	0.00000	0.00000	0.00000	1.0000000000	1.0000000000	0.21918	-0.28591	10	7	0	10	5	0	0.00000	0.00000
86	713197008	Recurrent rectal polyp	98	1551000119108	Nonproliferative diabetic retinopathy due to type 2 diabetes mellitus (disorder)	1095	22	12	0	22	12	1061	0.00000	-0.01507	0.00000	0.00000	0.00000	1.0000000000	1.0000000000	0.24110	-0.31161	12	7	0	10	5	0	0.00000	0.00000
75	431855005	Chronic kidney disease stage 1 (disorder)	98	1551000119108	Nonproliferative diabetic retinopathy due to type 2 diabetes mellitus (disorder)	1095	28	12	6	22	6	1061	19.55357	0.31637	48.22727	161.37009	14.41327	0.0000001327	0.0000076649	0.30685	2.42126	10	7	3	18	5	3	0.22314	-0.47957
69	233604007	Pneumonia	98	1551000119108	Nonproliferative diabetic retinopathy due to type 2 diabetes mellitus (disorder)	1095	7	12	0	7	12	1076	0.00000	-0.00844	0.00000	0.00000	0.00000	1.0000000000	1.0000000000	0.07671	-0.10663	3	7	0	4	5	0	0.00000	0.00000
64	444448004	Injury of medial collateral ligament of knee	98	1551000119108	Nonproliferative diabetic retinopathy due to type 2 diabetes mellitus (disorder)	1095	32	12	1	31	11	1052	2.85156	0.03382	3.08504	24.64586	0.38617	0.3007441790	0.9911272351	0.35068	0.56631	17	7	1	15	5	0	2.07944	2.89037
63	68496003	Polyp of colon	98	1551000119108	Nonproliferative diabetic retinopathy due to type 2 diabetes mellitus (disorder)	1095	91	12	1	90	11	993	1.00275	0.00009	1.00303	7.85761	0.12804	1.0000000000	1.0000000000	0.99726	0.00198	43	7	0	48	5	1	-1.79176	-3.89182
49	88805009	Chronic congestive heart failure (disorder)	98	1551000119108	Nonproliferative diabetic retinopathy due to type 2 diabetes mellitus (disorder)	1095	10	12	0	10	12	1073	0.00000	-0.01011	0.00000	0.00000	0.00000	1.0000000000	1.0000000000	0.10959	-0.15003	5	7	0	5	5	0	0.00000	0.00000
47	359817006	Closed fracture of hip	98	1551000119108	Nonproliferative diabetic retinopathy due to type 2 diabetes mellitus (disorder)	1095	29	12	0	29	12	1054	0.00000	-0.01736	0.00000	0.00000	0.00000	1.0000000000	1.0000000000	0.31781	-0.39814	11	7	0	18	5	0	0.00000	0.00000
44	58150001	Fracture of clavicle	98	1551000119108	Nonproliferative diabetic retinopathy due to type 2 diabetes mellitus (disorder)	1095	112	12	1	111	11	972	0.81473	-0.00658	0.79607	6.22420	0.10182	1.0000000000	1.0000000000	1.22740	-0.15536	55	7	0	57	5	1	-1.79176	-4.06044
43	307731004	Injury of tendon of the rotator cuff of shoulder	98	1551000119108	Nonproliferative diabetic retinopathy due to type 2 diabetes mellitus (disorder)	1095	51	12	3	48	9	1035	5.36765	0.10162	7.18750	27.40290	1.88521	0.0155572947	0.2122814615	0.55890	1.35947	26	7	2	25	5	1	-0.28768	-0.61904
42	16114001	Fracture of ankle	98	1551000119108	Nonproliferative diabetic retinopathy due to type 2 diabetes mellitus (disorder)	1095	108	12	1	107	11	976	0.84491	-0.00540	0.82923	6.48547	0.10602	1.0000000000	1.0000000000	1.18356	-0.12668	48	7	1	60	5	0	2.07944	3.89182
41	283385000	Laceration of thigh	98	1551000119108	Nonproliferative diabetic retinopathy due to type 2 diabetes mellitus (disorder)	1095	105	12	3	102	9	981	2.60714	0.05509	3.20588	12.03051	0.85430	0.0995143315	0.6255159994	1.15068	0.89520	50	7	2	55	5	1	-0.28768	-0.76726
39	74400008	Appendicitis	98	1551000119108	Nonproliferative diabetic retinopathy due to type 2 diabetes mellitus (disorder)	1095	51	12	0	51	12	1032	0.00000	-0.02327	0.00000	0.00000	0.00000	1.0000000000	1.0000000000	0.55890	-0.64053	27	7	0	24	5	0	0.00000	0.00000
38	398254007	Preeclampsia	98	1551000119108	Nonproliferative diabetic retinopathy due to type 2 diabetes mellitus (disorder)	1095	101	12	0	101	12	982	0.00000	-0.03355	0.00000	0.00000	0.00000	0.6163486314	1.0000000000	1.10685	-1.07509	101	7	0	0	5	0	0.00000	0.00000
35	19169002	Miscarriage in first trimester	98	1551000119108	Nonproliferative diabetic retinopathy due to type 2 diabetes mellitus (disorder)	1095	174	12	5	169	7	914	2.62213	0.07422	3.86306	12.31445	1.21185	0.0293510267	0.3161267640	1.90685	1.04551	174	7	5	0	5	0	0.87547	3.57795
33	429007001	History of cardiac arrest (situation)	98	1551000119108	Nonproliferative diabetic retinopathy due to type 2 diabetes mellitus (disorder)	1095	42	12	1	41	11	1042	2.17262	0.02465	2.31042	18.32372	0.29132	0.3760936227	1.0000000000	0.46027	0.45376	24	7	1	18	5	0	2.07944	3.21888
32	410429000	Cardiac Arrest	98	1551000119108	Nonproliferative diabetic retinopathy due to type 2 diabetes mellitus (disorder)	1095	42	12	1	41	11	1042	2.17262	0.02465	2.31042	18.32372	0.29132	0.3760936227	1.0000000000	0.46027	0.45376	24	7	1	18	5	0	2.07944	3.21888
27	408512008	Body mass index 40+ - severely obese (finding)	98	1551000119108	Nonproliferative diabetic retinopathy due to type 2 diabetes mellitus (disorder)	1095	97	12	2	95	10	988	1.88144	0.02893	2.08000	9.63189	0.44917	0.2882011785	0.9712041902	1.06301	0.54021	67	7	2	30	5	0	1.50408	3.54096
21	15777000	Prediabetes	98	1551000119108	Nonproliferative diabetic retinopathy due to type 2 diabetes mellitus (disorder)	1095	333	12	6	327	6	756	1.64414	0.04482	2.31193	7.22163	0.74014	0.2026096840	0.8513680261	3.64932	0.59034	159	7	4	174	5	2	-0.24116	-0.76988
20	80394007	Hyperglycemia (disorder)	98	1551000119108	Nonproliferative diabetic retinopathy due to type 2 diabetes mellitus (disorder)	1095	55	12	11	44	1	1039	18.25000	0.41757	259.75000	2056.87997	32.80214	0.0000000000	0.0000000000	0.60274	2.90442	23	7	7	32	5	4	-0.11778	-0.74194
18	302870006	Hypertriglyceridemia (disorder)	98	1551000119108	Nonproliferative diabetic retinopathy due to type 2 diabetes mellitus (disorder)	1095	64	12	12	52	0	1031	17.10937	0.42249	0.00000	0.00000	0.00000	0.0000000000	0.0000000000	0.70137	2.93374	28	7	7	36	5	5	0.00000	-0.49470
130	314994000	Metastasis from malignant tumor of prostate (disorder)	72	35999006	Blighted ovum	1095	1	53	0	1	53	1041	0.00000	-0.00682	0.00000	0.00000	0.00000	1.0000000000	1.0000000000	0.04840	-0.06819	0	53	0	1	0	0	0.00000	0.00000
15	40055000	Chronic sinusitis (disorder)	98	1551000119108	Nonproliferative diabetic retinopathy due to type 2 diabetes mellitus (disorder)	1095	216	12	3	213	9	870	1.26736	0.01395	1.36150	5.07231	0.36545	0.7133775499	1.0000000000	2.36712	0.24848	104	7	1	112	5	2	0.82668	0.61091
14	10509002	Acute bronchitis (disorder)	98	1551000119108	Nonproliferative diabetic retinopathy due to type 2 diabetes mellitus (disorder)	1095	863	12	12	851	0	232	1.26883	0.05458	0.00000	0.00000	0.00000	0.0813334827	0.5629813232	9.45753	0.31397	418	7	7	445	5	5	0.00000	-0.39363
125	1734006	Fracture of the vertebral column with spinal cord injury	72	35999006	Blighted ovum	1095	5	53	0	5	53	1037	0.00000	-0.01527	0.00000	0.00000	0.00000	1.0000000000	1.0000000000	0.24201	-0.31268	3	53	0	2	0	0	0.00000	0.00000
10	62106007	Concussion with no loss of consciousness	98	1551000119108	Nonproliferative diabetic retinopathy due to type 2 diabetes mellitus (disorder)	1095	206	12	6	200	6	883	2.65777	0.08400	4.41500	13.83161	1.40925	0.0139360760	0.1938682647	2.25753	1.10357	96	7	4	110	5	2	-0.24116	-0.80648
6	39848009	Whiplash injury to neck	98	1551000119108	Nonproliferative diabetic retinopathy due to type 2 diabetes mellitus (disorder)	1095	182	12	3	179	9	904	1.50412	0.02369	1.68343	6.27942	0.45130	0.4322067935	1.0000000000	1.99452	0.41767	92	7	1	90	5	2	0.82668	0.70396
118	48333001	Burn injury(morphologic abnormality)	72	35999006	Blighted ovum	1095	1	53	0	1	53	1041	0.00000	-0.00682	0.00000	0.00000	0.00000	1.0000000000	1.0000000000	0.04840	-0.06819	0	53	0	1	0	0	0.00000	0.00000
117	230265002	Familial Alzheimer's disease of early onset (disorder)	72	35999006	Blighted ovum	1095	6	53	0	6	53	1036	0.00000	-0.01674	0.00000	0.00000	0.00000	1.0000000000	1.0000000000	0.29041	-0.36783	2	53	0	4	0	0	0.00000	0.00000
109	90560007	Gout	72	35999006	Blighted ovum	1095	4	53	0	4	53	1038	0.00000	-0.01366	0.00000	0.00000	0.00000	1.0000000000	1.0000000000	0.19361	-0.25533	0	53	0	4	0	0	0.00000	0.00000
102	90781000119102	Microalbuminuria due to type 2 diabetes mellitus (disorder)	72	35999006	Blighted ovum	1095	6	53	0	6	53	1036	0.00000	-0.01674	0.00000	0.00000	0.00000	1.0000000000	1.0000000000	0.29041	-0.36783	3	53	0	3	0	0	0.00000	0.00000
98	1551000119108	Nonproliferative diabetic retinopathy due to type 2 diabetes mellitus (disorder)	72	35999006	Blighted ovum	1095	12	53	2	10	51	1032	3.44340	0.05801	4.04706	18.95347	0.86415	0.1112511476	0.6580610333	0.58082	0.92429	7	53	2	5	0	0	3.31419	1.50408
97	403192003	Third degree burn	72	35999006	Blighted ovum	1095	8	53	0	8	53	1034	0.00000	-0.01935	0.00000	0.00000	0.00000	1.0000000000	1.0000000000	0.38721	-0.47219	3	53	0	5	0	0	0.00000	0.00000
96	283371005	Laceration of forearm	72	35999006	Blighted ovum	1095	75	53	5	70	48	972	1.37736	0.02308	1.44643	3.74921	0.55803	0.4024642165	1.0000000000	3.63014	0.37391	39	53	5	36	0	0	2.45101	2.17475
94	703151001	History of single seizure (situation)	72	35999006	Blighted ovum	1095	39	53	2	37	51	1005	1.05951	0.00258	1.06518	4.54288	0.24976	0.7129355678	1.0000000000	1.88767	0.05506	14	53	2	25	0	0	3.31419	2.07944
93	128613002	Seizure disorder	72	35999006	Blighted ovum	1095	39	53	2	37	51	1005	1.05951	0.00258	1.06518	4.54288	0.24976	0.7129355678	1.0000000000	1.88767	0.05506	14	53	2	25	0	0	3.31419	2.07944
89	47693006	Rupture of appendix	72	35999006	Blighted ovum	1095	20	53	2	18	51	1024	2.06604	0.03279	2.23094	9.87605	0.50395	0.2518212279	0.9133257124	0.96804	0.60821	10	53	2	10	0	0	3.31419	1.79176
86	713197008	Recurrent rectal polyp	72	35999006	Blighted ovum	1095	22	53	1	21	52	1021	0.93911	-0.00197	0.93498	7.08599	0.12337	1.0000000000	1.0000000000	1.06484	-0.04603	12	53	1	10	0	0	3.98898	2.56495
75	431855005	Chronic kidney disease stage 1 (disorder)	72	35999006	Blighted ovum	1095	28	53	2	26	51	1016	1.47574	0.01738	1.53243	6.63473	0.35395	0.6419780779	1.0000000000	1.35525	0.34908	10	53	2	18	0	0	3.31419	1.79176
69	233604007	Pneumonia	72	35999006	Blighted ovum	1095	7	53	1	6	52	1036	2.95148	0.03530	3.32051	28.08877	0.39253	0.2940891927	0.9804462338	0.33881	0.57905	3	53	1	4	0	0	3.98898	1.38629
116	370143000	Major depression disorder	34	72892002	Normal pregnancy	1095	8	384	3	5	381	706	1.06934	0.00437	1.11181	4.67748	0.26427	1.0000000000	1.0000000000	2.80548	0.07192	3	384	3	5	0	0	4.85981	0.69315
67	403191005	Second degree burn	72	35999006	Blighted ovum	1095	49	53	4	45	49	997	1.68656	0.03351	1.80862	5.23113	0.62531	0.2918535599	0.9783965127	2.37169	0.56846	23	53	4	26	0	0	2.65676	1.90954
118	48333001	Burn injury(morphologic abnormality)	34	72892002	Normal pregnancy	1095	1	384	0	1	384	710	0.00000	-0.02222	0.00000	0.00000	0.00000	1.0000000000	1.0000000000	0.35068	-0.43369	0	384	0	1	0	0	0.00000	0.00000
119	275272006	Brain damage - traumatic	34	72892002	Normal pregnancy	1095	4	384	0	4	384	707	0.00000	-0.04450	0.00000	0.00000	0.00000	0.3039494249	0.9949586182	1.40274	-1.26468	0	384	0	4	0	0	0.00000	0.00000
64	444448004	Injury of medial collateral ligament of knee	72	35999006	Blighted ovum	1095	32	53	4	28	49	1014	2.58255	0.06193	2.95627	8.75907	0.99777	0.0643032624	0.4935519847	1.54886	0.97208	17	53	4	15	0	0	2.65676	1.65823
63	68496003	Polyp of colon	72	35999006	Blighted ovum	1095	91	53	8	83	45	959	1.81630	0.05543	2.05408	4.50228	0.93714	0.0742142139	0.5403135912	4.40457	0.73575	43	53	8	48	0	0	2.03143	1.85238
123	195967001	Asthma	34	72892002	Normal pregnancy	1095	2	384	1	1	383	710	1.42578	0.01339	1.85379	29.72014	0.11563	1.0000000000	1.0000000000	0.70137	0.23330	1	384	1	1	0	0	5.95324	0.69315
126	698754002	Chronic paralysis due to lesion of spinal cord	34	72892002	Normal pregnancy	1095	2	384	1	1	383	710	1.42578	0.01339	1.85379	29.72014	0.11563	1.0000000000	1.0000000000	0.70137	0.23330	2	384	1	0	0	0	5.95324	1.09861
127	431856006	Chronic kidney disease stage 2 (disorder)	34	72892002	Normal pregnancy	1095	5	384	3	2	381	709	1.71094	0.03539	2.79134	16.77759	0.46440	0.3506573863	1.0000000000	1.75342	0.53877	3	384	3	2	0	0	4.85981	0.69315
128	86849004	Suicidal deliberate poisoning	34	72892002	Normal pregnancy	1095	1	384	0	1	384	710	0.00000	-0.02222	0.00000	0.00000	0.00000	1.0000000000	1.0000000000	0.35068	-0.43369	0	384	0	1	0	0	0.00000	0.00000
118	48333001	Burn injury(morphologic abnormality)	97	403192003	Third degree burn	1095	1	8	0	1	8	1086	0.00000	-0.00259	0.00000	0.00000	0.00000	1.0000000000	1.0000000000	0.00731	-0.01050	0	3	0	1	5	0	0.00000	0.00000
130	314994000	Metastasis from malignant tumor of prostate (disorder)	34	72892002	Normal pregnancy	1095	1	384	0	1	384	710	0.00000	-0.02222	0.00000	0.00000	0.00000	1.0000000000	1.0000000000	0.35068	-0.43369	0	384	0	1	0	0	0.00000	0.00000
131	93761005	Primary malignant neoplasm of colon	34	72892002	Normal pregnancy	1095	5	384	3	2	381	709	1.71094	0.03539	2.79134	16.77759	0.46440	0.3506573863	1.0000000000	1.75342	0.53877	3	384	3	2	0	0	4.85981	0.69315
132	69896004	Rheumatoid arthritis	34	72892002	Normal pregnancy	1095	3	384	2	1	382	710	1.90104	0.03471	3.71728	41.12720	0.33599	0.2824986551	0.9648922936	1.05205	0.54789	2	384	2	1	0	0	5.26269	0.69315
133	97331000119101	Macular edema and retinopathy due to type 2 diabetes mellitus (disorder)	34	72892002	Normal pregnancy	1095	4	384	2	2	382	709	1.42578	0.01895	1.85602	13.22812	0.26042	0.6155045907	1.0000000000	1.40274	0.32028	2	384	2	2	0	0	5.26269	0.69315
49	88805009	Chronic congestive heart failure (disorder)	72	35999006	Blighted ovum	1095	10	53	1	9	52	1033	2.06604	0.02308	2.20726	17.75087	0.27447	0.3923929893	1.0000000000	0.48402	0.43049	5	53	1	5	0	0	3.98898	1.79176
47	359817006	Closed fracture of hip	72	35999006	Blighted ovum	1095	29	53	0	29	53	1013	0.00000	-0.03720	0.00000	0.00000	0.00000	0.3942651595	1.0000000000	1.40365	-1.26523	11	53	0	18	0	0	0.00000	0.00000
44	58150001	Fracture of clavicle	72	35999006	Blighted ovum	1095	112	53	10	102	43	940	1.84468	0.06430	2.14318	4.39333	1.04550	0.0574832422	0.4684968231	5.42100	0.77663	55	53	10	57	0	0	1.84055	1.87180
43	307731004	Injury of tendon of the rotator cuff of shoulder	72	35999006	Blighted ovum	1095	51	53	4	47	49	995	1.62042	0.03093	1.72818	4.98996	0.59852	0.3046771262	0.9953175875	2.46849	0.52762	26	53	4	25	0	0	2.65676	2.01490
42	16114001	Fracture of ankle	72	35999006	Blighted ovum	1095	108	53	8	100	45	942	1.53040	0.03957	1.67467	3.65240	0.76785	0.2315455690	0.8918415992	5.22740	0.53130	48	53	8	60	0	0	2.03143	1.94591
41	283385000	Laceration of thigh	72	35999006	Blighted ovum	1095	105	53	10	95	43	947	1.96765	0.07107	2.31824	4.76126	1.12874	0.0285323153	0.3115132637	5.08219	0.85484	50	53	10	55	0	0	1.84055	1.79176
39	74400008	Appendicitis	72	35999006	Blighted ovum	1095	51	53	2	49	51	993	0.81021	-0.00946	0.79472	3.35976	0.18798	1.0000000000	1.0000000000	2.46849	-0.20935	27	53	2	24	0	0	3.31419	2.67415
38	398254007	Preeclampsia	72	35999006	Blighted ovum	1095	101	53	14	87	39	955	2.86381	0.13399	3.94047	7.53980	2.05937	0.0001519137	0.0050320712	4.88858	1.34897	101	53	14	0	0	0	1.56564	2.10587
35	19169002	Miscarriage in first trimester	72	35999006	Blighted ovum	1095	174	53	53	121	0	921	6.29310	0.51887	0.00000	0.00000	0.00000	0.0000000000	0.0000000000	8.42192	2.51887	174	53	53	0	0	0	0.69315	1.45466
33	429007001	History of cardiac arrest (situation)	72	35999006	Blighted ovum	1095	42	53	3	39	50	1003	1.47574	0.02143	1.54308	5.16517	0.46099	0.4517328053	1.0000000000	2.03288	0.39931	24	53	3	18	0	0	2.92674	2.19722
32	410429000	Cardiac Arrest	72	35999006	Blighted ovum	1095	42	53	3	39	50	1003	1.47574	0.02143	1.54308	5.16517	0.46099	0.4517328053	1.0000000000	2.03288	0.39931	24	53	3	18	0	0	2.92674	2.19722
27	408512008	Body mass index 40+ - severely obese (finding)	72	35999006	Blighted ovum	1095	97	53	12	85	41	957	2.55592	0.10940	3.29527	6.50744	1.66867	0.0014628021	0.0333518886	4.69498	1.19075	67	53	12	30	0	0	1.68948	1.88454
21	15777000	Prediabetes	72	35999006	Blighted ovum	1095	333	53	25	308	28	734	1.55108	0.08216	2.12778	3.70826	1.22091	0.0089121047	0.1414655609	16.11781	0.60301	159	53	25	174	0	0	1.13783	1.99606
20	80394007	Hyperglycemia (disorder)	72	35999006	Blighted ovum	1095	55	53	4	51	49	991	1.50257	0.02607	1.58623	4.56629	0.55103	0.3341529984	1.0000000000	2.66210	0.44926	23	53	4	32	0	0	2.65676	1.90954
18	302870006	Hypertriglyceridemia (disorder)	72	35999006	Blighted ovum	1095	64	53	4	60	49	982	1.29127	0.01637	1.33605	3.82561	0.46660	0.5446666602	1.0000000000	3.09772	0.28711	28	53	4	36	0	0	2.65676	2.07944
130	314994000	Metastasis from malignant tumor of prostate (disorder)	46	62564004	Concussion with loss of consciousness	1095	1	67	0	1	67	1027	0.00000	-0.00772	0.00000	0.00000	0.00000	1.0000000000	1.0000000000	0.06119	-0.08568	0	36	0	1	31	0	0.00000	0.00000
129	47505003	Posttraumatic stress disorder	46	62564004	Concussion with loss of consciousness	1095	4	67	0	4	67	1024	0.00000	-0.01546	0.00000	0.00000	0.00000	1.0000000000	1.0000000000	0.24475	-0.31585	1	36	0	3	31	0	0.00000	0.00000
15	40055000	Chronic sinusitis (disorder)	72	35999006	Blighted ovum	1095	216	53	15	201	38	841	1.43475	0.04860	1.65161	3.06147	0.89101	0.1126040411	0.6611627244	10.45479	0.48212	104	53	15	112	0	0	1.51146	2.07107
14	10509002	Acute bronchitis (disorder)	72	35999006	Blighted ovum	1095	863	53	48	815	5	227	1.14913	0.06487	2.67387	6.79537	1.05212	0.0369944767	0.3610026234	41.77078	0.19616	418	53	48	445	0	0	0.74392	2.27298
125	1734006	Fracture of the vertebral column with spinal cord injury	46	62564004	Concussion with loss of consciousness	1095	5	67	0	5	67	1023	0.00000	-0.01729	0.00000	0.00000	0.00000	1.0000000000	1.0000000000	0.30594	-0.38508	3	36	0	2	31	0	0.00000	0.00000
124	1501000119109	Proliferative diabetic retinopathy due to type II diabetes mellitus (disorder)	46	62564004	Concussion with loss of consciousness	1095	1	67	0	1	67	1027	0.00000	-0.00772	0.00000	0.00000	0.00000	1.0000000000	1.0000000000	0.06119	-0.08568	1	36	0	0	31	0	0.00000	0.00000
10	62106007	Concussion with no loss of consciousness	72	35999006	Blighted ovum	1095	206	53	16	190	37	852	1.60469	0.06565	1.93912	3.55869	1.05662	0.0451559607	0.4084765375	9.97078	0.63187	96	53	16	110	0	0	1.46152	1.94591
121	254637007	Non-small cell lung cancer (disorder)	46	62564004	Concussion with loss of consciousness	1095	8	67	0	8	67	1020	0.00000	-0.02190	0.00000	0.00000	0.00000	1.0000000000	1.0000000000	0.48950	-0.57483	0	36	0	8	31	0	0.00000	0.00000
120	162573006	Suspected lung cancer (situation)	46	62564004	Concussion with loss of consciousness	1095	8	67	0	8	67	1020	0.00000	-0.02190	0.00000	0.00000	0.00000	1.0000000000	1.0000000000	0.48950	-0.57483	0	36	0	8	31	0	0.00000	0.00000
6	39848009	Whiplash injury to neck	72	35999006	Blighted ovum	1095	182	53	13	169	40	873	1.47574	0.04790	1.67885	3.20640	0.87903	0.1286008458	0.7046555710	8.80913	0.51323	92	53	13	90	0	0	1.62471	2.08901
118	48333001	Burn injury(morphologic abnormality)	46	62564004	Concussion with loss of consciousness	1095	1	67	0	1	67	1027	0.00000	-0.00772	0.00000	0.00000	0.00000	1.0000000000	1.0000000000	0.06119	-0.08568	0	36	0	1	31	0	0.00000	0.00000
117	230265002	Familial Alzheimer's disease of early onset (disorder)	46	62564004	Concussion with loss of consciousness	1095	6	67	0	6	67	1022	0.00000	-0.01895	0.00000	0.00000	0.00000	1.0000000000	1.0000000000	0.36712	-0.45114	2	36	0	4	31	0	0.00000	0.00000
115	36923009	Major depression  single episode	46	62564004	Concussion with loss of consciousness	1095	6	67	0	6	67	1022	0.00000	-0.01895	0.00000	0.00000	0.00000	1.0000000000	1.0000000000	0.36712	-0.45114	3	36	0	3	31	0	0.00000	0.00000
114	449868002	Smokes tobacco daily	46	62564004	Concussion with loss of consciousness	1095	9	67	0	9	67	1019	0.00000	-0.02324	0.00000	0.00000	0.00000	1.0000000000	1.0000000000	0.55068	-0.63291	2	36	0	7	31	0	0.00000	0.00000
111	235919008	Cholelithiasis	46	62564004	Concussion with loss of consciousness	1095	9	67	1	8	66	1020	1.81592	0.01896	1.93182	15.67664	0.23806	0.4347046993	1.0000000000	0.55068	0.36709	7	36	1	2	31	0	3.61092	2.07944
109	90560007	Gout	46	62564004	Concussion with loss of consciousness	1095	4	67	0	4	67	1024	0.00000	-0.01546	0.00000	0.00000	0.00000	1.0000000000	1.0000000000	0.24475	-0.31585	0	36	0	4	31	0	0.00000	0.00000
108	40930008	Hypothyroidism (disorder)	46	62564004	Concussion with loss of consciousness	1095	13	67	3	10	64	1018	3.77153	0.07756	4.77187	17.76869	1.28151	0.0402557954	0.3845107420	0.79543	1.15567	11	36	3	2	31	0	2.56495	1.54045
107	40275004	Contact dermatitis	46	62564004	Concussion with loss of consciousness	1095	18	67	1	17	66	1011	0.90796	-0.00304	0.90107	6.87526	0.11809	1.0000000000	1.0000000000	1.10137	-0.07133	9	36	0	9	31	1	-3.46574	-2.30259
106	24079001	Atopic dermatitis	46	62564004	Concussion with loss of consciousness	1095	20	67	1	19	66	1009	0.81716	-0.00637	0.80463	6.10351	0.10607	1.0000000000	1.0000000000	1.22374	-0.15299	13	36	1	7	31	0	3.61092	2.63906
105	363406005	Malignant tumor of colon	46	62564004	Concussion with loss of consciousness	1095	6	67	0	6	67	1022	0.00000	-0.01895	0.00000	0.00000	0.00000	1.0000000000	1.0000000000	0.36712	-0.45114	4	36	0	2	31	0	0.00000	0.00000
104	367498001	Seasonal allergic rhinitis	46	62564004	Concussion with loss of consciousness	1095	20	67	1	19	66	1009	0.81716	-0.00637	0.80463	6.10351	0.10607	1.0000000000	1.0000000000	1.22374	-0.15299	9	36	1	11	31	0	3.61092	2.30259
102	90781000119102	Microalbuminuria due to type 2 diabetes mellitus (disorder)	46	62564004	Concussion with loss of consciousness	1095	6	67	0	6	67	1022	0.00000	-0.01895	0.00000	0.00000	0.00000	1.0000000000	1.0000000000	0.36712	-0.45114	3	36	0	3	31	0	0.00000	0.00000
101	433144002	Chronic kidney disease stage 3 (disorder)	46	62564004	Concussion with loss of consciousness	1095	3	67	0	3	67	1025	0.00000	-0.01338	0.00000	0.00000	0.00000	1.0000000000	1.0000000000	0.18356	-0.24313	1	36	0	2	31	0	0.00000	0.00000
100	161622006	History of lower limb amputation (situation)	46	62564004	Concussion with loss of consciousness	1095	1	67	0	1	67	1027	0.00000	-0.00772	0.00000	0.00000	0.00000	1.0000000000	1.0000000000	0.06119	-0.08568	0	36	0	1	31	0	0.00000	0.00000
98	1551000119108	Nonproliferative diabetic retinopathy due to type 2 diabetes mellitus (disorder)	46	62564004	Concussion with loss of consciousness	1095	12	67	0	12	67	1016	0.00000	-0.02687	0.00000	0.00000	0.00000	1.0000000000	1.0000000000	0.73425	-0.79431	7	36	0	5	31	0	0.00000	0.00000
97	403192003	Third degree burn	46	62564004	Concussion with loss of consciousness	1095	8	67	0	8	67	1020	0.00000	-0.02190	0.00000	0.00000	0.00000	1.0000000000	1.0000000000	0.48950	-0.57483	3	36	0	5	31	0	0.00000	0.00000
96	283371005	Laceration of forearm	46	62564004	Concussion with loss of consciousness	1095	75	67	6	69	61	959	1.30746	0.02128	1.36707	3.27432	0.57077	0.4526097792	1.0000000000	4.58904	0.32475	39	36	5	36	31	1	-1.36160	-1.43617
95	84757009	Epilepsy	46	62564004	Concussion with loss of consciousness	1095	30	67	2	28	65	1000	1.08955	0.00384	1.09890	4.71445	0.25615	0.7051895185	1.0000000000	1.83562	0.08130	13	36	0	17	31	2	-2.80336	-2.25129
94	703151001	History of single seizure (situation)	46	62564004	Concussion with loss of consciousness	1095	39	67	3	36	64	992	1.25718	0.01262	1.29167	4.30831	0.38725	0.7279317647	1.0000000000	2.38630	0.24029	14	36	0	25	31	3	-2.42775	-2.23359
93	128613002	Seizure disorder	46	62564004	Concussion with loss of consciousness	1095	39	67	3	36	64	992	1.25718	0.01262	1.29167	4.30831	0.38725	0.7279317647	1.0000000000	2.38630	0.24029	14	36	0	25	31	3	-2.42775	-2.23359
118	48333001	Burn injury(morphologic abnormality)	98	1551000119108	Nonproliferative diabetic retinopathy due to type 2 diabetes mellitus (disorder)	1095	1	12	0	1	12	1082	0.00000	-0.00318	0.00000	0.00000	0.00000	1.0000000000	1.0000000000	0.01096	-0.01572	0	7	0	1	5	0	0.00000	0.00000
89	47693006	Rupture of appendix	46	62564004	Concussion with loss of consciousness	1095	20	67	4	16	63	1012	3.26866	0.07900	4.01587	12.36759	1.30399	0.0294847730	0.3166312918	1.22374	1.16894	10	36	3	10	31	1	-0.90079	-0.93156
86	713197008	Recurrent rectal polyp	46	62564004	Concussion with loss of consciousness	1095	22	67	0	22	67	1006	0.00000	-0.03656	0.00000	0.00000	0.00000	0.3927094716	1.0000000000	1.34612	-1.23028	12	36	0	10	31	0	0.00000	0.00000
82	94260004	Secondary malignant neoplasm of colon	46	62564004	Concussion with loss of consciousness	1095	4	67	0	4	67	1024	0.00000	-0.01546	0.00000	0.00000	0.00000	1.0000000000	1.0000000000	0.24475	-0.31585	2	36	0	2	31	0	0.00000	0.00000
80	6072007	Bleeding from anus	46	62564004	Concussion with loss of consciousness	1095	4	67	0	4	67	1024	0.00000	-0.01546	0.00000	0.00000	0.00000	1.0000000000	1.0000000000	0.24475	-0.31585	2	36	0	2	31	0	0.00000	0.00000
78	239872002	Osteoarthritis of hip	46	62564004	Concussion with loss of consciousness	1095	21	67	4	17	63	1011	3.11301	0.07543	3.77591	11.55562	1.23381	0.0347796054	0.3505113392	1.28493	1.12978	13	36	3	8	31	1	-0.90079	-0.52325
76	127013003	Diabetic renal disease (disorder)	46	62564004	Concussion with loss of consciousness	1095	28	67	0	28	67	1000	0.00000	-0.04136	0.00000	0.00000	0.00000	0.4093228976	1.0000000000	1.71324	-1.44002	10	36	0	18	31	0	0.00000	0.00000
75	431855005	Chronic kidney disease stage 1 (disorder)	46	62564004	Concussion with loss of consciousness	1095	28	67	0	28	67	1000	0.00000	-0.04136	0.00000	0.00000	0.00000	0.4093228976	1.0000000000	1.71324	-1.44002	10	36	0	18	31	0	0.00000	0.00000
73	196416002	Impacted molars	46	62564004	Concussion with loss of consciousness	1095	49	67	4	45	63	983	1.33415	0.01846	1.38695	3.97874	0.48348	0.5353416373	1.0000000000	2.99817	0.32259	25	36	3	24	31	1	-0.90079	-0.98528
72	35999006	Blighted ovum	46	62564004	Concussion with loss of consciousness	1095	53	67	7	46	60	982	2.15855	0.06671	2.49058	5.75064	1.07866	0.0378070303	0.3669636219	3.24292	0.91494	53	36	7	0	31	0	1.81529	2.14843
71	201834006	Localized  primary osteoarthritis of the hand	46	62564004	Concussion with loss of consciousness	1095	28	67	2	26	65	1002	1.16738	0.00692	1.18580	5.10568	0.27540	0.6873436573	1.0000000000	1.71324	0.14494	19	36	2	9	31	0	2.94444	2.35138
70	87433001	Pulmonary emphysema (disorder)	46	62564004	Concussion with loss of consciousness	1095	17	67	2	15	65	1013	1.92274	0.02958	2.07795	9.28084	0.46525	0.2793068505	0.9574808819	1.04018	0.55626	9	36	1	8	31	1	0.14518	0.10536
69	233604007	Pneumonia	46	62564004	Concussion with loss of consciousness	1095	7	67	1	6	66	1022	2.33475	0.02733	2.58081	21.75171	0.30621	0.3580400999	1.0000000000	0.42831	0.48569	3	36	1	4	31	0	3.61092	1.38629
68	26929004	Alzheimer's disease (disorder)	46	62564004	Concussion with loss of consciousness	1095	23	67	1	22	66	1006	0.71058	-0.01082	0.69284	5.21986	0.09196	1.0000000000	1.0000000000	1.40731	-0.26742	15	36	1	8	31	0	3.61092	2.77259
67	403191005	Second degree burn	46	62564004	Concussion with loss of consciousness	1095	49	67	5	44	62	984	1.66768	0.03689	1.80352	4.70991	0.69060	0.2169583953	0.8708096907	2.99817	0.58562	23	36	1	26	31	4	1.44186	1.16315
65	239873007	Osteoarthritis of knee	46	62564004	Concussion with loss of consciousness	1095	57	67	2	55	65	973	0.57345	-0.02552	0.54434	2.28156	0.12987	0.5731592709	1.0000000000	3.48767	-0.58100	30	36	2	27	31	0	2.94444	2.77259
64	444448004	Injury of medial collateral ligament of knee	46	62564004	Concussion with loss of consciousness	1095	32	67	2	30	65	998	1.02146	0.00095	1.02359	4.37758	0.23934	1.0000000000	1.0000000000	1.95799	0.02034	17	36	2	15	31	0	2.94444	2.25129
63	68496003	Polyp of colon	46	62564004	Concussion with loss of consciousness	1095	91	67	9	82	58	946	1.61637	0.04737	1.79016	3.74285	0.85621	0.1646616772	0.7911405508	5.56804	0.60647	43	36	5	48	31	4	-0.06492	-0.30319
59	262574004	Bullet wound	46	62564004	Concussion with loss of consciousness	1095	20	67	1	19	66	1009	0.81716	-0.00637	0.80463	6.10351	0.10607	1.0000000000	1.0000000000	1.22374	-0.15299	9	36	1	11	31	0	3.61092	2.30259
58	239720000	Tear of meniscus of knee	46	62564004	Concussion with loss of consciousness	1095	20	67	2	18	65	1010	1.63433	0.02209	1.72650	7.60145	0.39213	0.3489725409	1.0000000000	1.22374	0.43197	10	36	2	10	31	0	2.94444	1.79176
57	192127007	Child attention deficit disorder	46	62564004	Concussion with loss of consciousness	1095	76	67	7	69	60	959	1.50530	0.03523	1.62150	3.68180	0.71412	0.2195520562	0.8768098041	4.65023	0.50169	24	36	3	52	31	4	0.39590	-0.44183
56	92691004	Carcinoma in situ of prostate (disorder)	46	62564004	Concussion with loss of consciousness	1095	23	67	0	23	67	1005	0.00000	-0.03739	0.00000	0.00000	0.00000	0.3923454948	1.0000000000	1.40731	-1.26742	0	36	0	23	31	0	0.00000	0.00000
54	5602001	Opioid abuse (disorder)	46	62564004	Concussion with loss of consciousness	1095	7	67	0	7	67	1021	0.00000	-0.02048	0.00000	0.00000	0.00000	1.0000000000	1.0000000000	0.42831	-0.51431	0	36	0	7	31	0	0.00000	0.00000
52	124171000119105	Chronic intractable migraine without aura	46	62564004	Concussion with loss of consciousness	1095	51	67	4	47	63	981	1.28183	0.01590	1.32523	3.79514	0.46276	0.5468399592	1.0000000000	3.12055	0.27909	21	36	3	30	31	1	-0.90079	-1.35455
50	446096008	Perennial allergic rhinitis	46	62564004	Concussion with loss of consciousness	1095	26	67	0	26	67	1002	0.00000	-0.03981	0.00000	0.00000	0.00000	0.3991821097	1.0000000000	1.59087	-1.37344	14	36	0	12	31	0	0.00000	0.00000
49	88805009	Chronic congestive heart failure (disorder)	46	62564004	Concussion with loss of consciousness	1095	10	67	2	8	65	1020	3.26866	0.05560	3.92308	18.85014	0.81647	0.1208252644	0.6887664724	0.61187	0.89623	5	36	1	5	31	1	0.14518	0.00000
47	359817006	Closed fracture of hip	46	62564004	Concussion with loss of consciousness	1095	29	67	4	25	63	1003	2.25425	0.05281	2.54730	7.54417	0.86010	0.0957112291	0.6155535021	1.77443	0.84974	11	36	2	18	31	2	0.14108	-0.43078
45	263102004	Fracture subluxation of wrist	46	62564004	Concussion with loss of consciousness	1095	109	67	7	102	60	926	1.04957	0.00421	1.05915	2.37869	0.47160	0.8337373186	1.0000000000	6.66941	0.06089	51	36	4	58	31	3	-0.12516	-0.39122
44	58150001	Fracture of clavicle	46	62564004	Concussion with loss of consciousness	1095	112	67	6	106	61	922	0.87553	-0.01073	0.85555	2.02654	0.36119	0.8377281888	1.0000000000	6.85297	-0.16588	55	36	4	57	31	2	-0.50078	-0.69315
43	307731004	Injury of tendon of the rotator cuff of shoulder	46	62564004	Concussion with loss of consciousness	1095	51	67	3	48	64	980	0.96137	-0.00218	0.95703	3.15690	0.29013	1.0000000000	1.0000000000	3.12055	-0.04284	26	36	3	25	31	0	2.56495	2.26868
42	16114001	Fracture of ankle	46	62564004	Concussion with loss of consciousness	1095	108	67	8	100	59	928	1.21061	0.01779	1.25831	2.70872	0.58453	0.5262748427	1.0000000000	6.60822	0.24237	48	36	4	60	31	4	0.13353	-0.20764
41	283385000	Laceration of thigh	46	62564004	Concussion with loss of consciousness	1095	105	67	8	97	59	931	1.24520	0.02039	1.30142	2.80367	0.60409	0.5181168017	1.0000000000	6.42466	0.27760	50	36	3	55	31	5	0.59087	0.38677
39	74400008	Appendicitis	46	62564004	Concussion with loss of consciousness	1095	51	67	6	45	61	983	1.92274	0.05207	2.14863	5.23336	0.88215	0.1220498430	0.6889733259	3.12055	0.76452	27	36	4	24	31	2	-0.50078	-0.51726
38	398254007	Preeclampsia	46	62564004	Concussion with loss of consciousness	1095	101	67	4	97	63	931	0.64726	-0.02871	0.60939	1.71041	0.21712	0.5108891339	1.0000000000	6.17991	-0.52204	101	36	4	0	31	0	2.30259	3.26767
35	19169002	Miscarriage in first trimester	46	62564004	Concussion with loss of consciousness	1095	174	67	15	159	52	869	1.40890	0.04537	1.57656	2.86921	0.86628	0.1651840865	0.7915572889	10.64658	0.45817	174	36	15	0	31	0	1.22378	2.53370
33	429007001	History of cardiac arrest (situation)	46	62564004	Concussion with loss of consciousness	1095	42	67	5	37	62	991	1.94563	0.04821	2.15998	5.68926	0.82006	0.1748304949	0.8000743861	2.56986	0.74909	24	36	2	18	31	3	0.51669	0.61904
32	410429000	Cardiac Arrest	46	62564004	Concussion with loss of consciousness	1095	42	67	5	37	62	991	1.94563	0.04821	2.15998	5.68926	0.82006	0.1748304949	0.8000743861	2.56986	0.74909	24	36	2	18	31	3	0.51669	0.61904
30	399211009	History of myocardial infarction (situation)	46	62564004	Concussion with loss of consciousness	1095	31	67	2	29	65	999	1.05441	0.00237	1.05995	4.53995	0.24747	0.7142414460	1.0000000000	1.89680	0.05050	2	36	0	29	31	2	-2.80336	-2.74084
29	22298006	Myocardial Infarction	46	62564004	Concussion with loss of consciousness	1095	31	67	2	29	65	999	1.05441	0.00237	1.05995	4.53995	0.24747	0.7142414460	1.0000000000	1.89680	0.05050	2	36	0	29	31	2	-2.80336	-2.74084
27	408512008	Body mass index 40+ - severely obese (finding)	46	62564004	Concussion with loss of consciousness	1095	97	67	12	85	55	943	2.02185	0.08133	2.42053	4.69612	1.24762	0.0129728004	0.1836697454	5.93516	0.90651	67	36	10	30	31	2	-1.27730	-0.73137
24	162864005	Body mass index 30+ - obesity (finding)	46	62564004	Concussion with loss of consciousness	1095	439	67	38	401	29	627	1.41468	0.08660	2.04884	3.37548	1.24360	0.0064869185	0.1114328184	26.86119	0.48522	226	36	22	213	31	16	-0.10816	-0.23875
23	36971009	Sinusitis (disorder)	46	62564004	Concussion with loss of consciousness	1095	190	67	16	174	51	854	1.37628	0.04401	1.53978	2.76334	0.85799	0.1807154059	0.8126638488	11.62557	0.42919	84	36	7	106	31	9	0.32364	0.01724
21	15777000	Prediabetes	46	62564004	Concussion with loss of consciousness	1095	333	67	17	316	50	712	0.83434	-0.02796	0.76608	1.34921	0.43497	0.4119126523	1.0000000000	20.37534	-0.24795	159	36	11	174	31	6	-0.36691	-0.66329
20	80394007	Hyperglycemia (disorder)	46	62564004	Concussion with loss of consciousness	1095	55	67	1	54	66	974	0.29715	-0.04126	0.27329	2.00662	0.03722	0.2486404131	0.9133257124	3.36530	-1.12608	23	36	1	32	31	0	3.61092	3.17805
19	237602007	Metabolic syndrome X (disorder)	46	62564004	Concussion with loss of consciousness	1095	64	67	1	63	66	965	0.25536	-0.04736	0.23208	1.69974	0.03169	0.1736180952	0.7996618359	3.91598	-1.29748	28	36	1	36	31	0	3.61092	3.36730
18	302870006	Hypertriglyceridemia (disorder)	46	62564004	Concussion with loss of consciousness	1095	64	67	1	63	66	965	0.25536	-0.04736	0.23208	1.69974	0.03169	0.1736180952	0.7996618359	3.91598	-1.29748	28	36	1	36	31	0	3.61092	3.36730
17	368581000119106	Neuropathy due to type 2 diabetes mellitus (disorder)	46	62564004	Concussion with loss of consciousness	1095	28	67	0	28	67	1000	0.00000	-0.04136	0.00000	0.00000	0.00000	0.4093228976	1.0000000000	1.71324	-1.44002	7	36	0	21	31	0	0.00000	0.00000
15	40055000	Chronic sinusitis (disorder)	46	62564004	Concussion with loss of consciousness	1095	216	67	16	200	51	828	1.21061	0.02665	1.29882	2.32547	0.72542	0.4273049168	1.0000000000	13.21644	0.25797	104	36	11	112	31	5	-0.52183	-0.80570
14	10509002	Acute bronchitis (disorder)	46	62564004	Concussion with loss of consciousness	1095	863	67	55	808	12	220	1.04158	0.02047	1.24794	2.37146	0.65670	0.6431553194	1.0000000000	52.80457	0.05770	418	36	32	445	31	23	-0.09972	-0.36946
13	370247008	Facial laceration	46	62564004	Concussion with loss of consciousness	1095	109	67	9	100	58	928	1.34945	0.02966	1.44000	2.99367	0.69266	0.2965284278	0.9844654081	6.66941	0.38281	55	36	6	54	31	3	-0.48184	-0.62532
125	1734006	Fracture of the vertebral column with spinal cord injury	20	80394007	Hyperglycemia (disorder)	1095	5	55	0	5	55	1035	0.00000	-0.01558	0.00000	0.00000	0.00000	1.0000000000	1.0000000000	0.25114	-0.32325	3	23	0	2	32	0	0.00000	0.00000
10	62106007	Concussion with no loss of consciousness	46	62564004	Concussion with loss of consciousness	1095	206	67	12	194	55	834	0.95204	-0.00589	0.93796	1.78545	0.49274	1.0000000000	1.0000000000	12.60457	-0.06558	96	36	8	110	31	4	-0.46431	-0.78495
8	233678006	Childhood asthma	46	62564004	Concussion with loss of consciousness	1095	45	67	3	42	64	986	1.08955	0.00473	1.10045	3.64733	0.33202	0.7519454695	1.0000000000	2.75342	0.09179	25	36	3	20	31	0	2.56495	2.23359
7	75498004	Acute bacterial sinusitis (disorder)	46	62564004	Concussion with loss of consciousness	1095	187	67	16	171	51	857	1.39836	0.04615	1.57230	2.82259	0.87583	0.1322486713	0.7140816678	11.44201	0.45032	89	36	12	98	31	4	-0.78276	-1.10846
6	39848009	Whiplash injury to neck	46	62564004	Concussion with loss of consciousness	1095	182	67	12	170	55	858	1.07758	0.00884	1.10118	2.10048	0.57729	0.7360895443	1.0000000000	11.13607	0.09921	92	36	7	90	31	5	-0.15879	-0.29523
5	284549007	Laceration of hand	46	62564004	Concussion with loss of consciousness	1095	104	67	9	95	58	933	1.41432	0.03427	1.52396	3.17254	0.73205	0.2784611073	0.9565195531	6.36347	0.44154	54	36	5	50	31	4	-0.06492	-0.13459
117	230265002	Familial Alzheimer's disease of early onset (disorder)	20	80394007	Hyperglycemia (disorder)	1095	6	55	2	4	53	1036	6.63636	0.09621	9.77358	54.56325	1.75068	0.0326315624	0.3329331866	0.30137	1.20493	2	23	2	4	32	0	2.52573	0.69315
1	444814009	Viral sinusitis (disorder)	46	62564004	Concussion with loss of consciousness	1095	993	67	65	928	2	100	1.06980	0.05560	3.50216	14.51940	0.84474	0.0796433939	0.5585774477	60.75890	0.09582	478	36	36	515	31	29	-0.03390	-0.27295
109	90560007	Gout	20	80394007	Hyperglycemia (disorder)	1095	4	55	0	4	55	1036	0.00000	-0.01392	0.00000	0.00000	0.00000	1.0000000000	1.0000000000	0.20091	-0.26413	0	23	0	4	32	0	0.00000	0.00000
102	90781000119102	Microalbuminuria due to type 2 diabetes mellitus (disorder)	20	80394007	Hyperglycemia (disorder)	1095	6	55	3	3	52	1037	9.95455	0.15285	19.94231	101.21098	3.92937	0.0021563168	0.0461662157	0.30137	1.61997	3	23	2	3	32	1	-0.97078	-0.47000
97	403192003	Third degree burn	20	80394007	Hyperglycemia (disorder)	1095	8	55	1	7	54	1033	2.48864	0.02937	2.73280	22.61036	0.33030	0.3387530268	1.0000000000	0.40183	0.51269	3	23	0	5	32	1	-3.49651	-1.79176
96	283371005	Laceration of forearm	20	80394007	Hyperglycemia (disorder)	1095	75	55	4	71	51	969	1.06182	0.00385	1.07042	3.04616	0.37615	0.7859112176	1.0000000000	3.76712	0.06881	39	23	3	36	32	1	-1.33702	-0.97186
94	703151001	History of single seizure (situation)	20	80394007	Hyperglycemia (disorder)	1095	39	55	1	38	54	1002	0.51049	-0.02163	0.48830	3.62394	0.06580	0.7171026815	1.0000000000	1.95890	-0.56506	14	23	0	25	32	1	-3.49651	-3.25810
93	128613002	Seizure disorder	20	80394007	Hyperglycemia (disorder)	1095	39	55	1	38	54	1002	0.51049	-0.02163	0.48830	3.62394	0.06580	0.7171026815	1.0000000000	1.95890	-0.56506	14	23	0	25	32	1	-3.49651	-3.25810
89	47693006	Rupture of appendix	20	80394007	Hyperglycemia (disorder)	1095	20	55	0	20	55	1020	0.00000	-0.03137	0.00000	0.00000	0.00000	0.6191825171	1.0000000000	1.00457	-1.00329	10	23	0	10	32	0	0.00000	0.00000
86	713197008	Recurrent rectal polyp	20	80394007	Hyperglycemia (disorder)	1095	22	55	2	20	53	1020	1.80992	0.02667	1.92453	8.45050	0.43829	0.3039387939	0.9949586182	1.10502	0.51113	12	23	1	10	32	1	-0.31845	0.16705
75	431855005	Chronic kidney disease stage 1 (disorder)	20	80394007	Hyperglycemia (disorder)	1095	28	55	22	6	33	1034	15.64286	0.54549	114.88889	302.14565	43.68574	0.0000000000	0.0000000000	1.40639	3.25669	10	23	8	18	32	14	0.16496	-0.01575
69	233604007	Pneumonia	20	80394007	Hyperglycemia (disorder)	1095	7	55	0	7	55	1033	0.00000	-0.01845	0.00000	0.00000	0.00000	1.0000000000	1.0000000000	0.35160	-0.43467	3	23	0	4	32	0	0.00000	0.00000
64	444448004	Injury of medial collateral ligament of knee	20	80394007	Hyperglycemia (disorder)	1095	32	55	3	29	52	1011	1.86648	0.03457	2.01127	6.81878	0.59325	0.2140442940	0.8672161313	1.60731	0.61744	17	23	2	15	32	1	-0.97078	-0.52130
49	88805009	Chronic congestive heart failure (disorder)	20	80394007	Hyperglycemia (disorder)	1095	10	55	0	10	55	1030	0.00000	-0.02208	0.00000	0.00000	0.00000	1.0000000000	1.0000000000	0.50228	-0.58716	5	23	0	5	32	0	0.00000	0.00000
47	359817006	Closed fracture of hip	20	80394007	Hyperglycemia (disorder)	1095	29	55	0	29	55	1011	0.00000	-0.03793	0.00000	0.00000	0.00000	0.3946795190	1.0000000000	1.45662	-1.29668	11	23	0	18	32	0	0.00000	0.00000
44	58150001	Fracture of clavicle	20	80394007	Hyperglycemia (disorder)	1095	112	55	7	105	48	935	1.24432	0.01896	1.29861	2.94329	0.57296	0.4941950517	1.0000000000	5.62557	0.27196	55	23	2	57	32	5	0.52425	0.83221
43	307731004	Injury of tendon of the rotator cuff of shoulder	20	80394007	Hyperglycemia (disorder)	1095	51	55	8	43	47	997	3.12299	0.10791	3.94656	8.86606	1.75674	0.0028498696	0.0575084034	2.56164	1.33738	26	23	3	25	32	5	0.15800	0.47692
42	16114001	Fracture of ankle	20	80394007	Hyperglycemia (disorder)	1095	108	55	4	104	51	936	0.73737	-0.01998	0.70588	1.99242	0.25008	0.6461976546	1.0000000000	5.42466	-0.36169	48	23	1	60	32	3	0.72132	0.84730
41	283385000	Laceration of thigh	20	80394007	Hyperglycemia (disorder)	1095	105	55	8	97	47	943	1.51688	0.03871	1.65475	3.60329	0.75991	0.2341590775	0.8975757128	5.27397	0.52055	50	23	4	55	32	4	-0.28768	-0.08855
39	74400008	Appendicitis	20	80394007	Hyperglycemia (disorder)	1095	51	55	1	50	54	990	0.39037	-0.03099	0.36667	2.70480	0.04971	0.5102482171	1.0000000000	2.56164	-0.83254	27	23	0	24	32	1	-3.49651	-3.21888
38	398254007	Preeclampsia	20	80394007	Hyperglycemia (disorder)	1095	101	55	10	91	45	949	1.97120	0.07119	2.31746	4.75238	1.13009	0.0284420944	0.3109149502	5.07306	0.85701	101	23	10	0	32	0	1.19392	2.40695
35	19169002	Miscarriage in first trimester	20	80394007	Hyperglycemia (disorder)	1095	174	55	15	159	40	881	1.71630	0.07160	2.07783	3.85086	1.12115	0.0232088299	0.2764275560	8.73973	0.71612	174	23	15	0	32	0	0.92954	2.53370
33	429007001	History of cardiac arrest (situation)	20	80394007	Hyperglycemia (disorder)	1095	42	55	1	41	54	999	0.47403	-0.02416	0.45122	3.34255	0.06091	0.7183825785	1.0000000000	2.10959	-0.63672	24	23	1	18	32	0	3.17805	3.21888
32	410429000	Cardiac Arrest	20	80394007	Hyperglycemia (disorder)	1095	42	55	1	41	54	999	0.47403	-0.02416	0.45122	3.34255	0.06091	0.7183825785	1.0000000000	2.10959	-0.63672	24	23	1	18	32	0	3.17805	3.21888
27	408512008	Body mass index 40+ - severely obese (finding)	20	80394007	Hyperglycemia (disorder)	1095	97	55	5	92	50	948	1.02624	0.00188	1.03043	2.64818	0.40095	1.0000000000	1.0000000000	4.87215	0.03107	67	23	4	30	32	1	-1.58697	-0.55760
21	15777000	Prediabetes	20	80394007	Hyperglycemia (disorder)	1095	333	55	36	297	19	743	2.15233	0.17518	4.74003	8.39703	2.67570	0.0000000707	0.0000042491	16.72603	1.06166	159	23	13	174	32	23	0.14673	0.43484
18	302870006	Hypertriglyceridemia (disorder)	20	80394007	Hyperglycemia (disorder)	1095	64	55	55	9	0	1031	17.10937	0.92300	0.00000	0.00000	0.00000	0.0000000000	0.0000000000	3.21461	3.73196	28	23	23	36	32	32	0.00000	0.04256
15	40055000	Chronic sinusitis (disorder)	20	80394007	Hyperglycemia (disorder)	1095	216	55	12	204	43	836	1.10606	0.01209	1.14364	2.20815	0.59231	0.7277570953	1.0000000000	10.84932	0.13371	104	23	6	112	32	6	-0.27029	-0.07020
14	10509002	Acute bronchitis (disorder)	20	80394007	Hyperglycemia (disorder)	1095	863	55	51	812	4	228	1.17655	0.07831	3.58005	10.01028	1.28036	0.0065323322	0.1117754624	43.34703	0.22967	418	23	20	445	32	31	0.05632	0.35506
10	62106007	Concussion with no loss of consciousness	20	80394007	Hyperglycemia (disorder)	1095	206	55	17	189	38	851	1.64298	0.07118	2.01434	3.64554	1.11302	0.0315618832	0.3275952503	10.34703	0.66568	96	23	8	110	32	9	-0.16180	-0.01695
6	39848009	Whiplash injury to neck	20	80394007	Hyperglycemia (disorder)	1095	182	55	10	172	45	868	1.09391	0.00964	1.12145	2.26843	0.55441	0.7117072340	1.0000000000	9.14155	0.11723	92	23	5	90	32	5	-0.27871	0.02083
114	449868002	Smokes tobacco daily	101	433144002	Chronic kidney disease stage 3 (disorder)	1095	9	3	1	8	2	1084	40.55556	0.18874	67.75000	824.69220	5.56579	0.0244776081	0.2884086500	0.02466	0.96486	2	1	0	7	2	1	-1.09861	-2.07944
130	314994000	Metastasis from malignant tumor of prostate (disorder)	98	1551000119108	Nonproliferative diabetic retinopathy due to type 2 diabetes mellitus (disorder)	1095	1	12	0	1	12	1082	0.00000	-0.00318	0.00000	0.00000	0.00000	1.0000000000	1.0000000000	0.01096	-0.01572	0	7	0	1	5	0	0.00000	0.00000
118	48333001	Burn injury(morphologic abnormality)	102	90781000119102	Microalbuminuria due to type 2 diabetes mellitus (disorder)	1095	1	6	0	1	6	1088	0.00000	-0.00224	0.00000	0.00000	0.00000	1.0000000000	1.0000000000	0.00548	-0.00788	0	3	0	1	3	0	0.00000	0.00000
119	275272006	Brain damage - traumatic	103	157141000119108	Proteinuria due to type 2 diabetes mellitus (disorder)	1095	4	3	0	4	3	1088	0.00000	-0.00317	0.00000	0.00000	0.00000	1.0000000000	1.0000000000	0.01096	-0.01572	0	1	0	4	2	0	0.00000	0.00000
128	86849004	Suicidal deliberate poisoning	104	367498001	Seasonal allergic rhinitis	1095	1	20	0	1	20	1074	0.00000	-0.00412	0.00000	0.00000	0.00000	1.0000000000	1.0000000000	0.01826	-0.02611	0	9	0	1	11	0	0.00000	0.00000
114	449868002	Smokes tobacco daily	105	363406005	Malignant tumor of colon	1095	9	6	1	8	5	1081	20.27778	0.13026	27.02500	258.17573	2.82889	0.0484211802	0.4232510452	0.04932	0.93055	2	4	1	7	2	0	1.60944	1.09861
132	69896004	Rheumatoid arthritis	133	97331000119101	Macular edema and retinopathy due to type 2 diabetes mellitus (disorder)	1095	3	4	0	3	4	1088	0.00000	-0.00317	0.00000	0.00000	0.00000	1.0000000000	1.0000000000	0.01096	-0.01572	2	2	0	1	2	0	0.00000	0.00000
131	93761005	Primary malignant neoplasm of colon	133	97331000119101	Macular edema and retinopathy due to type 2 diabetes mellitus (disorder)	1095	5	4	0	5	4	1086	0.00000	-0.00410	0.00000	0.00000	0.00000	1.0000000000	1.0000000000	0.01826	-0.02611	3	2	0	2	2	0	0.00000	0.00000
130	314994000	Metastasis from malignant tumor of prostate (disorder)	133	97331000119101	Macular edema and retinopathy due to type 2 diabetes mellitus (disorder)	1095	1	4	0	1	4	1090	0.00000	-0.00183	0.00000	0.00000	0.00000	1.0000000000	1.0000000000	0.00365	-0.00526	0	2	0	1	2	0	0.00000	0.00000
129	47505003	Posttraumatic stress disorder	133	97331000119101	Macular edema and retinopathy due to type 2 diabetes mellitus (disorder)	1095	4	4	0	4	4	1087	0.00000	-0.00367	0.00000	0.00000	0.00000	1.0000000000	1.0000000000	0.01461	-0.02093	1	2	0	3	2	0	0.00000	0.00000
128	86849004	Suicidal deliberate poisoning	133	97331000119101	Macular edema and retinopathy due to type 2 diabetes mellitus (disorder)	1095	1	4	0	1	4	1090	0.00000	-0.00183	0.00000	0.00000	0.00000	1.0000000000	1.0000000000	0.00365	-0.00526	0	2	0	1	2	0	0.00000	0.00000
127	431856006	Chronic kidney disease stage 2 (disorder)	133	97331000119101	Macular edema and retinopathy due to type 2 diabetes mellitus (disorder)	1095	5	4	0	5	4	1086	0.00000	-0.00410	0.00000	0.00000	0.00000	1.0000000000	1.0000000000	0.01826	-0.02611	3	2	0	2	2	0	0.00000	0.00000
126	698754002	Chronic paralysis due to lesion of spinal cord	133	97331000119101	Macular edema and retinopathy due to type 2 diabetes mellitus (disorder)	1095	2	4	0	2	4	1089	0.00000	-0.00259	0.00000	0.00000	0.00000	1.0000000000	1.0000000000	0.00731	-0.01050	2	2	0	0	2	0	0.00000	0.00000
125	1734006	Fracture of the vertebral column with spinal cord injury	133	97331000119101	Macular edema and retinopathy due to type 2 diabetes mellitus (disorder)	1095	5	4	0	5	4	1086	0.00000	-0.00410	0.00000	0.00000	0.00000	1.0000000000	1.0000000000	0.01826	-0.02611	3	2	0	2	2	0	0.00000	0.00000
124	1501000119109	Proliferative diabetic retinopathy due to type II diabetes mellitus (disorder)	133	97331000119101	Macular edema and retinopathy due to type 2 diabetes mellitus (disorder)	1095	1	4	0	1	4	1090	0.00000	-0.00183	0.00000	0.00000	0.00000	1.0000000000	1.0000000000	0.00365	-0.00526	1	2	0	0	2	0	0.00000	0.00000
123	195967001	Asthma	133	97331000119101	Macular edema and retinopathy due to type 2 diabetes mellitus (disorder)	1095	2	4	0	2	4	1089	0.00000	-0.00259	0.00000	0.00000	0.00000	1.0000000000	1.0000000000	0.00731	-0.01050	1	2	0	1	2	0	0.00000	0.00000
121	254637007	Non-small cell lung cancer (disorder)	133	97331000119101	Macular edema and retinopathy due to type 2 diabetes mellitus (disorder)	1095	8	4	0	8	4	1083	0.00000	-0.00519	0.00000	0.00000	0.00000	1.0000000000	1.0000000000	0.02922	-0.04156	0	2	0	8	2	0	0.00000	0.00000
120	162573006	Suspected lung cancer (situation)	133	97331000119101	Macular edema and retinopathy due to type 2 diabetes mellitus (disorder)	1095	8	4	0	8	4	1083	0.00000	-0.00519	0.00000	0.00000	0.00000	1.0000000000	1.0000000000	0.02922	-0.04156	0	2	0	8	2	0	0.00000	0.00000
119	275272006	Brain damage - traumatic	133	97331000119101	Macular edema and retinopathy due to type 2 diabetes mellitus (disorder)	1095	4	4	0	4	4	1087	0.00000	-0.00367	0.00000	0.00000	0.00000	1.0000000000	1.0000000000	0.01461	-0.02093	0	2	0	4	2	0	0.00000	0.00000
118	48333001	Burn injury(morphologic abnormality)	133	97331000119101	Macular edema and retinopathy due to type 2 diabetes mellitus (disorder)	1095	1	4	0	1	4	1090	0.00000	-0.00183	0.00000	0.00000	0.00000	1.0000000000	1.0000000000	0.00365	-0.00526	0	2	0	1	2	0	0.00000	0.00000
117	230265002	Familial Alzheimer's disease of early onset (disorder)	133	97331000119101	Macular edema and retinopathy due to type 2 diabetes mellitus (disorder)	1095	6	4	0	6	4	1085	0.00000	-0.00449	0.00000	0.00000	0.00000	1.0000000000	1.0000000000	0.02192	-0.03128	2	2	0	4	2	0	0.00000	0.00000
116	370143000	Major depression disorder	133	97331000119101	Macular edema and retinopathy due to type 2 diabetes mellitus (disorder)	1095	8	4	0	8	4	1083	0.00000	-0.00519	0.00000	0.00000	0.00000	1.0000000000	1.0000000000	0.02922	-0.04156	3	2	0	5	2	0	0.00000	0.00000
114	449868002	Smokes tobacco daily	107	40275004	Contact dermatitis	1095	9	18	0	9	18	1068	0.00000	-0.01177	0.00000	0.00000	0.00000	1.0000000000	1.0000000000	0.14795	-0.19905	2	9	0	7	9	0	0.00000	0.00000
114	449868002	Smokes tobacco daily	133	97331000119101	Macular edema and retinopathy due to type 2 diabetes mellitus (disorder)	1095	9	4	0	9	4	1082	0.00000	-0.00551	0.00000	0.00000	0.00000	1.0000000000	1.0000000000	0.03288	-0.04667	2	2	0	7	2	0	0.00000	0.00000
113	443165006	Pathological fracture due to osteoporosis (disorder)	133	97331000119101	Macular edema and retinopathy due to type 2 diabetes mellitus (disorder)	1095	10	4	0	10	4	1081	0.00000	-0.00581	0.00000	0.00000	0.00000	1.0000000000	1.0000000000	0.03653	-0.05176	7	2	0	3	2	0	0.00000	0.00000
112	49436004	Atrial Fibrillation	133	97331000119101	Macular edema and retinopathy due to type 2 diabetes mellitus (disorder)	1095	35	4	0	35	4	1056	0.00000	-0.01100	0.00000	0.00000	0.00000	1.0000000000	1.0000000000	0.12785	-0.17358	9	2	0	26	2	0	0.00000	0.00000
111	235919008	Cholelithiasis	133	97331000119101	Macular edema and retinopathy due to type 2 diabetes mellitus (disorder)	1095	9	4	0	9	4	1082	0.00000	-0.00551	0.00000	0.00000	0.00000	1.0000000000	1.0000000000	0.03288	-0.04667	7	2	0	2	2	0	0.00000	0.00000
110	65275009	Acute Cholecystitis	133	97331000119101	Macular edema and retinopathy due to type 2 diabetes mellitus (disorder)	1095	9	4	0	9	4	1082	0.00000	-0.00551	0.00000	0.00000	0.00000	1.0000000000	1.0000000000	0.03288	-0.04667	7	2	0	2	2	0	0.00000	0.00000
109	90560007	Gout	133	97331000119101	Macular edema and retinopathy due to type 2 diabetes mellitus (disorder)	1095	4	4	0	4	4	1087	0.00000	-0.00367	0.00000	0.00000	0.00000	1.0000000000	1.0000000000	0.01461	-0.02093	0	2	0	4	2	0	0.00000	0.00000
108	40930008	Hypothyroidism (disorder)	133	97331000119101	Macular edema and retinopathy due to type 2 diabetes mellitus (disorder)	1095	13	4	0	13	4	1078	0.00000	-0.00664	0.00000	0.00000	0.00000	1.0000000000	1.0000000000	0.04749	-0.06693	11	2	0	2	2	0	0.00000	0.00000
107	40275004	Contact dermatitis	133	97331000119101	Macular edema and retinopathy due to type 2 diabetes mellitus (disorder)	1095	18	4	0	18	4	1073	0.00000	-0.00783	0.00000	0.00000	0.00000	1.0000000000	1.0000000000	0.06575	-0.09187	9	2	0	9	2	0	0.00000	0.00000
106	24079001	Atopic dermatitis	133	97331000119101	Macular edema and retinopathy due to type 2 diabetes mellitus (disorder)	1095	20	4	0	20	4	1071	0.00000	-0.00826	0.00000	0.00000	0.00000	1.0000000000	1.0000000000	0.07306	-0.10173	13	2	0	7	2	0	0.00000	0.00000
105	363406005	Malignant tumor of colon	133	97331000119101	Macular edema and retinopathy due to type 2 diabetes mellitus (disorder)	1095	6	4	0	6	4	1085	0.00000	-0.00449	0.00000	0.00000	0.00000	1.0000000000	1.0000000000	0.02192	-0.03128	4	2	0	2	2	0	0.00000	0.00000
104	367498001	Seasonal allergic rhinitis	133	97331000119101	Macular edema and retinopathy due to type 2 diabetes mellitus (disorder)	1095	20	4	0	20	4	1071	0.00000	-0.00826	0.00000	0.00000	0.00000	1.0000000000	1.0000000000	0.07306	-0.10173	9	2	0	11	2	0	0.00000	0.00000
103	157141000119108	Proteinuria due to type 2 diabetes mellitus (disorder)	133	97331000119101	Macular edema and retinopathy due to type 2 diabetes mellitus (disorder)	1095	3	4	0	3	4	1088	0.00000	-0.00317	0.00000	0.00000	0.00000	1.0000000000	1.0000000000	0.01096	-0.01572	1	2	0	2	2	0	0.00000	0.00000
102	90781000119102	Microalbuminuria due to type 2 diabetes mellitus (disorder)	133	97331000119101	Macular edema and retinopathy due to type 2 diabetes mellitus (disorder)	1095	6	4	0	6	4	1085	0.00000	-0.00449	0.00000	0.00000	0.00000	1.0000000000	1.0000000000	0.02192	-0.03128	3	2	0	3	2	0	0.00000	0.00000
101	433144002	Chronic kidney disease stage 3 (disorder)	133	97331000119101	Macular edema and retinopathy due to type 2 diabetes mellitus (disorder)	1095	3	4	0	3	4	1088	0.00000	-0.00317	0.00000	0.00000	0.00000	1.0000000000	1.0000000000	0.01096	-0.01572	1	2	0	2	2	0	0.00000	0.00000
100	161622006	History of lower limb amputation (situation)	133	97331000119101	Macular edema and retinopathy due to type 2 diabetes mellitus (disorder)	1095	1	4	0	1	4	1090	0.00000	-0.00183	0.00000	0.00000	0.00000	1.0000000000	1.0000000000	0.00365	-0.00526	0	2	0	1	2	0	0.00000	0.00000
99	30832001	Rupture of patellar tendon	133	97331000119101	Macular edema and retinopathy due to type 2 diabetes mellitus (disorder)	1095	23	4	0	23	4	1068	0.00000	-0.00887	0.00000	0.00000	0.00000	1.0000000000	1.0000000000	0.08402	-0.11639	14	2	0	9	2	0	0.00000	0.00000
98	1551000119108	Nonproliferative diabetic retinopathy due to type 2 diabetes mellitus (disorder)	133	97331000119101	Macular edema and retinopathy due to type 2 diabetes mellitus (disorder)	1095	12	4	4	8	0	1083	91.25000	0.57523	0.00000	0.00000	0.00000	0.0000000083	0.0000005610	0.04384	2.26003	7	2	2	5	2	2	0.00000	0.25131
97	403192003	Third degree burn	133	97331000119101	Macular edema and retinopathy due to type 2 diabetes mellitus (disorder)	1095	8	4	0	8	4	1083	0.00000	-0.00519	0.00000	0.00000	0.00000	1.0000000000	1.0000000000	0.02922	-0.04156	3	2	0	5	2	0	0.00000	0.00000
96	283371005	Laceration of forearm	133	97331000119101	Macular edema and retinopathy due to type 2 diabetes mellitus (disorder)	1095	75	4	0	75	4	1016	0.00000	-0.01642	0.00000	0.00000	0.00000	1.0000000000	1.0000000000	0.27397	-0.34933	39	2	0	36	2	0	0.00000	0.00000
95	84757009	Epilepsy	133	97331000119101	Macular edema and retinopathy due to type 2 diabetes mellitus (disorder)	1095	30	4	0	30	4	1061	0.00000	-0.01016	0.00000	0.00000	0.00000	1.0000000000	1.0000000000	0.10959	-0.15003	13	2	0	17	2	0	0.00000	0.00000
94	703151001	History of single seizure (situation)	133	97331000119101	Macular edema and retinopathy due to type 2 diabetes mellitus (disorder)	1095	39	4	0	39	4	1052	0.00000	-0.01164	0.00000	0.00000	0.00000	1.0000000000	1.0000000000	0.14247	-0.19215	14	2	0	25	2	0	0.00000	0.00000
93	128613002	Seizure disorder	133	97331000119101	Macular edema and retinopathy due to type 2 diabetes mellitus (disorder)	1095	39	4	0	39	4	1052	0.00000	-0.01164	0.00000	0.00000	0.00000	1.0000000000	1.0000000000	0.14247	-0.19215	14	2	0	25	2	0	0.00000	0.00000
92	82423001	Chronic pain	133	97331000119101	Macular edema and retinopathy due to type 2 diabetes mellitus (disorder)	1095	52	4	0	52	4	1039	0.00000	-0.01352	0.00000	0.00000	0.00000	1.0000000000	1.0000000000	0.18995	-0.25091	24	2	0	28	2	0	0.00000	0.00000
91	64859006	Osteoporosis (disorder)	133	97331000119101	Macular edema and retinopathy due to type 2 diabetes mellitus (disorder)	1095	37	4	0	37	4	1054	0.00000	-0.01132	0.00000	0.00000	0.00000	1.0000000000	1.0000000000	0.13516	-0.18290	24	2	0	13	2	0	0.00000	0.00000
90	444470001	Injury of anterior cruciate ligament	133	97331000119101	Macular edema and retinopathy due to type 2 diabetes mellitus (disorder)	1095	19	4	0	19	4	1072	0.00000	-0.00805	0.00000	0.00000	0.00000	1.0000000000	1.0000000000	0.06941	-0.09681	10	2	0	9	2	0	0.00000	0.00000
89	47693006	Rupture of appendix	133	97331000119101	Macular edema and retinopathy due to type 2 diabetes mellitus (disorder)	1095	20	4	0	20	4	1071	0.00000	-0.00826	0.00000	0.00000	0.00000	1.0000000000	1.0000000000	0.07306	-0.10173	10	2	0	10	2	0	0.00000	0.00000
88	197927001	Recurrent urinary tract infection	133	97331000119101	Macular edema and retinopathy due to type 2 diabetes mellitus (disorder)	1095	8	4	0	8	4	1083	0.00000	-0.00519	0.00000	0.00000	0.00000	1.0000000000	1.0000000000	0.02922	-0.04156	8	2	0	0	2	0	0.00000	0.00000
87	109838007	Overlapping malignant neoplasm of colon	133	97331000119101	Macular edema and retinopathy due to type 2 diabetes mellitus (disorder)	1095	8	4	0	8	4	1083	0.00000	-0.00519	0.00000	0.00000	0.00000	1.0000000000	1.0000000000	0.02922	-0.04156	5	2	0	3	2	0	0.00000	0.00000
86	713197008	Recurrent rectal polyp	133	97331000119101	Macular edema and retinopathy due to type 2 diabetes mellitus (disorder)	1095	22	4	0	22	4	1069	0.00000	-0.00867	0.00000	0.00000	0.00000	1.0000000000	1.0000000000	0.08037	-0.11152	12	2	0	10	2	0	0.00000	0.00000
85	241929008	Acute allergic reaction	133	97331000119101	Macular edema and retinopathy due to type 2 diabetes mellitus (disorder)	1095	47	4	0	47	4	1044	0.00000	-0.01282	0.00000	0.00000	0.00000	1.0000000000	1.0000000000	0.17169	-0.22859	25	2	0	22	2	0	0.00000	0.00000
84	232353008	Perennial allergic rhinitis with seasonal variation	133	97331000119101	Macular edema and retinopathy due to type 2 diabetes mellitus (disorder)	1095	29	4	1	28	3	1063	9.43966	0.08429	12.65476	125.47489	1.27630	0.1019356362	0.6291042150	0.10594	0.85473	14	2	1	15	2	0	1.09861	2.70805
83	110030002	Concussion injury of brain	133	97331000119101	Macular edema and retinopathy due to type 2 diabetes mellitus (disorder)	1095	7	4	0	7	4	1084	0.00000	-0.00486	0.00000	0.00000	0.00000	1.0000000000	1.0000000000	0.02557	-0.03643	1	2	0	6	2	0	0.00000	0.00000
82	94260004	Secondary malignant neoplasm of colon	133	97331000119101	Macular edema and retinopathy due to type 2 diabetes mellitus (disorder)	1095	4	4	0	4	4	1087	0.00000	-0.00367	0.00000	0.00000	0.00000	1.0000000000	1.0000000000	0.01461	-0.02093	2	2	0	2	2	0	0.00000	0.00000
81	236077008	Protracted diarrhea	133	97331000119101	Macular edema and retinopathy due to type 2 diabetes mellitus (disorder)	1095	4	4	0	4	4	1087	0.00000	-0.00367	0.00000	0.00000	0.00000	1.0000000000	1.0000000000	0.01461	-0.02093	2	2	0	2	2	0	0.00000	0.00000
80	6072007	Bleeding from anus	133	97331000119101	Macular edema and retinopathy due to type 2 diabetes mellitus (disorder)	1095	4	4	0	4	4	1087	0.00000	-0.00367	0.00000	0.00000	0.00000	1.0000000000	1.0000000000	0.01461	-0.02093	2	2	0	2	2	0	0.00000	0.00000
79	45816000	Pyelonephritis	133	97331000119101	Macular edema and retinopathy due to type 2 diabetes mellitus (disorder)	1095	1	4	0	1	4	1090	0.00000	-0.00183	0.00000	0.00000	0.00000	1.0000000000	1.0000000000	0.00365	-0.00526	1	2	0	0	2	0	0.00000	0.00000
78	239872002	Osteoarthritis of hip	133	97331000119101	Macular edema and retinopathy due to type 2 diabetes mellitus (disorder)	1095	21	4	0	21	4	1070	0.00000	-0.00847	0.00000	0.00000	0.00000	1.0000000000	1.0000000000	0.07671	-0.10663	13	2	0	8	2	0	0.00000	0.00000
77	422034002	Diabetic retinopathy associated with type II diabetes mellitus (disorder)	133	97331000119101	Macular edema and retinopathy due to type 2 diabetes mellitus (disorder)	1095	20	4	4	16	0	1075	54.75000	0.44392	0.00000	0.00000	0.00000	0.0000000813	0.0000048563	0.07306	2.22020	8	2	2	12	2	2	0.00000	-0.33647
76	127013003	Diabetic renal disease (disorder)	133	97331000119101	Macular edema and retinopathy due to type 2 diabetes mellitus (disorder)	1095	28	4	0	28	4	1063	0.00000	-0.00981	0.00000	0.00000	0.00000	1.0000000000	1.0000000000	0.10228	-0.14049	10	2	0	18	2	0	0.00000	0.00000
75	431855005	Chronic kidney disease stage 1 (disorder)	133	97331000119101	Macular edema and retinopathy due to type 2 diabetes mellitus (disorder)	1095	28	4	0	28	4	1063	0.00000	-0.00981	0.00000	0.00000	0.00000	1.0000000000	1.0000000000	0.10228	-0.14049	10	2	0	18	2	0	0.00000	0.00000
73	196416002	Impacted molars	133	97331000119101	Macular edema and retinopathy due to type 2 diabetes mellitus (disorder)	1095	49	4	0	49	4	1042	0.00000	-0.01311	0.00000	0.00000	0.00000	1.0000000000	1.0000000000	0.17900	-0.23756	25	2	0	24	2	0	0.00000	0.00000
72	35999006	Blighted ovum	133	97331000119101	Macular edema and retinopathy due to type 2 diabetes mellitus (disorder)	1095	53	4	0	53	4	1038	0.00000	-0.01366	0.00000	0.00000	0.00000	1.0000000000	1.0000000000	0.19361	-0.25533	53	2	0	0	2	0	0.00000	0.00000
71	201834006	Localized  primary osteoarthritis of the hand	133	97331000119101	Macular edema and retinopathy due to type 2 diabetes mellitus (disorder)	1095	28	4	1	27	3	1064	9.77679	0.08609	13.13580	130.38871	1.32335	0.0985562783	0.6237397336	0.10228	0.85951	19	2	1	9	2	0	1.09861	2.99573
70	87433001	Pulmonary emphysema (disorder)	133	97331000119101	Macular edema and retinopathy due to type 2 diabetes mellitus (disorder)	1095	17	4	0	17	4	1074	0.00000	-0.00760	0.00000	0.00000	0.00000	1.0000000000	1.0000000000	0.06210	-0.08692	9	2	0	8	2	0	0.00000	0.00000
69	233604007	Pneumonia	133	97331000119101	Macular edema and retinopathy due to type 2 diabetes mellitus (disorder)	1095	7	4	0	7	4	1084	0.00000	-0.00486	0.00000	0.00000	0.00000	1.0000000000	1.0000000000	0.02557	-0.03643	3	2	0	4	2	0	0.00000	0.00000
68	26929004	Alzheimer's disease (disorder)	133	97331000119101	Macular edema and retinopathy due to type 2 diabetes mellitus (disorder)	1095	23	4	0	23	4	1068	0.00000	-0.00887	0.00000	0.00000	0.00000	1.0000000000	1.0000000000	0.08402	-0.11639	15	2	0	8	2	0	0.00000	0.00000
67	403191005	Second degree burn	133	97331000119101	Macular edema and retinopathy due to type 2 diabetes mellitus (disorder)	1095	49	4	0	49	4	1042	0.00000	-0.01311	0.00000	0.00000	0.00000	1.0000000000	1.0000000000	0.17900	-0.23756	23	2	0	26	2	0	0.00000	0.00000
66	55822004	Hyperlipidemia	133	97331000119101	Macular edema and retinopathy due to type 2 diabetes mellitus (disorder)	1095	119	4	1	118	3	973	2.30042	0.02749	2.74859	26.63728	0.28362	0.3692576541	1.0000000000	0.43470	0.47925	64	2	0	55	2	1	-1.09861	-4.02535
65	239873007	Osteoarthritis of knee	133	97331000119101	Macular edema and retinopathy due to type 2 diabetes mellitus (disorder)	1095	57	4	1	56	3	1035	4.80263	0.05396	6.16071	60.17675	0.63072	0.1927613013	0.8298473287	0.20822	0.72712	30	2	0	27	2	1	-1.09861	-3.33220
64	444448004	Injury of medial collateral ligament of knee	133	97331000119101	Macular edema and retinopathy due to type 2 diabetes mellitus (disorder)	1095	32	4	0	32	4	1059	0.00000	-0.01051	0.00000	0.00000	0.00000	1.0000000000	1.0000000000	0.11689	-0.15949	17	2	0	15	2	0	0.00000	0.00000
63	68496003	Polyp of colon	133	97331000119101	Macular edema and retinopathy due to type 2 diabetes mellitus (disorder)	1095	91	4	1	90	3	1001	3.00824	0.03661	3.70741	36.00873	0.38171	0.2935812737	0.9796285312	0.33242	0.58595	43	2	0	48	2	1	-1.09861	-3.89182
62	185086009	Chronic obstructive bronchitis (disorder)	133	97331000119101	Macular edema and retinopathy due to type 2 diabetes mellitus (disorder)	1095	6	4	0	6	4	1085	0.00000	-0.00449	0.00000	0.00000	0.00000	1.0000000000	1.0000000000	0.02192	-0.03128	4	2	0	2	2	0	0.00000	0.00000
61	198992004	Antepartum eclampsia	133	97331000119101	Macular edema and retinopathy due to type 2 diabetes mellitus (disorder)	1095	96	4	1	95	3	996	2.85156	0.03475	3.49474	33.92652	0.35999	0.3075693478	0.9977249576	0.35068	0.56631	96	2	1	0	2	0	1.09861	4.57471
60	301011002	Escherichia coli urinary tract infection	133	97331000119101	Macular edema and retinopathy due to type 2 diabetes mellitus (disorder)	1095	92	4	1	91	3	1000	2.97554	0.03623	3.66300	35.57382	0.37718	0.2963956909	0.9843970393	0.33607	0.58200	85	2	1	7	2	0	1.09861	4.45435
59	262574004	Bullet wound	133	97331000119101	Macular edema and retinopathy due to type 2 diabetes mellitus (disorder)	1095	20	4	0	20	4	1071	0.00000	-0.00826	0.00000	0.00000	0.00000	1.0000000000	1.0000000000	0.07306	-0.10173	9	2	0	11	2	0	0.00000	0.00000
58	239720000	Tear of meniscus of knee	133	97331000119101	Macular edema and retinopathy due to type 2 diabetes mellitus (disorder)	1095	20	4	0	20	4	1071	0.00000	-0.00826	0.00000	0.00000	0.00000	1.0000000000	1.0000000000	0.07306	-0.10173	10	2	0	10	2	0	0.00000	0.00000
57	192127007	Child attention deficit disorder	133	97331000119101	Macular edema and retinopathy due to type 2 diabetes mellitus (disorder)	1095	76	4	0	76	4	1015	0.00000	-0.01654	0.00000	0.00000	0.00000	1.0000000000	1.0000000000	0.27763	-0.35347	24	2	0	52	2	0	0.00000	0.00000
56	92691004	Carcinoma in situ of prostate (disorder)	133	97331000119101	Macular edema and retinopathy due to type 2 diabetes mellitus (disorder)	1095	23	4	0	23	4	1068	0.00000	-0.00887	0.00000	0.00000	0.00000	1.0000000000	1.0000000000	0.08402	-0.11639	0	2	0	23	2	0	0.00000	0.00000
55	126906006	Neoplasm of prostate	133	97331000119101	Macular edema and retinopathy due to type 2 diabetes mellitus (disorder)	1095	24	4	0	24	4	1067	0.00000	-0.00906	0.00000	0.00000	0.00000	1.0000000000	1.0000000000	0.08767	-0.12124	0	2	0	24	2	0	0.00000	0.00000
54	5602001	Opioid abuse (disorder)	133	97331000119101	Macular edema and retinopathy due to type 2 diabetes mellitus (disorder)	1095	7	4	0	7	4	1084	0.00000	-0.00486	0.00000	0.00000	0.00000	1.0000000000	1.0000000000	0.02557	-0.03643	0	2	0	7	2	0	0.00000	0.00000
53	7200002	Alcoholism	133	97331000119101	Macular edema and retinopathy due to type 2 diabetes mellitus (disorder)	1095	5	4	0	5	4	1086	0.00000	-0.00410	0.00000	0.00000	0.00000	1.0000000000	1.0000000000	0.01826	-0.02611	0	2	0	5	2	0	0.00000	0.00000
52	124171000119105	Chronic intractable migraine without aura	133	97331000119101	Macular edema and retinopathy due to type 2 diabetes mellitus (disorder)	1095	51	4	1	50	3	1041	5.36765	0.05845	6.94000	67.91084	0.70922	0.1739068632	0.7996618359	0.18630	0.75353	21	2	0	30	2	1	-1.09861	-3.43399
51	403190006	First degree burn	133	97331000119101	Macular edema and retinopathy due to type 2 diabetes mellitus (disorder)	1095	79	4	0	79	4	1012	0.00000	-0.01688	0.00000	0.00000	0.00000	1.0000000000	1.0000000000	0.28858	-0.36579	43	2	0	36	2	0	0.00000	0.00000
50	446096008	Perennial allergic rhinitis	133	97331000119101	Macular edema and retinopathy due to type 2 diabetes mellitus (disorder)	1095	26	4	0	26	4	1065	0.00000	-0.00944	0.00000	0.00000	0.00000	1.0000000000	1.0000000000	0.09498	-0.13090	14	2	0	12	2	0	0.00000	0.00000
49	88805009	Chronic congestive heart failure (disorder)	133	97331000119101	Macular edema and retinopathy due to type 2 diabetes mellitus (disorder)	1095	10	4	0	10	4	1081	0.00000	-0.00581	0.00000	0.00000	0.00000	1.0000000000	1.0000000000	0.03653	-0.05176	5	2	0	5	2	0	0.00000	0.00000
48	55680006	Drug overdose	133	97331000119101	Macular edema and retinopathy due to type 2 diabetes mellitus (disorder)	1095	50	4	0	50	4	1041	0.00000	-0.01324	0.00000	0.00000	0.00000	1.0000000000	1.0000000000	0.18265	-0.24202	24	2	0	26	2	0	0.00000	0.00000
47	359817006	Closed fracture of hip	133	97331000119101	Macular edema and retinopathy due to type 2 diabetes mellitus (disorder)	1095	29	4	0	29	4	1062	0.00000	-0.00999	0.00000	0.00000	0.00000	1.0000000000	1.0000000000	0.10594	-0.14527	11	2	0	18	2	0	0.00000	0.00000
46	62564004	Concussion with loss of consciousness	133	97331000119101	Macular edema and retinopathy due to type 2 diabetes mellitus (disorder)	1095	67	4	0	67	4	1024	0.00000	-0.01546	0.00000	0.00000	0.00000	1.0000000000	1.0000000000	0.24475	-0.31585	36	2	0	31	2	0	0.00000	0.00000
45	263102004	Fracture subluxation of wrist	133	97331000119101	Macular edema and retinopathy due to type 2 diabetes mellitus (disorder)	1095	109	4	0	109	4	982	0.00000	-0.02013	0.00000	0.00000	0.00000	1.0000000000	1.0000000000	0.39817	-0.48354	51	2	0	58	2	0	0.00000	0.00000
44	58150001	Fracture of clavicle	133	97331000119101	Macular edema and retinopathy due to type 2 diabetes mellitus (disorder)	1095	112	4	1	111	3	980	2.44420	0.02952	2.94294	28.53354	0.30353	0.3509385028	1.0000000000	0.40913	0.50519	55	2	0	57	2	1	-1.09861	-4.06044
43	307731004	Injury of tendon of the rotator cuff of shoulder	133	97331000119101	Macular edema and retinopathy due to type 2 diabetes mellitus (disorder)	1095	51	4	0	51	4	1040	0.00000	-0.01338	0.00000	0.00000	0.00000	1.0000000000	1.0000000000	0.18630	-0.24647	26	2	0	25	2	0	0.00000	0.00000
42	16114001	Fracture of ankle	133	97331000119101	Macular edema and retinopathy due to type 2 diabetes mellitus (disorder)	1095	108	4	0	108	4	983	0.00000	-0.02003	0.00000	0.00000	0.00000	1.0000000000	1.0000000000	0.39452	-0.47977	48	2	0	60	2	0	0.00000	0.00000
41	283385000	Laceration of thigh	133	97331000119101	Macular edema and retinopathy due to type 2 diabetes mellitus (disorder)	1095	105	4	0	105	4	986	0.00000	-0.01972	0.00000	0.00000	0.00000	1.0000000000	1.0000000000	0.38356	-0.46839	50	2	0	55	2	0	0.00000	0.00000
40	428251008	History of appendectomy	133	97331000119101	Macular edema and retinopathy due to type 2 diabetes mellitus (disorder)	1095	51	4	0	51	4	1040	0.00000	-0.01338	0.00000	0.00000	0.00000	1.0000000000	1.0000000000	0.18630	-0.24647	27	2	0	24	2	0	0.00000	0.00000
39	74400008	Appendicitis	133	97331000119101	Macular edema and retinopathy due to type 2 diabetes mellitus (disorder)	1095	51	4	0	51	4	1040	0.00000	-0.01338	0.00000	0.00000	0.00000	1.0000000000	1.0000000000	0.18630	-0.24647	27	2	0	24	2	0	0.00000	0.00000
38	398254007	Preeclampsia	133	97331000119101	Macular edema and retinopathy due to type 2 diabetes mellitus (disorder)	1095	101	4	0	101	4	990	0.00000	-0.01930	0.00000	0.00000	0.00000	1.0000000000	1.0000000000	0.36895	-0.45307	101	2	0	0	2	0	0.00000	0.00000
37	38822007	Cystitis	133	97331000119101	Macular edema and retinopathy due to type 2 diabetes mellitus (disorder)	1095	71	4	1	70	3	1021	3.85563	0.04553	4.86190	47.34793	0.49924	0.2354991251	0.8999613933	0.25936	0.66731	68	2	1	3	2	0	1.09861	4.23411
36	156073000	Fetus with unknown complication	133	97331000119101	Macular edema and retinopathy due to type 2 diabetes mellitus (disorder)	1095	125	4	1	124	3	967	2.19000	0.02587	2.59946	25.18347	0.26832	0.3846487301	1.0000000000	0.45662	0.45737	125	2	1	0	2	0	1.09861	4.83628
35	19169002	Miscarriage in first trimester	133	97331000119101	Macular edema and retinopathy due to type 2 diabetes mellitus (disorder)	1095	174	4	1	173	3	918	1.57328	0.01509	1.76879	17.10363	0.18292	0.5000444330	1.0000000000	0.63562	0.29017	174	2	1	0	2	0	1.09861	5.16479
33	429007001	History of cardiac arrest (situation)	133	97331000119101	Macular edema and retinopathy due to type 2 diabetes mellitus (disorder)	1095	42	4	0	42	4	1049	0.00000	-0.01209	0.00000	0.00000	0.00000	1.0000000000	1.0000000000	0.15342	-0.20592	24	2	0	18	2	0	0.00000	0.00000
32	410429000	Cardiac Arrest	133	97331000119101	Macular edema and retinopathy due to type 2 diabetes mellitus (disorder)	1095	42	4	0	42	4	1049	0.00000	-0.01209	0.00000	0.00000	0.00000	1.0000000000	1.0000000000	0.15342	-0.20592	24	2	0	18	2	0	0.00000	0.00000
31	230690007	Stroke	133	97331000119101	Macular edema and retinopathy due to type 2 diabetes mellitus (disorder)	1095	62	4	0	62	4	1029	0.00000	-0.01483	0.00000	0.00000	0.00000	1.0000000000	1.0000000000	0.22648	-0.29453	32	2	0	30	2	0	0.00000	0.00000
30	399211009	History of myocardial infarction (situation)	133	97331000119101	Macular edema and retinopathy due to type 2 diabetes mellitus (disorder)	1095	31	4	0	31	4	1060	0.00000	-0.01034	0.00000	0.00000	0.00000	1.0000000000	1.0000000000	0.11324	-0.15477	2	2	0	29	2	0	0.00000	0.00000
29	22298006	Myocardial Infarction	133	97331000119101	Macular edema and retinopathy due to type 2 diabetes mellitus (disorder)	1095	31	4	0	31	4	1060	0.00000	-0.01034	0.00000	0.00000	0.00000	1.0000000000	1.0000000000	0.11324	-0.15477	2	2	0	29	2	0	0.00000	0.00000
28	53741008	Coronary Heart Disease	133	97331000119101	Macular edema and retinopathy due to type 2 diabetes mellitus (disorder)	1095	80	4	2	78	2	1013	6.84375	0.09934	12.98718	93.44882	1.80491	0.0287222815	0.3120348852	0.29224	1.21509	24	2	1	56	2	1	0.00000	-0.82418
27	408512008	Body mass index 40+ - severely obese (finding)	133	97331000119101	Macular edema and retinopathy due to type 2 diabetes mellitus (disorder)	1095	97	4	0	97	4	994	0.00000	-0.01888	0.00000	0.00000	0.00000	1.0000000000	1.0000000000	0.35434	-0.43759	67	2	0	30	2	0	0.00000	0.00000
26	33737001	Fracture of rib	133	97331000119101	Macular edema and retinopathy due to type 2 diabetes mellitus (disorder)	1095	54	4	0	54	4	1037	0.00000	-0.01379	0.00000	0.00000	0.00000	1.0000000000	1.0000000000	0.19726	-0.25974	32	2	0	22	2	0	0.00000	0.00000
25	284551006	Laceration of foot	133	97331000119101	Macular edema and retinopathy due to type 2 diabetes mellitus (disorder)	1095	118	4	1	117	3	974	2.31992	0.02778	2.77493	26.89418	0.28632	0.3666646743	1.0000000000	0.43105	0.48293	53	2	1	65	2	0	1.09861	3.98898
24	162864005	Body mass index 30+ - obesity (finding)	133	97331000119101	Macular edema and retinopathy due to type 2 diabetes mellitus (disorder)	1095	439	4	2	437	2	654	1.24715	0.01224	1.49657	10.66405	0.21002	1.0000000000	1.0000000000	1.60365	0.20443	226	2	0	213	2	2	-0.69315	-4.67749
23	36971009	Sinusitis (disorder)	133	97331000119101	Macular edema and retinopathy due to type 2 diabetes mellitus (disorder)	1095	190	4	2	188	2	903	2.88158	0.05220	4.80319	34.31336	0.67235	0.1412603061	0.7394054662	0.69406	0.82447	84	2	0	106	2	2	-0.69315	-3.98898
22	70704007	Sprain of wrist	133	97331000119101	Macular edema and retinopathy due to type 2 diabetes mellitus (disorder)	1095	195	4	1	194	3	897	1.40385	0.01138	1.54124	14.89572	0.15947	0.5441764707	1.0000000000	0.71233	0.22404	90	2	0	105	2	1	-1.09861	-4.66344
21	15777000	Prediabetes	133	97331000119101	Macular edema and retinopathy due to type 2 diabetes mellitus (disorder)	1095	333	4	2	331	2	760	1.64414	0.02578	2.29607	16.36937	0.32206	0.5894337899	1.0000000000	1.21644	0.43672	159	2	1	174	2	1	0.00000	-0.08961
20	80394007	Hyperglycemia (disorder)	133	97331000119101	Macular edema and retinopathy due to type 2 diabetes mellitus (disorder)	1095	55	4	4	51	0	1040	19.90909	0.26330	0.00000	0.00000	0.00000	0.0000057248	0.0002563899	0.20091	2.05780	23	2	2	32	2	2	0.00000	-0.30748
19	237602007	Metabolic syndrome X (disorder)	133	97331000119101	Macular edema and retinopathy due to type 2 diabetes mellitus (disorder)	1095	64	4	4	60	0	1031	17.10937	0.24303	0.00000	0.00000	0.00000	0.0000106652	0.0004522651	0.23379	2.01883	28	2	2	36	2	2	0.00000	-0.23639
18	302870006	Hypertriglyceridemia (disorder)	133	97331000119101	Macular edema and retinopathy due to type 2 diabetes mellitus (disorder)	1095	64	4	4	60	0	1031	17.10937	0.24303	0.00000	0.00000	0.00000	0.0000106652	0.0004522651	0.23379	2.01883	28	2	2	36	2	2	0.00000	-0.23639
17	368581000119106	Neuropathy due to type 2 diabetes mellitus (disorder)	133	97331000119101	Macular edema and retinopathy due to type 2 diabetes mellitus (disorder)	1095	28	4	3	25	1	1066	29.33036	0.27789	127.92000	1272.90932	12.85522	0.0000590176	0.0021585699	0.10228	1.85951	7	2	1	21	2	2	0.40547	-0.36291
16	44054006	Diabetes	133	97331000119101	Macular edema and retinopathy due to type 2 diabetes mellitus (disorder)	1095	68	4	4	64	0	1027	16.10294	0.23531	0.00000	0.00000	0.00000	0.0000136699	0.0005633558	0.24840	2.00185	29	2	2	39	2	2	0.00000	-0.27958
15	40055000	Chronic sinusitis (disorder)	133	97331000119101	Macular edema and retinopathy due to type 2 diabetes mellitus (disorder)	1095	216	4	0	216	4	875	0.00000	-0.03002	0.00000	0.00000	0.00000	1.0000000000	1.0000000000	0.78904	-0.83919	104	2	0	112	2	0	0.00000	0.00000
14	10509002	Acute bronchitis (disorder)	133	97331000119101	Macular edema and retinopathy due to type 2 diabetes mellitus (disorder)	1095	863	4	4	859	0	232	1.26883	0.03139	0.00000	0.00000	0.00000	0.5842857155	1.0000000000	3.15251	0.26794	418	2	2	445	2	2	0.00000	-0.06230
13	370247008	Facial laceration	133	97331000119101	Macular edema and retinopathy due to type 2 diabetes mellitus (disorder)	1095	109	4	1	108	3	983	2.51147	0.03043	3.03395	29.42206	0.31286	0.3429664897	1.0000000000	0.39817	0.51646	55	2	1	54	2	0	1.09861	4.02535
12	65966004	Fracture of forearm	133	97331000119101	Macular edema and retinopathy due to type 2 diabetes mellitus (disorder)	1095	123	4	1	122	3	969	2.22561	0.02640	2.64754	25.65207	0.27325	0.3795500346	1.0000000000	0.44932	0.46463	55	2	0	68	2	1	-1.09861	-4.23411
11	38341003	Hypertension	133	97331000119101	Macular edema and retinopathy due to type 2 diabetes mellitus (disorder)	1095	278	4	2	276	2	815	1.96942	0.03424	2.95290	21.06264	0.41398	0.2680998009	0.9388450812	1.01553	0.57381	131	2	1	147	2	1	0.00000	-0.11441
10	62106007	Concussion with no loss of consciousness	133	97331000119101	Macular edema and retinopathy due to type 2 diabetes mellitus (disorder)	1095	206	4	2	204	2	887	2.65777	0.04832	4.34804	31.04976	0.60888	0.1625474381	0.7879650300	0.75251	0.77554	96	2	2	110	2	0	0.69315	3.89182
9	44465007	Sprain of ankle	133	97331000119101	Macular edema and retinopathy due to type 2 diabetes mellitus (disorder)	1095	362	4	2	360	2	731	1.51243	0.02180	2.03056	14.47372	0.28487	0.6027839823	1.0000000000	1.32237	0.36936	185	2	1	177	2	1	0.00000	0.04396
8	233678006	Childhood asthma	133	97331000119101	Macular edema and retinopathy due to type 2 diabetes mellitus (disorder)	1095	45	4	0	45	4	1046	0.00000	-0.01254	0.00000	0.00000	0.00000	1.0000000000	1.0000000000	0.16438	-0.21957	25	2	0	20	2	0	0.00000	0.00000
7	75498004	Acute bacterial sinusitis (disorder)	133	97331000119101	Macular edema and retinopathy due to type 2 diabetes mellitus (disorder)	1095	187	4	1	186	3	905	1.46390	0.01275	1.62186	15.67778	0.16778	0.5277242233	1.0000000000	0.68311	0.24887	89	2	1	98	2	0	1.09861	4.49981
6	39848009	Whiplash injury to neck	133	97331000119101	Macular edema and retinopathy due to type 2 diabetes mellitus (disorder)	1095	182	4	1	181	3	910	1.50412	0.01363	1.67587	16.20183	0.17335	0.5172179176	1.0000000000	0.66484	0.26462	92	2	0	90	2	1	-1.09861	-4.51086
5	284549007	Laceration of hand	133	97331000119101	Macular edema and retinopathy due to type 2 diabetes mellitus (disorder)	1095	104	4	0	104	4	987	0.00000	-0.01962	0.00000	0.00000	0.00000	1.0000000000	1.0000000000	0.37991	-0.46457	54	2	0	50	2	0	0.00000	0.00000
4	195662009	Acute viral pharyngitis (disorder)	133	97331000119101	Macular edema and retinopathy due to type 2 diabetes mellitus (disorder)	1095	890	4	4	886	0	205	1.23034	0.02906	0.00000	0.00000	0.00000	1.0000000000	1.0000000000	3.25114	0.23408	430	2	2	460	2	2	0.00000	-0.06714
3	65363002	Otitis media	133	97331000119101	Macular edema and retinopathy due to type 2 diabetes mellitus (disorder)	1095	580	4	1	579	3	512	0.47198	-0.03393	0.29476	2.84256	0.03057	0.3473031964	1.0000000000	2.11872	-0.64095	277	2	1	303	2	0	1.09861	5.62762
2	43878008	Streptococcal sore throat (disorder)	133	97331000119101	Macular edema and retinopathy due to type 2 diabetes mellitus (disorder)	1095	523	4	4	519	0	572	2.09369	0.06332	0.00000	0.00000	0.00000	0.0517295877	0.4398325680	1.91050	0.78066	246	2	2	277	2	2	0.00000	-0.11778
1	444814009	Viral sinusitis (disorder)	133	97331000119101	Macular edema and retinopathy due to type 2 diabetes mellitus (disorder)	1095	993	4	4	989	0	102	1.10272	0.01941	0.00000	0.00000	0.00000	1.0000000000	1.0000000000	3.62740	0.11173	478	2	2	515	2	2	0.00000	-0.07426
115	36923009	Major depression  single episode	107	40275004	Contact dermatitis	1095	6	18	0	6	18	1071	0.00000	-0.00960	0.00000	0.00000	0.00000	1.0000000000	1.0000000000	0.09863	-0.13571	3	9	0	3	9	0	0.00000	0.00000
117	230265002	Familial Alzheimer's disease of early onset (disorder)	107	40275004	Contact dermatitis	1095	6	18	1	5	17	1072	10.13889	0.08770	12.61176	113.80360	1.39764	0.0948725469	0.6123464826	0.09863	0.86429	2	9	0	4	9	1	-2.30259	-1.60944
118	48333001	Burn injury(morphologic abnormality)	107	40275004	Contact dermatitis	1095	1	18	0	1	18	1076	0.00000	-0.00391	0.00000	0.00000	0.00000	1.0000000000	1.0000000000	0.01644	-0.02352	0	9	0	1	9	0	0.00000	0.00000
109	90560007	Gout	107	40275004	Contact dermatitis	1095	4	18	0	4	18	1073	0.00000	-0.00783	0.00000	0.00000	0.00000	1.0000000000	1.0000000000	0.06575	-0.09187	0	9	0	4	9	0	0.00000	0.00000
106	24079001	Atopic dermatitis	107	40275004	Contact dermatitis	1095	20	18	0	20	18	1057	0.00000	-0.01763	0.00000	0.00000	0.00000	1.0000000000	1.0000000000	0.32877	-0.41009	13	9	0	7	9	0	0.00000	0.00000
125	1734006	Fracture of the vertebral column with spinal cord injury	107	40275004	Contact dermatitis	1095	5	18	0	5	18	1072	0.00000	-0.00876	0.00000	0.00000	0.00000	1.0000000000	1.0000000000	0.08219	-0.11396	3	9	0	2	9	0	0.00000	0.00000
102	90781000119102	Microalbuminuria due to type 2 diabetes mellitus (disorder)	107	40275004	Contact dermatitis	1095	6	18	0	6	18	1071	0.00000	-0.00960	0.00000	0.00000	0.00000	1.0000000000	1.0000000000	0.09863	-0.13571	3	9	0	3	9	0	0.00000	0.00000
129	47505003	Posttraumatic stress disorder	107	40275004	Contact dermatitis	1095	4	18	0	4	18	1073	0.00000	-0.00783	0.00000	0.00000	0.00000	1.0000000000	1.0000000000	0.06575	-0.09187	1	9	0	3	9	0	0.00000	0.00000
98	1551000119108	Nonproliferative diabetic retinopathy due to type 2 diabetes mellitus (disorder)	107	40275004	Contact dermatitis	1095	12	18	0	12	18	1065	0.00000	-0.01361	0.00000	0.00000	0.00000	1.0000000000	1.0000000000	0.19726	-0.25974	7	9	0	5	9	0	0.00000	0.00000
97	403192003	Third degree burn	107	40275004	Contact dermatitis	1095	8	18	0	8	18	1069	0.00000	-0.01109	0.00000	0.00000	0.00000	1.0000000000	1.0000000000	0.13151	-0.17825	3	9	0	5	9	0	0.00000	0.00000
96	283371005	Laceration of forearm	107	40275004	Contact dermatitis	1095	75	18	1	74	17	1003	0.81111	-0.00662	0.79730	6.07410	0.10465	1.0000000000	1.0000000000	1.23288	-0.15890	39	9	1	36	9	0	2.30259	3.68888
94	703151001	History of single seizure (situation)	107	40275004	Contact dermatitis	1095	39	18	0	39	18	1038	0.00000	-0.02484	0.00000	0.00000	0.00000	1.0000000000	1.0000000000	0.64110	-0.71466	14	9	0	25	9	0	0.00000	0.00000
93	128613002	Seizure disorder	107	40275004	Contact dermatitis	1095	39	18	0	39	18	1038	0.00000	-0.02484	0.00000	0.00000	0.00000	1.0000000000	1.0000000000	0.64110	-0.71466	14	9	0	25	9	0	0.00000	0.00000
89	47693006	Rupture of appendix	107	40275004	Contact dermatitis	1095	20	18	0	20	18	1057	0.00000	-0.01763	0.00000	0.00000	0.00000	1.0000000000	1.0000000000	0.32877	-0.41009	10	9	0	10	9	0	0.00000	0.00000
86	713197008	Recurrent rectal polyp	107	40275004	Contact dermatitis	1095	22	18	0	22	18	1055	0.00000	-0.01851	0.00000	0.00000	0.00000	1.0000000000	1.0000000000	0.36164	-0.44535	12	9	0	10	9	0	0.00000	0.00000
82	94260004	Secondary malignant neoplasm of colon	107	40275004	Contact dermatitis	1095	4	18	0	4	18	1073	0.00000	-0.00783	0.00000	0.00000	0.00000	1.0000000000	1.0000000000	0.06575	-0.09187	2	9	0	2	9	0	0.00000	0.00000
76	127013003	Diabetic renal disease (disorder)	107	40275004	Contact dermatitis	1095	28	18	1	27	17	1050	2.17262	0.02456	2.28758	17.81686	0.29371	0.3749775845	1.0000000000	0.46027	0.45376	10	9	0	18	9	1	-2.30259	-2.94444
75	431855005	Chronic kidney disease stage 1 (disorder)	107	40275004	Contact dermatitis	1095	28	18	1	27	17	1050	2.17262	0.02456	2.28758	17.81686	0.29371	0.3749775845	1.0000000000	0.46027	0.45376	10	9	0	18	9	1	-2.30259	-2.94444
72	35999006	Blighted ovum	107	40275004	Contact dermatitis	1095	53	18	0	53	18	1024	0.00000	-0.02916	0.00000	0.00000	0.00000	1.0000000000	1.0000000000	0.87123	-0.90399	53	9	0	0	9	0	0.00000	0.00000
71	201834006	Localized  primary osteoarthritis of the hand	107	40275004	Contact dermatitis	1095	28	18	0	28	18	1049	0.00000	-0.02094	0.00000	0.00000	0.00000	1.0000000000	1.0000000000	0.46027	-0.54624	19	9	0	9	9	0	0.00000	0.00000
69	233604007	Pneumonia	107	40275004	Contact dermatitis	1095	7	18	0	7	18	1070	0.00000	-0.01037	0.00000	0.00000	0.00000	1.0000000000	1.0000000000	0.11507	-0.15713	3	9	0	4	9	0	0.00000	0.00000
67	403191005	Second degree burn	107	40275004	Contact dermatitis	1095	49	18	0	49	18	1028	0.00000	-0.02798	0.00000	0.00000	0.00000	1.0000000000	1.0000000000	0.80548	-0.85238	23	9	0	26	9	0	0.00000	0.00000
130	314994000	Metastasis from malignant tumor of prostate (disorder)	107	40275004	Contact dermatitis	1095	1	18	0	1	18	1076	0.00000	-0.00391	0.00000	0.00000	0.00000	1.0000000000	1.0000000000	0.01644	-0.02352	0	9	0	1	9	0	0.00000	0.00000
64	444448004	Injury of medial collateral ligament of knee	107	40275004	Contact dermatitis	1095	32	18	0	32	18	1045	0.00000	-0.02243	0.00000	0.00000	0.00000	1.0000000000	1.0000000000	0.52603	-0.60978	17	9	0	15	9	0	0.00000	0.00000
63	68496003	Polyp of colon	107	40275004	Contact dermatitis	1095	91	18	1	90	17	987	0.66850	-0.01290	0.64510	4.90350	0.08487	1.0000000000	1.0000000000	1.49589	-0.31955	43	9	0	48	9	1	-2.30259	-3.89182
59	262574004	Bullet wound	107	40275004	Contact dermatitis	1095	20	18	0	20	18	1057	0.00000	-0.01763	0.00000	0.00000	0.00000	1.0000000000	1.0000000000	0.32877	-0.41009	9	9	0	11	9	0	0.00000	0.00000
58	239720000	Tear of meniscus of knee	107	40275004	Contact dermatitis	1095	20	18	0	20	18	1057	0.00000	-0.01763	0.00000	0.00000	0.00000	1.0000000000	1.0000000000	0.32877	-0.41009	10	9	0	10	9	0	0.00000	0.00000
57	192127007	Child attention deficit disorder	107	40275004	Contact dermatitis	1095	76	18	3	73	15	1004	2.40132	0.04947	2.75068	9.71825	0.77856	0.1235769612	0.6913144812	1.24932	0.83051	24	9	1	52	9	2	0.59784	-0.07696
54	5602001	Opioid abuse (disorder)	107	40275004	Contact dermatitis	1095	7	18	0	7	18	1070	0.00000	-0.01037	0.00000	0.00000	0.00000	1.0000000000	1.0000000000	0.11507	-0.15713	0	9	0	7	9	0	0.00000	0.00000
52	124171000119105	Chronic intractable migraine without aura	107	40275004	Contact dermatitis	1095	51	18	1	50	17	1027	1.19281	0.00551	1.20824	9.26113	0.15763	0.5791205601	1.0000000000	0.83836	0.12158	21	9	0	30	9	1	-2.30259	-3.43399
50	446096008	Perennial allergic rhinitis	107	40275004	Contact dermatitis	1095	26	18	0	26	18	1051	0.00000	-0.02016	0.00000	0.00000	0.00000	1.0000000000	1.0000000000	0.42740	-0.51339	14	9	0	12	9	0	0.00000	0.00000
49	88805009	Chronic congestive heart failure (disorder)	107	40275004	Contact dermatitis	1095	10	18	0	10	18	1067	0.00000	-0.01241	0.00000	0.00000	0.00000	1.0000000000	1.0000000000	0.16438	-0.21957	5	9	0	5	9	0	0.00000	0.00000
47	359817006	Closed fracture of hip	107	40275004	Contact dermatitis	1095	29	18	0	29	18	1048	0.00000	-0.02132	0.00000	0.00000	0.00000	1.0000000000	1.0000000000	0.47671	-0.56239	11	9	0	18	9	0	0.00000	0.00000
44	58150001	Fracture of clavicle	107	40275004	Contact dermatitis	1095	112	18	1	111	17	966	0.54315	-0.01994	0.51192	3.88356	0.06748	1.0000000000	1.0000000000	1.84110	-0.50645	55	9	1	57	9	0	2.30259	4.02535
43	307731004	Injury of tendon of the rotator cuff of shoulder	107	40275004	Contact dermatitis	1095	51	18	0	51	18	1026	0.00000	-0.02857	0.00000	0.00000	0.00000	1.0000000000	1.0000000000	0.83836	-0.87842	26	9	0	25	9	0	0.00000	0.00000
42	16114001	Fracture of ankle	107	40275004	Contact dermatitis	1095	108	18	2	106	16	971	1.12654	0.00541	1.14505	5.04819	0.25972	0.6955867483	1.0000000000	1.77534	0.11230	48	9	0	60	9	2	-1.70475	-3.43399
41	283385000	Laceration of thigh	107	40275004	Contact dermatitis	1095	105	18	1	104	17	973	0.57937	-0.01771	0.55034	4.17736	0.07250	1.0000000000	1.0000000000	1.72603	-0.44680	50	9	1	55	9	0	2.30259	3.93183
39	74400008	Appendicitis	107	40275004	Contact dermatitis	1095	51	18	0	51	18	1026	0.00000	-0.02857	0.00000	0.00000	0.00000	1.0000000000	1.0000000000	0.83836	-0.87842	27	9	0	24	9	0	0.00000	0.00000
38	398254007	Preeclampsia	107	40275004	Contact dermatitis	1095	101	18	3	98	15	979	1.80693	0.03325	1.99796	7.02160	0.56851	0.2266883690	0.8839940040	1.66027	0.58843	101	9	3	0	9	0	1.38629	3.54578
35	19169002	Miscarriage in first trimester	107	40275004	Contact dermatitis	1095	174	18	3	171	15	906	1.04885	0.00275	1.05965	3.69971	0.30350	1.0000000000	1.0000000000	2.86027	0.05130	174	9	3	0	9	0	1.38629	4.07754
33	429007001	History of cardiac arrest (situation)	107	40275004	Contact dermatitis	1095	42	18	1	41	17	1036	1.44841	0.01158	1.48637	11.44017	0.19312	0.5081762078	1.0000000000	0.69041	0.24263	24	9	0	18	9	1	-2.30259	-2.94444
32	410429000	Cardiac Arrest	107	40275004	Contact dermatitis	1095	42	18	1	41	17	1036	1.44841	0.01158	1.48637	11.44017	0.19312	0.5081762078	1.0000000000	0.69041	0.24263	24	9	0	18	9	1	-2.30259	-2.94444
30	399211009	History of myocardial infarction (situation)	107	40275004	Contact dermatitis	1095	31	18	2	29	16	1048	3.92473	0.06454	4.51724	20.56257	0.99236	0.0895917834	0.5935371128	0.50959	0.99081	2	9	0	29	9	2	-1.70475	-2.74084
27	408512008	Body mass index 40+ - severely obese (finding)	107	40275004	Contact dermatitis	1095	97	18	1	96	17	981	0.62715	-0.01503	0.60110	4.56611	0.07913	1.0000000000	1.0000000000	1.59452	-0.37547	67	9	0	30	9	1	-2.30259	-3.43399
24	162864005	Body mass index 30+ - obesity (finding)	107	40275004	Contact dermatitis	1095	439	18	10	429	8	648	1.38573	0.04079	1.88811	4.82225	0.73927	0.2255654378	0.8827523019	7.21644	0.42092	226	9	6	213	9	4	-0.26236	-0.33863
23	36971009	Sinusitis (disorder)	107	40275004	Contact dermatitis	1095	190	18	5	185	13	892	1.60088	0.03559	1.85447	5.26502	0.65319	0.2198474879	0.8771914765	3.12329	0.54117	84	9	2	106	9	3	0.31845	0.16846
21	15777000	Prediabetes	107	40275004	Contact dermatitis	1095	333	18	7	326	11	751	1.27878	0.02382	1.46598	3.81534	0.56328	0.4437432928	1.0000000000	5.47397	0.30535	159	9	3	174	9	4	0.20764	0.19349
20	80394007	Hyperglycemia (disorder)	107	40275004	Contact dermatitis	1095	55	18	2	53	16	1024	2.21212	0.03604	2.41509	10.77704	0.54121	0.2275517155	0.8856025459	0.90411	0.65585	23	9	0	32	9	2	-1.70475	-2.83321
18	302870006	Hypertriglyceridemia (disorder)	107	40275004	Contact dermatitis	1095	64	18	2	62	16	1015	1.90104	0.02902	2.04637	9.09966	0.46020	0.2838342633	0.9659403678	1.05205	0.54789	28	9	0	36	9	2	-1.70475	-2.94444
17	368581000119106	Neuropathy due to type 2 diabetes mellitus (disorder)	107	40275004	Contact dermatitis	1095	28	18	0	28	18	1049	0.00000	-0.02094	0.00000	0.00000	0.00000	1.0000000000	1.0000000000	0.46027	-0.54624	7	9	0	21	9	0	0.00000	0.00000
129	47505003	Posttraumatic stress disorder	81	236077008	Protracted diarrhea	1095	4	4	0	4	4	1087	0.00000	-0.00367	0.00000	0.00000	0.00000	1.0000000000	1.0000000000	0.01461	-0.02093	1	2	0	3	2	0	0.00000	0.00000
15	40055000	Chronic sinusitis (disorder)	107	40275004	Contact dermatitis	1095	216	18	4	212	14	865	1.12654	0.00811	1.16577	3.57757	0.37987	0.7665373413	1.0000000000	3.55068	0.13584	104	9	2	112	9	2	0.00000	-0.07276
14	10509002	Acute bronchitis (disorder)	107	40275004	Contact dermatitis	1095	863	18	16	847	2	230	1.12785	0.03188	2.17237	9.51625	0.49591	0.3922033499	1.0000000000	14.18630	0.16276	418	9	8	445	9	8	0.00000	-0.06145
13	370247008	Facial laceration	107	40275004	Contact dermatitis	1095	109	18	2	107	16	970	1.11621	0.00500	1.13318	4.99530	0.25706	0.6980598418	1.0000000000	1.79178	0.10378	55	9	2	54	9	0	1.70475	3.34990
125	1734006	Fracture of the vertebral column with spinal cord injury	81	236077008	Protracted diarrhea	1095	5	4	0	5	4	1086	0.00000	-0.00410	0.00000	0.00000	0.00000	1.0000000000	1.0000000000	0.01826	-0.02611	3	2	0	2	2	0	0.00000	0.00000
124	1501000119109	Proliferative diabetic retinopathy due to type II diabetes mellitus (disorder)	81	236077008	Protracted diarrhea	1095	1	4	0	1	4	1090	0.00000	-0.00183	0.00000	0.00000	0.00000	1.0000000000	1.0000000000	0.00365	-0.00526	1	2	0	0	2	0	0.00000	0.00000
10	62106007	Concussion with no loss of consciousness	107	40275004	Contact dermatitis	1095	206	18	4	202	14	875	1.18123	0.01128	1.23762	3.79951	0.40313	0.7598702342	1.0000000000	3.38630	0.18892	96	9	3	110	9	1	-0.91629	-1.21302
121	254637007	Non-small cell lung cancer (disorder)	81	236077008	Protracted diarrhea	1095	8	4	0	8	4	1083	0.00000	-0.00519	0.00000	0.00000	0.00000	1.0000000000	1.0000000000	0.02922	-0.04156	0	2	0	8	2	0	0.00000	0.00000
7	75498004	Acute bacterial sinusitis (disorder)	107	40275004	Contact dermatitis	1095	187	18	5	182	13	895	1.62656	0.03676	1.89138	5.37065	0.66609	0.2129177611	0.8671354646	3.07397	0.55853	89	9	4	98	9	1	-1.12393	-1.44881
6	39848009	Whiplash injury to neck	107	40275004	Contact dermatitis	1095	182	18	2	180	16	897	0.66850	-0.01913	0.62292	2.73279	0.14199	0.7527618468	1.0000000000	2.99178	-0.41207	92	9	1	90	9	1	0.00000	0.02174
5	284549007	Laceration of hand	107	40275004	Contact dermatitis	1095	104	18	2	102	16	975	1.16987	0.00711	1.19485	5.27027	0.27089	0.6858204370	1.0000000000	1.70959	0.14689	54	9	2	50	9	0	1.70475	3.33220
117	230265002	Familial Alzheimer's disease of early onset (disorder)	81	236077008	Protracted diarrhea	1095	6	4	0	6	4	1085	0.00000	-0.00449	0.00000	0.00000	0.00000	1.0000000000	1.0000000000	0.02192	-0.03128	2	2	0	4	2	0	0.00000	0.00000
115	36923009	Major depression  single episode	81	236077008	Protracted diarrhea	1095	6	4	0	6	4	1085	0.00000	-0.00449	0.00000	0.00000	0.00000	1.0000000000	1.0000000000	0.02192	-0.03128	3	2	0	3	2	0	0.00000	0.00000
1	444814009	Viral sinusitis (disorder)	107	40275004	Contact dermatitis	1095	993	18	18	975	0	102	1.10272	0.04143	0.00000	0.00000	0.00000	0.4007458143	1.0000000000	16.32329	0.13329	478	9	9	515	9	9	0.00000	-0.07323
112	49436004	Atrial Fibrillation	81	236077008	Protracted diarrhea	1095	35	4	1	34	3	1057	7.82143	0.07505	10.36275	102.20808	1.05067	0.1220126900	0.6889733259	0.12785	0.82642	9	2	0	26	2	1	-1.09861	-3.29584
111	235919008	Cholelithiasis	81	236077008	Protracted diarrhea	1095	9	4	0	9	4	1082	0.00000	-0.00551	0.00000	0.00000	0.00000	1.0000000000	1.0000000000	0.03288	-0.04667	7	2	0	2	2	0	0.00000	0.00000
109	90560007	Gout	81	236077008	Protracted diarrhea	1095	4	4	0	4	4	1087	0.00000	-0.00367	0.00000	0.00000	0.00000	1.0000000000	1.0000000000	0.01461	-0.02093	0	2	0	4	2	0	0.00000	0.00000
108	40930008	Hypothyroidism (disorder)	81	236077008	Protracted diarrhea	1095	13	4	0	13	4	1078	0.00000	-0.00664	0.00000	0.00000	0.00000	1.0000000000	1.0000000000	0.04749	-0.06693	11	2	0	2	2	0	0.00000	0.00000
107	40275004	Contact dermatitis	81	236077008	Protracted diarrhea	1095	18	4	0	18	4	1073	0.00000	-0.00783	0.00000	0.00000	0.00000	1.0000000000	1.0000000000	0.06575	-0.09187	9	2	0	9	2	0	0.00000	0.00000
106	24079001	Atopic dermatitis	81	236077008	Protracted diarrhea	1095	20	4	0	20	4	1071	0.00000	-0.00826	0.00000	0.00000	0.00000	1.0000000000	1.0000000000	0.07306	-0.10173	13	2	0	7	2	0	0.00000	0.00000
105	363406005	Malignant tumor of colon	81	236077008	Protracted diarrhea	1095	6	4	0	6	4	1085	0.00000	-0.00449	0.00000	0.00000	0.00000	1.0000000000	1.0000000000	0.02192	-0.03128	4	2	0	2	2	0	0.00000	0.00000
104	367498001	Seasonal allergic rhinitis	81	236077008	Protracted diarrhea	1095	20	4	0	20	4	1071	0.00000	-0.00826	0.00000	0.00000	0.00000	1.0000000000	1.0000000000	0.07306	-0.10173	9	2	0	11	2	0	0.00000	0.00000
102	90781000119102	Microalbuminuria due to type 2 diabetes mellitus (disorder)	81	236077008	Protracted diarrhea	1095	6	4	0	6	4	1085	0.00000	-0.00449	0.00000	0.00000	0.00000	1.0000000000	1.0000000000	0.02192	-0.03128	3	2	0	3	2	0	0.00000	0.00000
101	433144002	Chronic kidney disease stage 3 (disorder)	81	236077008	Protracted diarrhea	1095	3	4	0	3	4	1088	0.00000	-0.00317	0.00000	0.00000	0.00000	1.0000000000	1.0000000000	0.01096	-0.01572	1	2	0	2	2	0	0.00000	0.00000
100	161622006	History of lower limb amputation (situation)	81	236077008	Protracted diarrhea	1095	1	4	0	1	4	1090	0.00000	-0.00183	0.00000	0.00000	0.00000	1.0000000000	1.0000000000	0.00365	-0.00526	0	2	0	1	2	0	0.00000	0.00000
99	30832001	Rupture of patellar tendon	81	236077008	Protracted diarrhea	1095	23	4	0	23	4	1068	0.00000	-0.00887	0.00000	0.00000	0.00000	1.0000000000	1.0000000000	0.08402	-0.11639	14	2	0	9	2	0	0.00000	0.00000
98	1551000119108	Nonproliferative diabetic retinopathy due to type 2 diabetes mellitus (disorder)	81	236077008	Protracted diarrhea	1095	12	4	1	11	3	1080	22.81250	0.13903	32.72727	339.68704	3.15312	0.0431785002	0.3985498161	0.04384	0.93811	7	2	0	5	2	1	-1.09861	-1.79176
97	403192003	Third degree burn	81	236077008	Protracted diarrhea	1095	8	4	0	8	4	1083	0.00000	-0.00519	0.00000	0.00000	0.00000	1.0000000000	1.0000000000	0.02922	-0.04156	3	2	0	5	2	0	0.00000	0.00000
96	283371005	Laceration of forearm	81	236077008	Protracted diarrhea	1095	75	4	0	75	4	1016	0.00000	-0.01642	0.00000	0.00000	0.00000	1.0000000000	1.0000000000	0.27397	-0.34933	39	2	0	36	2	0	0.00000	0.00000
95	84757009	Epilepsy	81	236077008	Protracted diarrhea	1095	30	4	0	30	4	1061	0.00000	-0.01016	0.00000	0.00000	0.00000	1.0000000000	1.0000000000	0.10959	-0.15003	13	2	0	17	2	0	0.00000	0.00000
94	703151001	History of single seizure (situation)	81	236077008	Protracted diarrhea	1095	39	4	0	39	4	1052	0.00000	-0.01164	0.00000	0.00000	0.00000	1.0000000000	1.0000000000	0.14247	-0.19215	14	2	0	25	2	0	0.00000	0.00000
93	128613002	Seizure disorder	81	236077008	Protracted diarrhea	1095	39	4	0	39	4	1052	0.00000	-0.01164	0.00000	0.00000	0.00000	1.0000000000	1.0000000000	0.14247	-0.19215	14	2	0	25	2	0	0.00000	0.00000
89	47693006	Rupture of appendix	81	236077008	Protracted diarrhea	1095	20	4	0	20	4	1071	0.00000	-0.00826	0.00000	0.00000	0.00000	1.0000000000	1.0000000000	0.07306	-0.10173	10	2	0	10	2	0	0.00000	0.00000
86	713197008	Recurrent rectal polyp	81	236077008	Protracted diarrhea	1095	22	4	0	22	4	1069	0.00000	-0.00867	0.00000	0.00000	0.00000	1.0000000000	1.0000000000	0.08037	-0.11152	12	2	0	10	2	0	0.00000	0.00000
85	241929008	Acute allergic reaction	81	236077008	Protracted diarrhea	1095	47	4	0	47	4	1044	0.00000	-0.01282	0.00000	0.00000	0.00000	1.0000000000	1.0000000000	0.17169	-0.22859	25	2	0	22	2	0	0.00000	0.00000
82	94260004	Secondary malignant neoplasm of colon	81	236077008	Protracted diarrhea	1095	4	4	4	0	0	1091	273.75000	1.00000	0.00000	0.00000	0.00000	0.0000000000	0.0000000015	0.01461	2.30100	2	2	2	2	2	2	0.00000	0.00000
80	6072007	Bleeding from anus	81	236077008	Protracted diarrhea	1095	4	4	4	0	0	1091	273.75000	1.00000	0.00000	0.00000	0.00000	0.0000000000	0.0000000015	0.01461	2.30100	2	2	2	2	2	2	0.00000	0.00000
78	239872002	Osteoarthritis of hip	81	236077008	Protracted diarrhea	1095	21	4	0	21	4	1070	0.00000	-0.00847	0.00000	0.00000	0.00000	1.0000000000	1.0000000000	0.07671	-0.10663	13	2	0	8	2	0	0.00000	0.00000
76	127013003	Diabetic renal disease (disorder)	81	236077008	Protracted diarrhea	1095	28	4	1	27	3	1064	9.77679	0.08609	13.13580	130.38871	1.32335	0.0985562783	0.6237397336	0.10228	0.85951	10	2	0	18	2	1	-1.09861	-2.94444
75	431855005	Chronic kidney disease stage 1 (disorder)	81	236077008	Protracted diarrhea	1095	28	4	1	27	3	1064	9.77679	0.08609	13.13580	130.38871	1.32335	0.0985562783	0.6237397336	0.10228	0.85951	10	2	0	18	2	1	-1.09861	-2.94444
73	196416002	Impacted molars	81	236077008	Protracted diarrhea	1095	49	4	0	49	4	1042	0.00000	-0.01311	0.00000	0.00000	0.00000	1.0000000000	1.0000000000	0.17900	-0.23756	25	2	0	24	2	0	0.00000	0.00000
72	35999006	Blighted ovum	81	236077008	Protracted diarrhea	1095	53	4	1	52	3	1039	5.16509	0.05688	6.66026	65.13132	0.68107	0.1802279749	0.8113031609	0.19361	0.74467	53	2	1	0	2	0	1.09861	3.98898
71	201834006	Localized  primary osteoarthritis of the hand	81	236077008	Protracted diarrhea	1095	28	4	0	28	4	1063	0.00000	-0.00981	0.00000	0.00000	0.00000	1.0000000000	1.0000000000	0.10228	-0.14049	19	2	0	9	2	0	0.00000	0.00000
70	87433001	Pulmonary emphysema (disorder)	81	236077008	Protracted diarrhea	1095	17	4	0	17	4	1074	0.00000	-0.00760	0.00000	0.00000	0.00000	1.0000000000	1.0000000000	0.06210	-0.08692	9	2	0	8	2	0	0.00000	0.00000
69	233604007	Pneumonia	81	236077008	Protracted diarrhea	1095	7	4	0	7	4	1084	0.00000	-0.00486	0.00000	0.00000	0.00000	1.0000000000	1.0000000000	0.02557	-0.03643	3	2	0	4	2	0	0.00000	0.00000
68	26929004	Alzheimer's disease (disorder)	81	236077008	Protracted diarrhea	1095	23	4	0	23	4	1068	0.00000	-0.00887	0.00000	0.00000	0.00000	1.0000000000	1.0000000000	0.08402	-0.11639	15	2	0	8	2	0	0.00000	0.00000
67	403191005	Second degree burn	81	236077008	Protracted diarrhea	1095	49	4	1	48	3	1043	5.58673	0.06011	7.24306	70.92601	0.73967	0.1675492660	0.7942848378	0.17900	0.76244	23	2	0	26	2	1	-1.09861	-3.29584
65	239873007	Osteoarthritis of knee	81	236077008	Protracted diarrhea	1095	57	4	2	55	2	1036	9.60526	0.12210	18.83636	136.24169	2.60426	0.0149348054	0.2058049008	0.20822	1.31208	30	2	1	27	2	1	0.00000	0.10178
64	444448004	Injury of medial collateral ligament of knee	81	236077008	Protracted diarrhea	1095	32	4	0	32	4	1059	0.00000	-0.01051	0.00000	0.00000	0.00000	1.0000000000	1.0000000000	0.11689	-0.15949	17	2	0	15	2	0	0.00000	0.00000
63	68496003	Polyp of colon	81	236077008	Protracted diarrhea	1095	91	4	0	91	4	1000	0.00000	-0.01823	0.00000	0.00000	0.00000	1.0000000000	1.0000000000	0.33242	-0.41405	43	2	0	48	2	0	0.00000	0.00000
62	185086009	Chronic obstructive bronchitis (disorder)	81	236077008	Protracted diarrhea	1095	6	4	0	6	4	1085	0.00000	-0.00449	0.00000	0.00000	0.00000	1.0000000000	1.0000000000	0.02192	-0.03128	4	2	0	2	2	0	0.00000	0.00000
59	262574004	Bullet wound	81	236077008	Protracted diarrhea	1095	20	4	0	20	4	1071	0.00000	-0.00826	0.00000	0.00000	0.00000	1.0000000000	1.0000000000	0.07306	-0.10173	9	2	0	11	2	0	0.00000	0.00000
58	239720000	Tear of meniscus of knee	81	236077008	Protracted diarrhea	1095	20	4	0	20	4	1071	0.00000	-0.00826	0.00000	0.00000	0.00000	1.0000000000	1.0000000000	0.07306	-0.10173	10	2	0	10	2	0	0.00000	0.00000
57	192127007	Child attention deficit disorder	81	236077008	Protracted diarrhea	1095	76	4	1	75	3	1016	3.60197	0.04303	4.51556	43.93983	0.46405	0.2503433784	0.9133257124	0.27763	0.64653	24	2	0	52	2	1	-1.09861	-3.97029
56	92691004	Carcinoma in situ of prostate (disorder)	81	236077008	Protracted diarrhea	1095	23	4	1	22	3	1069	11.90217	0.09669	16.19697	161.90868	1.62031	0.0815162066	0.5629813232	0.08402	0.88361	0	2	0	23	2	1	-1.09861	-3.17805
54	5602001	Opioid abuse (disorder)	81	236077008	Protracted diarrhea	1095	7	4	0	7	4	1084	0.00000	-0.00486	0.00000	0.00000	0.00000	1.0000000000	1.0000000000	0.02557	-0.03643	0	2	0	7	2	0	0.00000	0.00000
52	124171000119105	Chronic intractable migraine without aura	81	236077008	Protracted diarrhea	1095	51	4	1	50	3	1041	5.36765	0.05845	6.94000	67.91084	0.70922	0.1739068632	0.7996618359	0.18630	0.75353	21	2	0	30	2	1	-1.09861	-3.43399
50	446096008	Perennial allergic rhinitis	81	236077008	Protracted diarrhea	1095	26	4	0	26	4	1065	0.00000	-0.00944	0.00000	0.00000	0.00000	1.0000000000	1.0000000000	0.09498	-0.13090	14	2	0	12	2	0	0.00000	0.00000
49	88805009	Chronic congestive heart failure (disorder)	81	236077008	Protracted diarrhea	1095	10	4	0	10	4	1081	0.00000	-0.00581	0.00000	0.00000	0.00000	1.0000000000	1.0000000000	0.03653	-0.05176	5	2	0	5	2	0	0.00000	0.00000
47	359817006	Closed fracture of hip	81	236077008	Protracted diarrhea	1095	29	4	0	29	4	1062	0.00000	-0.00999	0.00000	0.00000	0.00000	1.0000000000	1.0000000000	0.10594	-0.14527	11	2	0	18	2	0	0.00000	0.00000
46	62564004	Concussion with loss of consciousness	81	236077008	Protracted diarrhea	1095	67	4	0	67	4	1024	0.00000	-0.01546	0.00000	0.00000	0.00000	1.0000000000	1.0000000000	0.24475	-0.31585	36	2	0	31	2	0	0.00000	0.00000
45	263102004	Fracture subluxation of wrist	81	236077008	Protracted diarrhea	1095	109	4	0	109	4	982	0.00000	-0.02013	0.00000	0.00000	0.00000	1.0000000000	1.0000000000	0.39817	-0.48354	51	2	0	58	2	0	0.00000	0.00000
44	58150001	Fracture of clavicle	81	236077008	Protracted diarrhea	1095	112	4	0	112	4	979	0.00000	-0.02044	0.00000	0.00000	0.00000	1.0000000000	1.0000000000	0.40913	-0.49481	55	2	0	57	2	0	0.00000	0.00000
43	307731004	Injury of tendon of the rotator cuff of shoulder	81	236077008	Protracted diarrhea	1095	51	4	1	50	3	1041	5.36765	0.05845	6.94000	67.91084	0.70922	0.1739068632	0.7996618359	0.18630	0.75353	26	2	1	25	2	0	1.09861	3.29584
42	16114001	Fracture of ankle	81	236077008	Protracted diarrhea	1095	108	4	1	107	3	984	2.53472	0.03074	3.06542	29.72939	0.31608	0.3402929047	1.0000000000	0.39452	0.52023	48	2	1	60	2	0	1.09861	3.89182
41	283385000	Laceration of thigh	81	236077008	Protracted diarrhea	1095	105	4	0	105	4	986	0.00000	-0.01972	0.00000	0.00000	0.00000	1.0000000000	1.0000000000	0.38356	-0.46839	50	2	0	55	2	0	0.00000	0.00000
39	74400008	Appendicitis	81	236077008	Protracted diarrhea	1095	51	4	0	51	4	1040	0.00000	-0.01338	0.00000	0.00000	0.00000	1.0000000000	1.0000000000	0.18630	-0.24647	27	2	0	24	2	0	0.00000	0.00000
38	398254007	Preeclampsia	81	236077008	Protracted diarrhea	1095	101	4	0	101	4	990	0.00000	-0.01930	0.00000	0.00000	0.00000	1.0000000000	1.0000000000	0.36895	-0.45307	101	2	0	0	2	0	0.00000	0.00000
35	19169002	Miscarriage in first trimester	81	236077008	Protracted diarrhea	1095	174	4	2	172	2	919	3.14655	0.05649	5.34302	38.18758	0.74757	0.1209931534	0.6887664724	0.63562	0.87513	174	2	2	0	2	0	0.69315	4.47734
33	429007001	History of cardiac arrest (situation)	81	236077008	Protracted diarrhea	1095	42	4	0	42	4	1049	0.00000	-0.01209	0.00000	0.00000	0.00000	1.0000000000	1.0000000000	0.15342	-0.20592	24	2	0	18	2	0	0.00000	0.00000
32	410429000	Cardiac Arrest	81	236077008	Protracted diarrhea	1095	42	4	0	42	4	1049	0.00000	-0.01209	0.00000	0.00000	0.00000	1.0000000000	1.0000000000	0.15342	-0.20592	24	2	0	18	2	0	0.00000	0.00000
30	399211009	History of myocardial infarction (situation)	81	236077008	Protracted diarrhea	1095	31	4	0	31	4	1060	0.00000	-0.01034	0.00000	0.00000	0.00000	1.0000000000	1.0000000000	0.11324	-0.15477	2	2	0	29	2	0	0.00000	0.00000
29	22298006	Myocardial Infarction	81	236077008	Protracted diarrhea	1095	31	4	0	31	4	1060	0.00000	-0.01034	0.00000	0.00000	0.00000	1.0000000000	1.0000000000	0.11324	-0.15477	2	2	0	29	2	0	0.00000	0.00000
28	53741008	Coronary Heart Disease	81	236077008	Protracted diarrhea	1095	80	4	1	79	3	1012	3.42187	0.04117	4.27004	41.52726	0.43907	0.2620622740	0.9281913645	0.29224	0.63013	24	2	0	56	2	1	-1.09861	-4.04305
27	408512008	Body mass index 40+ - severely obese (finding)	81	236077008	Protracted diarrhea	1095	97	4	0	97	4	994	0.00000	-0.01888	0.00000	0.00000	0.00000	1.0000000000	1.0000000000	0.35434	-0.43759	67	2	0	30	2	0	0.00000	0.00000
26	33737001	Fracture of rib	81	236077008	Protracted diarrhea	1095	54	4	0	54	4	1037	0.00000	-0.01379	0.00000	0.00000	0.00000	1.0000000000	1.0000000000	0.19726	-0.25974	32	2	0	22	2	0	0.00000	0.00000
24	162864005	Body mass index 30+ - obesity (finding)	81	236077008	Protracted diarrhea	1095	439	4	4	435	0	656	2.49431	0.07402	0.00000	0.00000	0.00000	0.0256231380	0.2905941929	1.60365	0.94139	226	2	2	213	2	2	0.00000	0.05871
23	36971009	Sinusitis (disorder)	81	236077008	Protracted diarrhea	1095	190	4	0	190	4	901	0.00000	-0.02774	0.00000	0.00000	0.00000	1.0000000000	1.0000000000	0.69406	-0.76049	84	2	0	106	2	0	0.00000	0.00000
21	15777000	Prediabetes	81	236077008	Protracted diarrhea	1095	333	4	1	332	3	759	0.82207	-0.00712	0.76205	7.35294	0.07898	1.0000000000	1.0000000000	1.21644	-0.14824	159	2	1	174	2	0	1.09861	5.07517
20	80394007	Hyperglycemia (disorder)	81	236077008	Protracted diarrhea	1095	55	4	1	54	3	1037	4.97727	0.05538	6.40123	62.56087	0.65497	0.1865127411	0.8181443419	0.20091	0.73587	23	2	0	32	2	1	-1.09861	-3.49651
19	237602007	Metabolic syndrome X (disorder)	81	236077008	Protracted diarrhea	1095	64	4	1	63	3	1028	4.27734	0.04944	5.43915	53.04017	0.55777	0.2143481492	0.8672161313	0.23379	0.69690	28	2	0	36	2	1	-1.09861	-3.61092
18	302870006	Hypertriglyceridemia (disorder)	81	236077008	Protracted diarrhea	1095	64	4	1	63	3	1028	4.27734	0.04944	5.43915	53.04017	0.55777	0.2143481492	0.8672161313	0.23379	0.69690	28	2	0	36	2	1	-1.09861	-3.61092
17	368581000119106	Neuropathy due to type 2 diabetes mellitus (disorder)	81	236077008	Protracted diarrhea	1095	28	4	0	28	4	1063	0.00000	-0.00981	0.00000	0.00000	0.00000	1.0000000000	1.0000000000	0.10228	-0.14049	7	2	0	21	2	0	0.00000	0.00000
129	47505003	Posttraumatic stress disorder	55	126906006	Neoplasm of prostate	1095	4	24	2	2	22	1069	22.81250	0.19771	48.59091	360.80905	6.54384	0.0026911050	0.0547074043	0.08767	1.46372	1	0	0	3	24	2	-2.56495	-0.91629
15	40055000	Chronic sinusitis (disorder)	81	236077008	Protracted diarrhea	1095	216	4	2	214	2	877	2.53472	0.04607	4.09813	29.25896	0.57400	0.1763210047	0.8029498763	0.78904	0.74578	104	2	1	112	2	1	0.00000	-0.07343
14	10509002	Acute bronchitis (disorder)	81	236077008	Protracted diarrhea	1095	863	4	4	859	0	232	1.26883	0.03139	0.00000	0.00000	0.00000	0.5842857155	1.0000000000	3.15251	0.26794	418	2	2	445	2	2	0.00000	-0.06230
13	370247008	Facial laceration	81	236077008	Protracted diarrhea	1095	109	4	0	109	4	982	0.00000	-0.02013	0.00000	0.00000	0.00000	1.0000000000	1.0000000000	0.39817	-0.48354	55	2	0	54	2	0	0.00000	0.00000
125	1734006	Fracture of the vertebral column with spinal cord injury	55	126906006	Neoplasm of prostate	1095	5	24	0	5	24	1066	0.00000	-0.01014	0.00000	0.00000	0.00000	1.0000000000	1.0000000000	0.10959	-0.15003	3	0	0	2	24	0	0.00000	0.00000
124	1501000119109	Proliferative diabetic retinopathy due to type II diabetes mellitus (disorder)	55	126906006	Neoplasm of prostate	1095	1	24	0	1	24	1070	0.00000	-0.00453	0.00000	0.00000	0.00000	1.0000000000	1.0000000000	0.02192	-0.03128	1	0	0	0	24	0	0.00000	0.00000
10	62106007	Concussion with no loss of consciousness	81	236077008	Protracted diarrhea	1095	206	4	3	203	1	888	3.98665	0.08705	13.12315	126.80911	1.35808	0.0226490157	0.2721606699	0.75251	1.19058	96	2	1	110	2	2	0.40547	0.54936
9	44465007	Sprain of ankle	81	236077008	Protracted diarrhea	1095	362	4	2	360	2	731	1.51243	0.02180	2.03056	14.47372	0.28487	0.6027839823	1.0000000000	1.32237	0.36936	185	2	1	177	2	1	0.00000	0.04396
8	233678006	Childhood asthma	81	236077008	Protracted diarrhea	1095	45	4	0	45	4	1046	0.00000	-0.01254	0.00000	0.00000	0.00000	1.0000000000	1.0000000000	0.16438	-0.21957	25	2	0	20	2	0	0.00000	0.00000
7	75498004	Acute bacterial sinusitis (disorder)	81	236077008	Protracted diarrhea	1095	187	4	2	185	2	906	2.92781	0.05297	4.89730	34.98846	0.68547	0.1373791614	0.7296699408	0.68311	0.83384	89	2	1	98	2	1	0.00000	-0.09531
6	39848009	Whiplash injury to neck	81	236077008	Protracted diarrhea	1095	182	4	1	181	3	910	1.50412	0.01363	1.67587	16.20183	0.17335	0.5172179176	1.0000000000	0.66484	0.26462	92	2	1	90	2	0	1.09861	4.53260
5	284549007	Laceration of hand	81	236077008	Protracted diarrhea	1095	104	4	1	103	3	988	2.63221	0.03202	3.19741	31.01888	0.32959	0.3295168874	1.0000000000	0.37991	0.53543	54	2	1	50	2	0	1.09861	4.00733
117	230265002	Familial Alzheimer's disease of early onset (disorder)	55	126906006	Neoplasm of prostate	1095	6	24	0	6	24	1065	0.00000	-0.01111	0.00000	0.00000	0.00000	1.0000000000	1.0000000000	0.13151	-0.17825	2	0	0	4	24	0	0.00000	0.00000
116	370143000	Major depression disorder	55	126906006	Neoplasm of prostate	1095	8	24	3	5	21	1066	17.10937	0.20688	30.45714	135.83176	6.82931	0.0004830219	0.0135462174	0.17534	1.76692	3	0	0	5	24	3	-2.19722	-0.98083
115	36923009	Major depression  single episode	55	126906006	Neoplasm of prostate	1095	6	24	1	5	23	1066	7.60417	0.07338	9.26957	82.52867	1.04115	0.1247777687	0.6927889020	0.13151	0.82175	3	0	0	3	24	1	-3.21888	-1.38629
1	444814009	Viral sinusitis (disorder)	81	236077008	Protracted diarrhea	1095	993	4	4	989	0	102	1.10272	0.01941	0.00000	0.00000	0.00000	1.0000000000	1.0000000000	3.62740	0.11173	478	2	2	515	2	2	0.00000	-0.07426
113	443165006	Pathological fracture due to osteoporosis (disorder)	55	126906006	Neoplasm of prostate	1095	10	24	1	9	23	1062	4.56250	0.05120	5.13043	42.18516	0.62395	0.1995186591	0.8432232976	0.21918	0.71409	7	0	0	3	24	1	-3.21888	-1.38629
112	49436004	Atrial Fibrillation	55	126906006	Neoplasm of prostate	1095	35	24	12	23	12	1048	15.64286	0.39831	45.56522	112.13029	18.51586	0.0000000000	0.0000000000	0.76712	2.87904	9	0	0	26	24	12	-1.09861	-1.15268
111	235919008	Cholelithiasis	55	126906006	Neoplasm of prostate	1095	9	24	1	8	23	1063	5.06944	0.05546	5.77717	48.10643	0.69379	0.1814286852	0.8137869183	0.19726	0.74026	7	0	0	2	24	1	-3.21888	-1.09861
110	65275009	Acute Cholecystitis	55	126906006	Neoplasm of prostate	1095	9	24	1	8	23	1063	5.06944	0.05546	5.77717	48.10643	0.69379	0.1814286852	0.8137869183	0.19726	0.74026	7	0	0	2	24	1	-3.21888	-1.09861
109	90560007	Gout	55	126906006	Neoplasm of prostate	1095	4	24	0	4	24	1067	0.00000	-0.00906	0.00000	0.00000	0.00000	1.0000000000	1.0000000000	0.08767	-0.12124	0	0	0	4	24	0	0.00000	0.00000
108	40930008	Hypothyroidism (disorder)	55	126906006	Neoplasm of prostate	1095	13	24	1	12	23	1059	3.50962	0.04118	3.83696	30.75592	0.47868	0.2515187157	0.9133257124	0.28493	0.63831	11	0	0	2	24	1	-3.21888	-1.09861
107	40275004	Contact dermatitis	55	126906006	Neoplasm of prostate	1095	18	24	0	18	24	1053	0.00000	-0.01935	0.00000	0.00000	0.00000	1.0000000000	1.0000000000	0.39452	-0.47977	9	0	0	9	24	0	0.00000	0.00000
106	24079001	Atopic dermatitis	55	126906006	Neoplasm of prostate	1095	20	24	0	20	24	1051	0.00000	-0.02042	0.00000	0.00000	0.00000	1.0000000000	1.0000000000	0.43836	-0.52442	13	0	0	7	24	0	0.00000	0.00000
105	363406005	Malignant tumor of colon	55	126906006	Neoplasm of prostate	1095	6	24	1	5	23	1066	7.60417	0.07338	9.26957	82.52867	1.04115	0.1247777687	0.6927889020	0.13151	0.82175	4	0	0	2	24	1	-3.21888	-1.09861
104	367498001	Seasonal allergic rhinitis	55	126906006	Neoplasm of prostate	1095	20	24	0	20	24	1051	0.00000	-0.02042	0.00000	0.00000	0.00000	1.0000000000	1.0000000000	0.43836	-0.52442	9	0	0	11	24	0	0.00000	0.00000
103	157141000119108	Proteinuria due to type 2 diabetes mellitus (disorder)	55	126906006	Neoplasm of prostate	1095	3	24	1	2	23	1069	15.20833	0.11148	23.23913	265.48937	2.03420	0.0643803150	0.4935519847	0.06575	0.90813	1	0	0	2	24	1	-3.21888	-1.09861
102	90781000119102	Microalbuminuria due to type 2 diabetes mellitus (disorder)	55	126906006	Neoplasm of prostate	1095	6	24	1	5	23	1066	7.60417	0.07338	9.26957	82.52867	1.04115	0.1247777687	0.6927889020	0.13151	0.82175	3	0	0	3	24	1	-3.21888	-1.38629
101	433144002	Chronic kidney disease stage 3 (disorder)	55	126906006	Neoplasm of prostate	1095	3	24	1	2	23	1069	15.20833	0.11148	23.23913	265.48937	2.03420	0.0643803150	0.4935519847	0.06575	0.90813	1	0	0	2	24	1	-3.21888	-1.09861
100	161622006	History of lower limb amputation (situation)	55	126906006	Neoplasm of prostate	1095	1	24	0	1	24	1070	0.00000	-0.00453	0.00000	0.00000	0.00000	1.0000000000	1.0000000000	0.02192	-0.03128	0	0	0	1	24	0	0.00000	0.00000
99	30832001	Rupture of patellar tendon	55	126906006	Neoplasm of prostate	1095	23	24	0	23	24	1048	0.00000	-0.02193	0.00000	0.00000	0.00000	1.0000000000	1.0000000000	0.50411	-0.58891	14	0	0	9	24	0	0.00000	0.00000
98	1551000119108	Nonproliferative diabetic retinopathy due to type 2 diabetes mellitus (disorder)	55	126906006	Neoplasm of prostate	1095	12	24	1	11	23	1060	3.80208	0.04415	4.18972	33.81877	0.51905	0.2345559671	0.8987046176	0.26301	0.66313	7	0	0	5	24	1	-3.21888	-1.79176
97	403192003	Third degree burn	55	126906006	Neoplasm of prostate	1095	8	24	1	7	23	1064	5.70312	0.06040	6.60870	55.92480	0.78096	0.1629473009	0.7879650300	0.17534	0.76692	3	0	0	5	24	1	-3.21888	-1.79176
96	283371005	Laceration of forearm	55	126906006	Neoplasm of prostate	1095	75	24	3	72	21	999	1.82500	0.03349	1.98214	6.80264	0.57755	0.2232610228	0.8794911525	1.64384	0.59737	39	0	0	36	24	3	-2.19722	-2.56495
95	84757009	Epilepsy	55	126906006	Neoplasm of prostate	1095	30	24	0	30	24	1041	0.00000	-0.02512	0.00000	0.00000	0.00000	1.0000000000	1.0000000000	0.65753	-0.72904	13	0	0	17	24	0	0.00000	0.00000
94	703151001	History of single seizure (situation)	55	126906006	Neoplasm of prostate	1095	39	24	2	37	22	1034	2.33974	0.03854	2.54054	11.20756	0.57589	0.2092523682	0.8619508625	0.85479	0.69370	14	0	0	25	24	2	-2.56495	-2.60269
93	128613002	Seizure disorder	55	126906006	Neoplasm of prostate	1095	39	24	2	37	22	1034	2.33974	0.03854	2.54054	11.20756	0.57589	0.2092523682	0.8619508625	0.85479	0.69370	14	0	0	25	24	2	-2.56495	-2.60269
92	82423001	Chronic pain	55	126906006	Neoplasm of prostate	1095	52	24	2	50	22	1021	1.75481	0.02523	1.85636	8.11509	0.42465	0.3170506606	1.0000000000	1.13973	0.48754	24	0	0	28	24	2	-2.56495	-2.70805
91	64859006	Osteoporosis (disorder)	55	126906006	Neoplasm of prostate	1095	37	24	6	31	18	1040	7.39865	0.17913	11.18280	30.11333	4.15281	0.0000848558	0.0029558088	0.81096	1.95060	24	0	0	13	24	6	-1.60944	-1.15268
89	47693006	Rupture of appendix	55	126906006	Neoplasm of prostate	1095	20	24	0	20	24	1051	0.00000	-0.02042	0.00000	0.00000	0.00000	1.0000000000	1.0000000000	0.43836	-0.52442	10	0	0	10	24	0	0.00000	0.00000
88	197927001	Recurrent urinary tract infection	55	126906006	Neoplasm of prostate	1095	8	24	0	8	24	1063	0.00000	-0.01284	0.00000	0.00000	0.00000	1.0000000000	1.0000000000	0.17534	-0.23308	8	0	0	0	24	0	0.00000	0.00000
86	713197008	Recurrent rectal polyp	55	126906006	Neoplasm of prostate	1095	22	24	3	19	21	1052	6.22159	0.11192	7.90977	28.79190	2.17299	0.0108456006	0.1627396269	0.48219	1.43227	12	0	0	10	24	3	-2.19722	-1.46634
85	241929008	Acute allergic reaction	55	126906006	Neoplasm of prostate	1095	47	24	1	46	23	1025	0.97074	-0.00093	0.96881	7.33097	0.12803	1.0000000000	1.0000000000	1.03014	-0.02158	25	0	0	22	24	1	-3.21888	-3.13549
84	232353008	Perennial allergic rhinitis with seasonal variation	55	126906006	Neoplasm of prostate	1095	29	24	0	29	24	1042	0.00000	-0.02469	0.00000	0.00000	0.00000	1.0000000000	1.0000000000	0.63562	-0.70983	14	0	0	15	24	0	0.00000	0.00000
83	110030002	Concussion injury of brain	55	126906006	Neoplasm of prostate	1095	7	24	0	7	24	1064	0.00000	-0.01201	0.00000	0.00000	0.00000	1.0000000000	1.0000000000	0.15342	-0.20592	1	0	0	6	24	0	0.00000	0.00000
82	94260004	Secondary malignant neoplasm of colon	55	126906006	Neoplasm of prostate	1095	4	24	1	3	23	1068	11.40625	0.09432	15.47826	154.46942	1.55096	0.0849433850	0.5757784040	0.08767	0.87876	2	0	0	2	24	1	-3.21888	-1.09861
81	236077008	Protracted diarrhea	55	126906006	Neoplasm of prostate	1095	4	24	1	3	23	1068	11.40625	0.09432	15.47826	154.46942	1.55096	0.0849433850	0.5757784040	0.08767	0.87876	2	0	0	2	24	1	-3.21888	-1.09861
80	6072007	Bleeding from anus	55	126906006	Neoplasm of prostate	1095	4	24	1	3	23	1068	11.40625	0.09432	15.47826	154.46942	1.55096	0.0849433850	0.5757784040	0.08767	0.87876	2	0	0	2	24	1	-3.21888	-1.09861
79	45816000	Pyelonephritis	55	126906006	Neoplasm of prostate	1095	1	24	0	1	24	1070	0.00000	-0.00453	0.00000	0.00000	0.00000	1.0000000000	1.0000000000	0.02192	-0.03128	1	0	0	0	24	0	0.00000	0.00000
78	239872002	Osteoarthritis of hip	55	126906006	Neoplasm of prostate	1095	21	24	1	20	23	1051	2.17262	0.02455	2.28478	17.75540	0.29401	0.3748387348	1.0000000000	0.46027	0.45376	13	0	0	8	24	1	-3.21888	-2.19722
77	422034002	Diabetic retinopathy associated with type II diabetes mellitus (disorder)	55	126906006	Neoplasm of prostate	1095	20	24	1	19	23	1052	2.28125	0.02616	2.40732	18.75381	0.30901	0.3605629304	1.0000000000	0.43836	0.47558	8	0	0	12	24	1	-3.21888	-2.56495
76	127013003	Diabetic renal disease (disorder)	55	126906006	Neoplasm of prostate	1095	28	24	5	23	19	1048	8.14732	0.17332	11.99085	34.89681	4.12016	0.0002292176	0.0071740650	0.61370	1.89459	10	0	0	18	24	5	-1.75786	-1.52606
75	431855005	Chronic kidney disease stage 1 (disorder)	55	126906006	Neoplasm of prostate	1095	28	24	5	23	19	1048	8.14732	0.17332	11.99085	34.89681	4.12016	0.0002292176	0.0071740650	0.61370	1.89459	10	0	0	18	24	5	-1.75786	-1.52606
73	196416002	Impacted molars	55	126906006	Neoplasm of prostate	1095	49	24	3	46	21	1025	2.79337	0.05810	3.18323	11.05803	0.91634	0.0880340270	0.5876522352	1.07397	0.94760	25	0	0	24	24	3	-2.19722	-2.19722
72	35999006	Blighted ovum	55	126906006	Neoplasm of prostate	1095	53	24	0	53	24	1018	0.00000	-0.03376	0.00000	0.00000	0.00000	0.6254166980	1.0000000000	1.16164	-1.11213	53	0	0	0	24	0	0.00000	0.00000
71	201834006	Localized  primary osteoarthritis of the hand	55	126906006	Neoplasm of prostate	1095	28	24	1	27	23	1044	1.62946	0.01526	1.68116	12.90648	0.21898	0.4665517539	1.0000000000	0.61370	0.30963	19	0	0	9	24	1	-3.21888	-2.30259
70	87433001	Pulmonary emphysema (disorder)	55	126906006	Neoplasm of prostate	1095	17	24	0	17	24	1054	0.00000	-0.01880	0.00000	0.00000	0.00000	1.0000000000	1.0000000000	0.37260	-0.45691	9	0	0	8	24	0	0.00000	0.00000
69	233604007	Pneumonia	55	126906006	Neoplasm of prostate	1095	7	24	1	6	23	1065	6.51786	0.06625	7.71739	66.71333	0.89275	0.1440664130	0.7404942507	0.15342	0.79408	3	0	0	4	24	1	-3.21888	-1.60944
68	26929004	Alzheimer's disease (disorder)	55	126906006	Neoplasm of prostate	1095	23	24	3	20	21	1051	5.95109	0.10856	7.50714	27.21948	2.07047	0.0122935690	0.1763283468	0.50411	1.41109	15	0	0	8	24	3	-2.19722	-1.29928
67	403191005	Second degree burn	55	126906006	Neoplasm of prostate	1095	49	24	1	48	23	1023	0.93112	-0.00223	0.92663	7.00579	0.12256	1.0000000000	1.0000000000	1.07397	-0.05240	23	0	0	26	24	1	-3.21888	-3.29584
65	239873007	Osteoarthritis of knee	55	126906006	Neoplasm of prostate	1095	57	24	1	56	23	1015	0.80044	-0.00700	0.78804	5.94122	0.10453	1.0000000000	1.0000000000	1.24932	-0.16949	30	0	0	27	24	1	-3.21888	-3.33220
64	444448004	Injury of medial collateral ligament of knee	55	126906006	Neoplasm of prostate	1095	32	24	2	30	22	1041	2.85156	0.04809	3.15455	14.02984	0.70929	0.1533954178	0.7711941449	0.70137	0.81827	17	0	0	15	24	2	-2.56495	-2.14007
63	68496003	Polyp of colon	55	126906006	Neoplasm of prostate	1095	91	24	7	84	17	987	3.50962	0.11310	4.83824	11.99513	1.95150	0.0023318941	0.0489697765	1.99452	1.41767	43	0	0	48	24	7	-1.48808	-2.06142
62	185086009	Chronic obstructive bronchitis (disorder)	55	126906006	Neoplasm of prostate	1095	6	24	0	6	24	1065	0.00000	-0.01111	0.00000	0.00000	0.00000	1.0000000000	1.0000000000	0.13151	-0.17825	4	0	0	2	24	0	0.00000	0.00000
60	301011002	Escherichia coli urinary tract infection	55	126906006	Neoplasm of prostate	1095	92	24	0	92	24	979	0.00000	-0.04534	0.00000	0.00000	0.00000	0.2544241364	0.9141772695	2.01644	-1.59285	85	0	0	7	24	0	0.00000	0.00000
59	262574004	Bullet wound	55	126906006	Neoplasm of prostate	1095	20	24	0	20	24	1051	0.00000	-0.02042	0.00000	0.00000	0.00000	1.0000000000	1.0000000000	0.43836	-0.52442	9	0	0	11	24	0	0.00000	0.00000
58	239720000	Tear of meniscus of knee	55	126906006	Neoplasm of prostate	1095	20	24	0	20	24	1051	0.00000	-0.02042	0.00000	0.00000	0.00000	1.0000000000	1.0000000000	0.43836	-0.52442	10	0	0	10	24	0	0.00000	0.00000
57	192127007	Child attention deficit disorder	55	126906006	Neoplasm of prostate	1095	76	24	0	76	24	995	0.00000	-0.04088	0.00000	0.00000	0.00000	0.4037607595	1.0000000000	1.66575	-1.41454	24	0	0	52	24	0	0.00000	0.00000
56	92691004	Carcinoma in situ of prostate (disorder)	55	126906006	Neoplasm of prostate	1095	23	24	23	0	1	1071	45.62500	0.97849	0.00000	0.00000	0.00000	0.0000000000	0.0000000000	0.50411	3.99605	0	0	0	23	24	23	-0.71465	-0.69315
54	5602001	Opioid abuse (disorder)	55	126906006	Neoplasm of prostate	1095	7	24	3	4	21	1067	19.55357	0.22278	38.10714	180.98390	8.02367	0.0003063020	0.0092395839	0.15342	1.79408	0	0	0	7	24	3	-2.19722	-1.20397
53	7200002	Alcoholism	55	126906006	Neoplasm of prostate	1095	5	24	4	1	20	1070	36.50000	0.35992	214.00000	2001.16465	22.88467	0.0000008787	0.0000441265	0.10959	2.17190	0	0	0	5	24	4	-1.94591	-0.81093
52	124171000119105	Chronic intractable migraine without aura	55	126906006	Neoplasm of prostate	1095	51	24	5	46	19	1025	4.47304	0.11491	5.86384	16.39977	2.09666	0.0038981763	0.0739053810	1.11781	1.50239	21	0	0	30	24	5	-1.75786	-1.94591
50	446096008	Perennial allergic rhinitis	55	126906006	Neoplasm of prostate	1095	26	24	0	26	24	1045	0.00000	-0.02335	0.00000	0.00000	0.00000	1.0000000000	1.0000000000	0.56986	-0.65064	14	0	0	12	24	0	0.00000	0.00000
49	88805009	Chronic congestive heart failure (disorder)	55	126906006	Neoplasm of prostate	1095	10	24	0	10	24	1061	0.00000	-0.01437	0.00000	0.00000	0.00000	1.0000000000	1.0000000000	0.21918	-0.28591	5	0	0	5	24	0	0.00000	0.00000
47	359817006	Closed fracture of hip	55	126906006	Neoplasm of prostate	1095	29	24	0	29	24	1042	0.00000	-0.02469	0.00000	0.00000	0.00000	1.0000000000	1.0000000000	0.63562	-0.70983	11	0	0	18	24	0	0.00000	0.00000
46	62564004	Concussion with loss of consciousness	55	126906006	Neoplasm of prostate	1095	67	24	0	67	24	1004	0.00000	-0.03822	0.00000	0.00000	0.00000	0.3933740841	1.0000000000	1.46849	-1.30363	36	0	0	31	24	0	0.00000	0.00000
45	263102004	Fracture subluxation of wrist	55	126906006	Neoplasm of prostate	1095	109	24	4	105	20	966	1.67431	0.03356	1.84000	5.48497	0.61725	0.2886926094	0.9714931084	2.38904	0.56105	51	0	0	58	24	4	-1.94591	-2.74084
44	58150001	Fracture of clavicle	55	126906006	Neoplasm of prostate	1095	112	24	4	108	20	963	1.62946	0.03181	1.78333	5.31361	0.59852	0.2974674326	0.9848726602	2.45479	0.53333	55	0	0	57	24	4	-1.94591	-2.72458
43	307731004	Injury of tendon of the rotator cuff of shoulder	55	126906006	Neoplasm of prostate	1095	51	24	1	50	23	1021	0.89461	-0.00349	0.88783	6.70711	0.11752	1.0000000000	1.0000000000	1.11781	-0.08257	26	0	0	25	24	1	-3.21888	-3.25810
42	16114001	Fracture of ankle	55	126906006	Neoplasm of prostate	1095	108	24	2	106	22	965	0.84491	-0.00768	0.82762	3.56852	0.19194	1.0000000000	1.0000000000	2.36712	-0.16655	48	0	0	60	24	2	-2.56495	-3.43399
41	283385000	Laceration of thigh	55	126906006	Neoplasm of prostate	1095	105	24	2	103	22	968	0.86905	-0.00638	0.85437	3.68519	0.19808	1.0000000000	1.0000000000	2.30137	-0.13810	50	0	0	55	24	2	-2.56495	-3.34990
40	428251008	History of appendectomy	55	126906006	Neoplasm of prostate	1095	51	24	1	50	23	1021	0.89461	-0.00349	0.88783	6.70711	0.11752	1.0000000000	1.0000000000	1.11781	-0.08257	27	0	0	24	24	1	-3.21888	-3.21888
39	74400008	Appendicitis	55	126906006	Neoplasm of prostate	1095	51	24	1	50	23	1021	0.89461	-0.00349	0.88783	6.70711	0.11752	1.0000000000	1.0000000000	1.11781	-0.08257	27	0	0	24	24	1	-3.21888	-3.21888
38	398254007	Preeclampsia	55	126906006	Neoplasm of prostate	1095	101	24	0	101	24	970	0.00000	-0.04772	0.00000	0.00000	0.00000	0.1578219138	0.7763448205	2.21370	-1.68423	101	0	0	0	24	0	0.00000	0.00000
37	38822007	Cystitis	55	126906006	Neoplasm of prostate	1095	71	24	0	71	24	1000	0.00000	-0.03942	0.00000	0.00000	0.00000	0.3964936379	1.0000000000	1.55616	-1.35398	68	0	0	3	24	0	0.00000	0.00000
35	19169002	Miscarriage in first trimester	55	126906006	Neoplasm of prostate	1095	174	24	0	174	24	897	0.00000	-0.06507	0.00000	0.00000	0.00000	0.0228941544	0.2737941248	3.81370	-2.26715	174	0	0	0	24	0	0.00000	0.00000
33	429007001	History of cardiac arrest (situation)	55	126906006	Neoplasm of prostate	1095	42	24	1	41	23	1030	1.08631	0.00258	1.09226	8.28588	0.14398	0.6128216151	1.0000000000	0.92055	0.05848	24	0	0	18	24	1	-3.21888	-2.94444
32	410429000	Cardiac Arrest	55	126906006	Neoplasm of prostate	1095	42	24	1	41	23	1030	1.08631	0.00258	1.09226	8.28588	0.14398	0.6128216151	1.0000000000	0.92055	0.05848	24	0	0	18	24	1	-3.21888	-2.94444
31	230690007	Stroke	55	126906006	Neoplasm of prostate	1095	62	24	9	53	15	1018	6.62298	0.20622	11.52453	27.54409	4.82190	0.0000022370	0.0001078912	1.35890	2.08381	32	0	0	30	24	9	-1.29928	-1.46634
30	399211009	History of myocardial infarction (situation)	55	126906006	Neoplasm of prostate	1095	31	24	1	30	23	1041	1.47177	0.01205	1.50870	11.54209	0.19721	0.5017769494	1.0000000000	0.67945	0.25201	2	0	0	29	24	1	-3.21888	-3.40120
29	22298006	Myocardial Infarction	55	126906006	Neoplasm of prostate	1095	31	24	1	30	23	1041	1.47177	0.01205	1.50870	11.54209	0.19721	0.5017769494	1.0000000000	0.67945	0.25201	2	0	0	29	24	1	-3.21888	-3.40120
28	53741008	Coronary Heart Disease	55	126906006	Neoplasm of prostate	1095	80	24	5	75	19	996	2.85156	0.07781	3.49474	9.62105	1.26942	0.0258978611	0.2928186163	1.75342	1.12374	24	0	0	56	24	5	-1.75786	-2.50144
27	408512008	Body mass index 40+ - severely obese (finding)	55	126906006	Neoplasm of prostate	1095	97	24	1	96	23	975	0.47036	-0.02472	0.44158	3.30575	0.05898	0.7156259919	1.0000000000	2.12603	-0.64433	67	0	0	30	24	1	-3.21888	-3.43399
26	33737001	Fracture of rib	55	126906006	Neoplasm of prostate	1095	54	24	1	53	23	1018	0.84491	-0.00529	0.83511	6.30210	0.11066	1.0000000000	1.0000000000	1.18356	-0.12668	32	0	0	22	24	1	-3.21888	-3.13549
25	284551006	Laceration of foot	55	126906006	Neoplasm of prostate	1095	118	24	6	112	18	959	2.31992	0.06867	2.85417	7.33912	1.10998	0.0364535020	0.3590974313	2.58630	0.96486	53	0	0	65	24	6	-1.60944	-2.47092
24	162864005	Body mass index 30+ - obesity (finding)	55	126906006	Neoplasm of prostate	1095	439	24	13	426	11	645	1.35108	0.04299	1.78937	4.03127	0.79425	0.2055033633	0.8544076578	9.62192	0.39838	226	0	0	213	24	13	-1.04597	-2.85559
23	36971009	Sinusitis (disorder)	55	126906006	Neoplasm of prostate	1095	190	24	8	182	16	889	1.92105	0.06318	2.44231	5.79204	1.02984	0.0518098514	0.4398325680	4.16438	0.80133	84	0	0	106	24	8	-1.38629	-2.65676
22	70704007	Sprain of wrist	55	126906006	Neoplasm of prostate	1095	195	24	7	188	17	883	1.63782	0.04444	1.93398	4.72915	0.79090	0.1719887901	0.7978675799	4.27397	0.60111	90	0	0	105	24	7	-1.48808	-2.77259
21	15777000	Prediabetes	55	126906006	Neoplasm of prostate	1095	333	24	16	317	8	754	2.19219	0.11798	4.75710	11.22798	2.01550	0.0003788836	0.0110861350	7.29863	1.03459	159	0	0	174	24	16	-0.91629	-2.47444
20	80394007	Hyperglycemia (disorder)	55	126906006	Neoplasm of prostate	1095	55	24	5	50	19	1021	4.14773	0.10836	5.37368	14.98021	1.92764	0.0054398508	0.0962721977	1.20548	1.44387	23	0	0	32	24	5	-1.75786	-2.00148
19	237602007	Metabolic syndrome X (disorder)	55	126906006	Neoplasm of prostate	1095	64	24	5	59	19	1012	3.56445	0.09565	4.51383	12.51147	1.62848	0.0104284205	0.1590125021	1.40274	1.32028	28	0	0	36	24	5	-1.75786	-2.10413
18	302870006	Hypertriglyceridemia (disorder)	55	126906006	Neoplasm of prostate	1095	64	24	5	59	19	1012	3.56445	0.09565	4.51383	12.51147	1.62848	0.0104284205	0.1590125021	1.40274	1.32028	28	0	0	36	24	5	-1.75786	-2.10413
17	368581000119106	Neuropathy due to type 2 diabetes mellitus (disorder)	55	126906006	Neoplasm of prostate	1095	28	24	2	26	22	1045	3.25893	0.05478	3.65385	16.35778	0.81616	0.1231827679	0.6913144812	0.61370	0.89459	7	0	0	21	24	2	-2.56495	-2.44235
129	47505003	Posttraumatic stress disorder	29	22298006	Myocardial Infarction	1095	4	31	0	4	31	1060	0.00000	-0.01034	0.00000	0.00000	0.00000	1.0000000000	1.0000000000	0.11324	-0.15477	1	2	0	3	29	0	0.00000	0.00000
15	40055000	Chronic sinusitis (disorder)	55	126906006	Neoplasm of prostate	1095	216	24	12	204	12	867	2.53472	0.11389	4.25000	9.59726	1.88205	0.0007438317	0.0195453746	4.73425	1.18084	104	0	0	112	24	12	-1.09861	-2.33537
14	10509002	Acute bronchitis (disorder)	55	126906006	Neoplasm of prostate	1095	863	24	22	841	2	230	1.16309	0.04709	3.00832	12.88730	0.70224	0.1364392710	0.7293933742	18.91507	0.20777	418	0	0	445	24	22	-0.73760	-3.05529
13	370247008	Facial laceration	55	126906006	Neoplasm of prostate	1095	109	24	4	105	20	966	1.67431	0.03356	1.84000	5.48497	0.61725	0.2886926094	0.9714931084	2.38904	0.56105	55	0	0	54	24	4	-1.94591	-2.67415
12	65966004	Fracture of forearm	55	126906006	Neoplasm of prostate	1095	123	24	2	121	22	950	0.74187	-0.01375	0.71375	3.07289	0.16578	1.0000000000	1.0000000000	2.69589	-0.30096	55	0	0	68	24	2	-2.56495	-3.55535
11	38341003	Hypertension	55	126906006	Neoplasm of prostate	1095	278	24	12	266	12	805	1.96942	0.08465	3.02632	6.81698	1.34350	0.0083823737	0.1352582287	6.09315	0.87401	131	0	0	147	24	12	-1.09861	-2.58400
10	62106007	Concussion with no loss of consciousness	55	126906006	Neoplasm of prostate	1095	206	24	2	204	22	867	0.44296	-0.04014	0.38636	1.65627	0.09013	0.2882139184	0.9712041902	4.51507	-0.87842	96	0	0	110	24	2	-2.56495	-4.02535
9	44465007	Sprain of ankle	55	126906006	Neoplasm of prostate	1095	362	24	8	354	16	717	1.00829	0.00087	1.01271	2.38887	0.42932	1.0000000000	1.0000000000	7.93425	0.01058	185	0	0	177	24	8	-1.38629	-3.14091
8	233678006	Childhood asthma	55	126906006	Neoplasm of prostate	1095	45	24	0	45	24	1026	0.00000	-0.03099	0.00000	0.00000	0.00000	0.6200761813	1.0000000000	0.98630	-0.99008	25	0	0	20	24	0	0.00000	0.00000
7	75498004	Acute bacterial sinusitis (disorder)	55	126906006	Neoplasm of prostate	1095	187	24	7	180	17	891	1.70789	0.04809	2.03824	4.98651	0.83313	0.1630551580	0.7879650300	4.09863	0.64989	89	0	0	98	24	7	-1.48808	-2.70805
6	39848009	Whiplash injury to neck	55	126906006	Neoplasm of prostate	1095	182	24	4	178	20	893	1.00275	0.00018	1.00337	2.97092	0.33887	1.0000000000	1.0000000000	3.98904	0.00317	92	0	0	90	24	4	-1.94591	-3.15700
5	284549007	Laceration of hand	55	126906006	Neoplasm of prostate	1095	104	24	4	100	20	971	1.75481	0.03660	1.94200	5.79382	0.65093	0.2757120664	0.9505356881	2.27945	0.60847	54	0	0	50	24	4	-1.94591	-2.60269
4	195662009	Acute viral pharyngitis (disorder)	55	126906006	Neoplasm of prostate	1095	890	24	23	867	1	204	1.17907	0.05585	5.41176	40.30587	0.72662	0.0665177157	0.5048217971	19.50685	0.22693	430	0	0	460	24	23	-0.71465	-3.04452
3	65363002	Otitis media	55	126906006	Neoplasm of prostate	1095	580	24	5	575	19	496	0.39332	-0.09638	0.22700	0.61240	0.08414	0.0015487788	0.0346815819	12.71233	-1.19244	277	0	0	303	24	5	-1.75786	-4.12066
115	36923009	Major depression  single episode	29	22298006	Myocardial Infarction	1095	6	31	1	5	30	1059	5.88710	0.06192	7.06000	62.29801	0.80008	0.1586220457	0.7768414475	0.16986	0.77366	3	2	0	3	29	1	-3.40120	-1.38629
1	444814009	Viral sinusitis (disorder)	55	126906006	Neoplasm of prostate	1095	993	24	24	969	0	102	1.10272	0.04798	0.00000	0.00000	0.00000	0.1577529500	0.7763448205	21.76438	0.13515	478	0	0	515	24	24	-0.69315	-3.11166
118	48333001	Burn injury(morphologic abnormality)	47	359817006	Closed fracture of hip	1095	1	29	0	1	29	1065	0.00000	-0.00499	0.00000	0.00000	0.00000	1.0000000000	1.0000000000	0.02648	-0.03771	0	11	0	1	18	0	0.00000	0.00000
111	235919008	Cholelithiasis	29	22298006	Myocardial Infarction	1095	9	31	0	9	31	1055	0.00000	-0.01554	0.00000	0.00000	0.00000	1.0000000000	1.0000000000	0.25479	-0.32745	7	2	0	2	29	0	0.00000	0.00000
109	90560007	Gout	29	22298006	Myocardial Infarction	1095	4	31	0	4	31	1060	0.00000	-0.01034	0.00000	0.00000	0.00000	1.0000000000	1.0000000000	0.11324	-0.15477	0	2	0	4	29	0	0.00000	0.00000
107	40275004	Contact dermatitis	29	22298006	Myocardial Infarction	1095	18	31	2	16	29	1048	3.92473	0.06454	4.51724	20.56257	0.99236	0.0895917834	0.5935371128	0.50959	0.99081	9	2	0	9	29	2	-2.74084	-1.70475
106	24079001	Atopic dermatitis	29	22298006	Myocardial Infarction	1095	20	31	0	20	31	1044	0.00000	-0.02328	0.00000	0.00000	0.00000	1.0000000000	1.0000000000	0.56621	-0.64728	13	2	0	7	29	0	0.00000	0.00000
102	90781000119102	Microalbuminuria due to type 2 diabetes mellitus (disorder)	29	22298006	Myocardial Infarction	1095	6	31	0	6	31	1058	0.00000	-0.01267	0.00000	0.00000	0.00000	1.0000000000	1.0000000000	0.16986	-0.22634	3	2	0	3	29	0	0.00000	0.00000
98	1551000119108	Nonproliferative diabetic retinopathy due to type 2 diabetes mellitus (disorder)	29	22298006	Myocardial Infarction	1095	12	31	0	12	31	1052	0.00000	-0.01797	0.00000	0.00000	0.00000	1.0000000000	1.0000000000	0.33973	-0.42194	7	2	0	5	29	0	0.00000	0.00000
97	403192003	Third degree burn	29	22298006	Myocardial Infarction	1095	8	31	0	8	31	1056	0.00000	-0.01464	0.00000	0.00000	0.00000	1.0000000000	1.0000000000	0.22648	-0.29453	3	2	0	5	29	0	0.00000	0.00000
96	283371005	Laceration of forearm	29	22298006	Myocardial Infarction	1095	75	31	4	71	27	993	1.88387	0.04091	2.07199	6.08501	0.70553	0.1570134909	0.7751768407	2.12329	0.67886	39	2	1	36	29	3	-1.26851	1.12393
94	703151001	History of single seizure (situation)	29	22298006	Myocardial Infarction	1095	39	31	1	38	30	1026	0.90571	-0.00309	0.90000	6.77434	0.11957	1.0000000000	1.0000000000	1.10411	-0.07321	14	2	0	25	29	1	-3.40120	-3.25810
93	128613002	Seizure disorder	29	22298006	Myocardial Infarction	1095	39	31	1	38	30	1026	0.90571	-0.00309	0.90000	6.77434	0.11957	1.0000000000	1.0000000000	1.10411	-0.07321	14	2	0	25	29	1	-3.40120	-3.25810
89	47693006	Rupture of appendix	29	22298006	Myocardial Infarction	1095	20	31	0	20	31	1044	0.00000	-0.02328	0.00000	0.00000	0.00000	1.0000000000	1.0000000000	0.56621	-0.64728	10	2	0	10	29	0	0.00000	0.00000
86	713197008	Recurrent rectal polyp	29	22298006	Myocardial Infarction	1095	22	31	0	22	31	1042	0.00000	-0.02444	0.00000	0.00000	0.00000	1.0000000000	1.0000000000	0.62283	-0.69851	12	2	0	10	29	0	0.00000	0.00000
82	94260004	Secondary malignant neoplasm of colon	29	22298006	Myocardial Infarction	1095	4	31	0	4	31	1060	0.00000	-0.01034	0.00000	0.00000	0.00000	1.0000000000	1.0000000000	0.11324	-0.15477	2	2	0	2	29	0	0.00000	0.00000
78	239872002	Osteoarthritis of hip	29	22298006	Myocardial Infarction	1095	21	31	2	19	29	1045	3.36406	0.05643	3.79310	17.05086	0.84381	0.1167390052	0.6772868389	0.59452	0.91184	13	2	0	8	29	2	-2.74084	-1.60944
76	127013003	Diabetic renal disease (disorder)	29	22298006	Myocardial Infarction	1095	28	31	0	28	31	1036	0.00000	-0.02765	0.00000	0.00000	0.00000	1.0000000000	1.0000000000	0.79269	-0.84213	10	2	0	18	29	0	0.00000	0.00000
75	431855005	Chronic kidney disease stage 1 (disorder)	29	22298006	Myocardial Infarction	1095	28	31	0	28	31	1036	0.00000	-0.02765	0.00000	0.00000	0.00000	1.0000000000	1.0000000000	0.79269	-0.84213	10	2	0	18	29	0	0.00000	0.00000
72	35999006	Blighted ovum	29	22298006	Myocardial Infarction	1095	53	31	0	53	31	1011	0.00000	-0.03850	0.00000	0.00000	0.00000	0.3961538006	1.0000000000	1.50046	-1.32219	53	2	0	0	29	0	0.00000	0.00000
71	201834006	Localized  primary osteoarthritis of the hand	29	22298006	Myocardial Infarction	1095	28	31	0	28	31	1036	0.00000	-0.02765	0.00000	0.00000	0.00000	1.0000000000	1.0000000000	0.79269	-0.84213	19	2	0	9	29	0	0.00000	0.00000
69	233604007	Pneumonia	29	22298006	Myocardial Infarction	1095	7	31	0	7	31	1057	0.00000	-0.01369	0.00000	0.00000	0.00000	1.0000000000	1.0000000000	0.19817	-0.26084	3	2	0	4	29	0	0.00000	0.00000
67	403191005	Second degree burn	29	22298006	Myocardial Infarction	1095	49	31	3	46	28	1018	2.16261	0.04295	2.37112	8.08599	0.69530	0.1576381908	0.7763448205	1.38721	0.74467	23	2	0	26	29	3	-2.36712	-2.26868
64	444448004	Injury of medial collateral ligament of knee	29	22298006	Myocardial Infarction	1095	32	31	0	32	31	1032	0.00000	-0.02962	0.00000	0.00000	0.00000	1.0000000000	1.0000000000	0.90594	-0.93050	17	2	0	15	29	0	0.00000	0.00000
63	68496003	Polyp of colon	29	22298006	Myocardial Infarction	1095	91	31	3	88	28	976	1.16448	0.00845	1.18831	3.98692	0.35418	0.7381617939	1.0000000000	2.57626	0.16155	43	2	0	48	29	3	-2.36712	-2.83321
59	262574004	Bullet wound	29	22298006	Myocardial Infarction	1095	20	31	1	19	30	1045	1.76613	0.01784	1.83333	14.14710	0.23758	0.4398197230	1.0000000000	0.56621	0.35272	9	2	0	11	29	1	-3.40120	-2.48491
58	239720000	Tear of meniscus of knee	29	22298006	Myocardial Infarction	1095	20	31	0	20	31	1044	0.00000	-0.02328	0.00000	0.00000	0.00000	1.0000000000	1.0000000000	0.56621	-0.64728	10	2	0	10	29	0	0.00000	0.00000
57	192127007	Child attention deficit disorder	29	22298006	Myocardial Infarction	1095	76	31	6	70	25	994	2.78862	0.08338	3.40800	8.58069	1.35356	0.0166908951	0.2196591865	2.15160	1.15127	24	2	0	52	29	6	-1.76359	-2.26868
56	92691004	Carcinoma in situ of prostate (disorder)	29	22298006	Myocardial Infarction	1095	23	31	1	22	30	1042	1.53576	0.01340	1.57879	12.10086	0.20598	0.4869403360	1.0000000000	0.65114	0.27654	0	2	0	23	29	1	-3.40120	-3.17805
54	5602001	Opioid abuse (disorder)	29	22298006	Myocardial Infarction	1095	7	31	0	7	31	1057	0.00000	-0.01369	0.00000	0.00000	0.00000	1.0000000000	1.0000000000	0.19817	-0.26084	0	2	0	7	29	0	0.00000	0.00000
52	124171000119105	Chronic intractable migraine without aura	29	22298006	Myocardial Infarction	1095	51	31	0	51	31	1013	0.00000	-0.03773	0.00000	0.00000	0.00000	0.3948460482	1.0000000000	1.44384	-1.28915	21	2	0	30	29	0	0.00000	0.00000
50	446096008	Perennial allergic rhinitis	29	22298006	Myocardial Infarction	1095	26	31	0	26	31	1038	0.00000	-0.02662	0.00000	0.00000	0.00000	1.0000000000	1.0000000000	0.73607	-0.79583	14	2	0	12	29	0	0.00000	0.00000
49	88805009	Chronic congestive heart failure (disorder)	29	22298006	Myocardial Infarction	1095	10	31	0	10	31	1054	0.00000	-0.01639	0.00000	0.00000	0.00000	1.0000000000	1.0000000000	0.28311	-0.35964	5	2	0	5	29	0	0.00000	0.00000
47	359817006	Closed fracture of hip	29	22298006	Myocardial Infarction	1095	29	31	1	28	30	1036	1.21802	0.00614	1.23333	9.36648	0.16240	0.5699470383	1.0000000000	0.82100	0.13527	11	2	0	18	29	1	-3.40120	-2.94444
45	263102004	Fracture subluxation of wrist	29	22298006	Myocardial Infarction	1095	109	31	2	107	29	957	0.64812	-0.01997	0.61682	2.62108	0.14516	0.7613405663	1.0000000000	3.08584	-0.44567	51	2	0	58	29	2	-2.74084	-3.40120
44	58150001	Fracture of clavicle	29	22298006	Myocardial Infarction	1095	112	31	1	111	30	953	0.31538	-0.03944	0.28619	2.11896	0.03865	0.3592873418	1.0000000000	3.17078	-1.06032	55	2	0	57	29	1	-3.40120	-4.06044
43	307731004	Injury of tendon of the rotator cuff of shoulder	29	22298006	Myocardial Infarction	1095	51	31	1	50	30	1014	0.69260	-0.01160	0.67600	5.05780	0.09035	1.0000000000	1.0000000000	1.44384	-0.28915	26	2	0	25	29	1	-3.40120	-3.25810
42	16114001	Fracture of ankle	29	22298006	Myocardial Infarction	1095	108	31	2	106	29	958	0.65412	-0.01953	0.62329	2.64888	0.14666	0.7611328001	1.0000000000	3.05753	-0.43564	48	2	0	60	29	2	-2.74084	-3.43399
41	283385000	Laceration of thigh	29	22298006	Myocardial Infarction	1095	105	31	2	103	29	961	0.67281	-0.01819	0.64345	2.73555	0.15135	0.7609318498	1.0000000000	2.97260	-0.40512	50	2	0	55	29	2	-2.74084	-3.34990
39	74400008	Appendicitis	29	22298006	Myocardial Infarction	1095	51	31	0	51	31	1013	0.00000	-0.03773	0.00000	0.00000	0.00000	0.3948460482	1.0000000000	1.44384	-1.28915	27	2	0	24	29	0	0.00000	0.00000
38	398254007	Preeclampsia	29	22298006	Myocardial Infarction	1095	101	31	1	100	30	964	0.34973	-0.03538	0.32133	2.38143	0.04336	0.3520950881	1.0000000000	2.85936	-0.94836	101	2	1	0	29	0	1.09861	4.62497
35	19169002	Miscarriage in first trimester	29	22298006	Myocardial Infarction	1095	174	31	2	172	29	892	0.40601	-0.04407	0.35766	1.51284	0.08456	0.2102870816	0.8633769890	4.92603	-0.98210	174	2	2	0	29	0	0.69315	4.47734
33	429007001	History of cardiac arrest (situation)	29	22298006	Myocardial Infarction	1095	42	31	0	42	31	1022	0.00000	-0.03409	0.00000	0.00000	0.00000	0.6278836387	1.0000000000	1.18904	-1.13030	24	2	0	18	29	0	0.00000	0.00000
32	410429000	Cardiac Arrest	29	22298006	Myocardial Infarction	1095	42	31	0	42	31	1022	0.00000	-0.03409	0.00000	0.00000	0.00000	0.6278836387	1.0000000000	1.18904	-1.13030	24	2	0	18	29	0	0.00000	0.00000
30	399211009	History of myocardial infarction (situation)	29	22298006	Myocardial Infarction	1095	31	31	31	0	0	1064	35.32258	1.00000	0.00000	0.00000	0.00000	0.0000000000	0.0000000000	0.87763	4.09109	2	2	2	29	29	29	0.00000	0.00000
27	408512008	Body mass index 40+ - severely obese (finding)	29	22298006	Myocardial Infarction	1095	97	31	1	96	30	968	0.36415	-0.03384	0.33611	2.49193	0.04533	0.5141181051	1.0000000000	2.74612	-0.90540	67	2	0	30	29	1	-3.40120	-3.43399
24	162864005	Body mass index 30+ - obesity (finding)	29	22298006	Myocardial Infarction	1095	439	31	13	426	18	638	1.04600	0.00642	1.08164	2.23071	0.52447	0.8539488105	1.0000000000	12.42831	0.06015	226	2	2	213	29	11	-0.59784	1.72245
23	36971009	Sinusitis (disorder)	29	22298006	Myocardial Infarction	1095	190	31	9	181	22	883	1.67317	0.05265	1.99573	4.40550	0.90408	0.0917743622	0.5998476181	5.37900	0.64860	84	2	0	106	29	9	-1.44036	-2.54771
21	15777000	Prediabetes	29	22298006	Myocardial Infarction	1095	333	31	15	318	16	746	1.59111	0.06670	2.19929	4.50266	1.07423	0.0452311682	0.4084765375	9.42740	0.61769	159	2	1	174	29	14	-0.02353	2.47779
20	80394007	Hyperglycemia (disorder)	29	22298006	Myocardial Infarction	1095	55	31	1	54	30	1010	0.64223	-0.01404	0.62346	4.65810	0.08345	1.0000000000	1.0000000000	1.55708	-0.35450	23	2	0	32	29	1	-3.40120	-3.49651
19	237602007	Metabolic syndrome X (disorder)	29	22298006	Myocardial Infarction	1095	64	31	1	63	30	1001	0.55192	-0.01906	0.52963	3.94712	0.07107	1.0000000000	1.0000000000	1.81187	-0.49153	28	2	0	36	29	1	-3.40120	-3.61092
18	302870006	Hypertriglyceridemia (disorder)	29	22298006	Myocardial Infarction	1095	64	31	1	63	30	1001	0.55192	-0.01906	0.52963	3.94712	0.07107	1.0000000000	1.0000000000	1.81187	-0.49153	28	2	0	36	29	1	-3.40120	-3.61092
17	368581000119106	Neuropathy due to type 2 diabetes mellitus (disorder)	29	22298006	Myocardial Infarction	1095	28	31	1	27	30	1037	1.26152	0.00723	1.28025	9.73495	0.16837	0.5570786582	1.0000000000	0.79269	0.15787	7	2	0	21	29	1	-3.40120	-3.09104
129	47505003	Posttraumatic stress disorder	3	65363002	Otitis media	1095	4	580	2	2	578	513	0.94397	-0.00360	0.88754	6.32349	0.12457	1.0000000000	1.0000000000	2.11872	-0.05599	1	277	0	3	303	2	-5.02716	-0.91629
15	40055000	Chronic sinusitis (disorder)	29	22298006	Myocardial Infarction	1095	216	31	11	205	20	859	1.79884	0.06759	2.30463	4.88544	1.08718	0.0366857865	0.3598076353	6.11507	0.75408	104	2	1	112	29	10	-0.26236	2.15252
14	10509002	Acute bronchitis (disorder)	29	22298006	Myocardial Infarction	1095	863	31	26	837	5	227	1.06418	0.02113	1.41027	3.71381	0.53553	0.6560085655	1.0000000000	24.43196	0.08632	418	2	1	445	29	25	0.32850	3.10401
13	370247008	Facial laceration	29	22298006	Myocardial Infarction	1095	109	31	1	108	30	956	0.32406	-0.03836	0.29506	2.18519	0.03984	0.3556378871	1.0000000000	3.08584	-1.03063	55	2	0	54	29	1	-3.40120	-4.00733
125	1734006	Fracture of the vertebral column with spinal cord injury	3	65363002	Otitis media	1095	5	580	0	5	580	510	0.00000	-0.07188	0.00000	0.00000	0.00000	0.0227761116	0.2727540350	2.64840	-1.86726	3	277	0	2	303	0	0.00000	0.00000
124	1501000119109	Proliferative diabetic retinopathy due to type II diabetes mellitus (disorder)	3	65363002	Otitis media	1095	1	580	0	1	580	514	0.00000	-0.03208	0.00000	0.00000	0.00000	0.4703196347	1.0000000000	0.52968	-0.61323	1	277	0	0	303	0	0.00000	0.00000
10	62106007	Concussion with no loss of consciousness	29	22298006	Myocardial Infarction	1095	206	31	9	197	22	867	1.54322	0.04463	1.80042	3.97022	0.81645	0.1594953564	0.7786708778	5.83196	0.54963	96	2	0	110	29	9	-1.44036	-2.58190
121	254637007	Non-small cell lung cancer (disorder)	3	65363002	Otitis media	1095	8	580	3	5	577	510	0.70797	-0.02659	0.53033	2.23010	0.12611	0.4859122459	1.0000000000	4.23744	-0.38886	0	277	0	8	303	3	-4.62497	-1.29928
7	75498004	Acute bacterial sinusitis (disorder)	29	22298006	Myocardial Infarction	1095	187	31	10	177	21	887	1.88891	0.06886	2.38633	5.15462	1.10475	0.0298744272	0.3180139089	5.29406	0.80544	89	2	2	98	29	8	-0.83833	1.23371
6	39848009	Whiplash injury to neck	29	22298006	Myocardial Infarction	1095	182	31	4	178	27	886	0.77632	-0.01705	0.73741	2.13342	0.25488	0.8063456354	1.0000000000	5.15251	-0.29925	92	2	0	90	29	4	-2.11021	-3.15700
5	284549007	Laceration of hand	29	22298006	Myocardial Infarction	1095	104	31	4	100	27	964	1.35856	0.01983	1.42815	4.16387	0.48983	0.5275945651	1.0000000000	2.94429	0.34216	54	2	0	50	29	4	-2.11021	-2.60269
117	230265002	Familial Alzheimer's disease of early onset (disorder)	3	65363002	Otitis media	1095	6	580	0	6	580	509	0.00000	-0.07877	0.00000	0.00000	0.00000	0.0106567128	0.1610062387	3.17808	-2.06284	2	277	0	4	303	0	0.00000	0.00000
115	36923009	Major depression  single episode	3	65363002	Otitis media	1095	6	580	4	2	576	513	1.25862	0.02037	1.78125	9.76555	0.32490	0.6899536561	1.0000000000	3.17808	0.25909	3	277	2	3	303	2	-0.08910	0.00000
1	444814009	Viral sinusitis (disorder)	29	22298006	Myocardial Infarction	1095	993	31	31	962	0	102	1.10272	0.05471	0.00000	0.00000	0.00000	0.1067725795	0.6424490271	28.11233	0.13644	478	2	2	515	29	29	0.00000	2.54899
112	49436004	Atrial Fibrillation	3	65363002	Otitis media	1095	35	580	6	29	574	486	0.32365	-0.13043	0.17518	0.42543	0.07213	0.0000164123	0.0006578408	18.53881	-1.48092	9	277	0	26	303	6	-3.94158	-1.67398
111	235919008	Cholelithiasis	3	65363002	Otitis media	1095	9	580	2	7	578	508	0.41954	-0.05608	0.25111	1.21425	0.05193	0.0921798762	0.6002633183	4.76712	-0.94289	7	277	2	2	303	0	4.93806	1.50408
110	65275009	Acute Cholecystitis	3	65363002	Otitis media	1095	9	580	2	7	578	508	0.41954	-0.05608	0.25111	1.21425	0.05193	0.0921798762	0.6002633183	4.76712	-0.94289	7	277	2	2	303	0	4.93806	1.50408
109	90560007	Gout	3	65363002	Otitis media	1095	4	580	2	2	578	513	0.94397	-0.00360	0.88754	6.32349	0.12457	1.0000000000	1.0000000000	2.11872	-0.05599	0	277	0	4	303	2	-5.02716	-1.09861
108	40930008	Hypothyroidism (disorder)	3	65363002	Otitis media	1095	13	580	2	11	578	504	0.29045	-0.08254	0.15854	0.71865	0.03498	0.0091596284	0.1448706631	6.88584	-1.39430	11	277	2	2	303	0	4.93806	1.87180
107	40275004	Contact dermatitis	3	65363002	Otitis media	1095	18	580	4	14	576	501	0.41954	-0.07964	0.24851	0.75985	0.08128	0.0148142401	0.2051094631	9.53425	-1.07509	9	277	3	9	303	1	-1.18085	-0.91629
106	24079001	Atopic dermatitis	3	65363002	Otitis media	1095	20	580	11	9	569	506	1.03836	0.00555	1.08690	2.64420	0.44677	1.0000000000	1.0000000000	10.59361	0.04970	13	277	7	7	303	4	-0.63749	0.03822
105	363406005	Malignant tumor of colon	3	65363002	Otitis media	1095	6	580	2	4	578	511	0.62931	-0.02920	0.44204	2.42346	0.08063	0.4284087139	1.0000000000	3.17808	-0.47788	4	277	1	2	303	1	-0.08941	0.51083
104	367498001	Seasonal allergic rhinitis	3	65363002	Otitis media	1095	20	580	10	10	570	505	0.94397	-0.00811	0.88596	2.14597	0.36577	0.8243111854	1.0000000000	10.59361	-0.07583	9	277	4	11	303	6	0.31048	0.13720
102	90781000119102	Microalbuminuria due to type 2 diabetes mellitus (disorder)	3	65363002	Otitis media	1095	6	580	4	2	576	513	1.25862	0.02037	1.78125	9.76555	0.32490	0.6899536561	1.0000000000	3.17808	0.25909	3	277	1	3	303	3	1.00265	0.69315
101	433144002	Chronic kidney disease stage 3 (disorder)	3	65363002	Otitis media	1095	3	580	2	1	578	514	1.25862	0.01439	1.77855	19.67197	0.16080	1.0000000000	1.0000000000	1.58904	0.21254	1	277	0	2	303	2	-5.02716	-0.69315
100	161622006	History of lower limb amputation (situation)	3	65363002	Otitis media	1095	1	580	1	0	579	515	1.88793	0.02849	0.00000	0.00000	0.00000	1.0000000000	1.0000000000	0.52968	0.38677	0	277	0	1	303	1	-5.71703	-0.69315
99	30832001	Rupture of patellar tendon	3	65363002	Otitis media	1095	23	580	15	8	565	507	1.23126	0.03595	1.68252	4.00162	0.70743	0.2927800838	0.9786512274	12.18265	0.27943	14	277	9	9	303	6	-0.48281	0.02198
98	1551000119108	Nonproliferative diabetic retinopathy due to type 2 diabetes mellitus (disorder)	3	65363002	Otitis media	1095	12	580	3	9	577	506	0.47198	-0.05898	0.29232	1.08564	0.07871	0.0777794766	0.5519212949	6.35616	-0.87895	7	277	2	5	303	1	-0.77896	-0.28768
97	403192003	Third degree burn	3	65363002	Otitis media	1095	8	580	3	5	577	510	0.70797	-0.02659	0.53033	2.23010	0.12611	0.4859122459	1.0000000000	4.23744	-0.38886	3	277	1	5	303	2	0.60046	0.13353
96	283371005	Laceration of forearm	3	65363002	Otitis media	1095	75	580	31	44	549	471	0.78034	-0.06321	0.60445	0.97273	0.37560	0.0414483976	0.3887115745	39.72603	-0.34788	39	277	15	36	303	16	-0.02390	0.10228
95	84757009	Epilepsy	3	65363002	Otitis media	1095	30	580	18	12	562	503	1.13276	0.02365	1.34253	2.81463	0.64036	0.4639701968	1.0000000000	15.89041	0.16979	13	277	6	17	303	12	0.58602	0.27029
94	703151001	History of single seizure (situation)	3	65363002	Otitis media	1095	39	580	24	15	556	500	1.16180	0.03300	1.43885	2.77364	0.74642	0.3279076319	1.0000000000	20.65753	0.20706	14	277	7	25	303	17	0.76796	0.19416
93	128613002	Seizure disorder	3	65363002	Otitis media	1095	39	580	24	15	556	500	1.16180	0.03300	1.43885	2.77364	0.74642	0.3279076319	1.0000000000	20.65753	0.20706	14	277	7	25	303	17	0.76796	0.19416
89	47693006	Rupture of appendix	3	65363002	Otitis media	1095	20	580	8	12	572	503	0.75517	-0.03544	0.58625	1.44567	0.23774	0.2651858096	0.9339825096	10.59361	-0.36533	10	277	6	10	303	2	-1.17348	-0.81093
86	713197008	Recurrent rectal polyp	3	65363002	Otitis media	1095	22	580	6	16	574	499	0.51489	-0.07372	0.32600	0.83950	0.12660	0.0171415151	0.2232466162	11.65297	-0.85405	12	277	2	10	303	4	0.59751	0.69315
85	241929008	Acute allergic reaction	3	65363002	Otitis media	1095	47	580	23	24	557	491	0.92388	-0.01711	0.84478	1.51582	0.47080	0.6546080767	1.0000000000	24.89498	-0.10964	25	277	13	22	303	10	-0.33869	-0.09051
83	110030002	Concussion injury of brain	3	65363002	Otitis media	1095	7	580	6	1	574	514	1.61823	0.05263	5.37282	44.77734	0.64468	0.1284293556	0.7042184342	3.70776	0.57231	1	277	1	6	303	5	1.50696	-0.09531
82	94260004	Secondary malignant neoplasm of colon	3	65363002	Otitis media	1095	4	580	0	4	580	511	0.00000	-0.06426	0.00000	0.00000	0.00000	0.0486276668	0.4234659321	2.11872	-1.64095	2	277	0	2	303	0	0.00000	0.00000
81	236077008	Protracted diarrhea	3	65363002	Otitis media	1095	4	580	0	4	580	511	0.00000	-0.06426	0.00000	0.00000	0.00000	0.0486276668	0.4234659321	2.11872	-1.64095	2	277	0	2	303	0	0.00000	0.00000
80	6072007	Bleeding from anus	3	65363002	Otitis media	1095	4	580	0	4	580	511	0.00000	-0.06426	0.00000	0.00000	0.00000	0.0486276668	0.4234659321	2.11872	-1.64095	2	277	0	2	303	0	0.00000	0.00000
79	45816000	Pyelonephritis	3	65363002	Otitis media	1095	1	580	0	1	580	514	0.00000	-0.03208	0.00000	0.00000	0.00000	0.4703196347	1.0000000000	0.52968	-0.61323	1	277	0	0	303	0	0.00000	0.00000
78	239872002	Osteoarthritis of hip	3	65363002	Otitis media	1095	21	580	6	15	574	500	0.53941	-0.06835	0.34843	0.90484	0.13417	0.0273306020	0.3044518076	11.12329	-0.79235	13	277	3	8	303	3	-0.08880	0.37469
76	127013003	Diabetic renal disease (disorder)	3	65363002	Otitis media	1095	28	580	10	18	570	497	0.67426	-0.05600	0.48441	1.05918	0.22154	0.0832260269	0.5700988979	14.83105	-0.52525	10	277	3	18	303	7	0.74552	0.19337
75	431855005	Chronic kidney disease stage 1 (disorder)	3	65363002	Otitis media	1095	28	580	10	18	570	497	0.67426	-0.05600	0.48441	1.05918	0.22154	0.0832260269	0.5700988979	14.83105	-0.52525	10	277	3	18	303	7	0.74552	0.19337
73	196416002	Impacted molars	3	65363002	Otitis media	1095	49	580	23	26	557	489	0.88617	-0.02615	0.77662	1.37883	0.43743	0.4644420000	1.0000000000	25.95434	-0.16748	25	277	12	24	303	11	-0.16998	-0.03144
72	35999006	Blighted ovum	3	65363002	Otitis media	1095	53	580	21	32	559	483	0.74805	-0.06030	0.56703	0.99640	0.32268	0.0490504214	0.4267240824	28.07306	-0.40218	53	277	21	0	303	0	2.65257	1.25954
71	201834006	Localized  primary osteoarthritis of the hand	3	65363002	Otitis media	1095	28	580	9	19	571	496	0.60683	-0.06759	0.41147	0.91773	0.18448	0.0335166157	0.3393412372	14.83105	-0.66276	19	277	6	9	303	3	-0.77129	0.04082
70	87433001	Pulmonary emphysema (disorder)	3	65363002	Otitis media	1095	17	580	6	11	574	504	0.66633	-0.04447	0.47894	1.30435	0.17586	0.1510304540	0.7644354026	9.00457	-0.51523	9	277	4	8	303	2	-0.77510	-0.43078
69	233604007	Pneumonia	3	65363002	Otitis media	1095	7	580	0	7	580	508	0.00000	-0.08512	0.00000	0.00000	0.00000	0.0049809612	0.0910893288	3.70776	-2.23504	3	277	0	4	303	0	0.00000	0.00000
68	26929004	Alzheimer's disease (disorder)	3	65363002	Otitis media	1095	23	580	3	20	577	495	0.24625	-0.11717	0.12868	0.43562	0.03801	0.0000802974	0.0028194017	12.18265	-1.72057	15	277	2	8	303	1	-0.77896	-0.05716
67	403191005	Second degree burn	3	65363002	Otitis media	1095	49	580	28	21	552	494	1.07882	0.01810	1.19324	2.12833	0.66898	0.5623044266	1.0000000000	25.95434	0.10554	23	277	12	26	303	16	0.18892	0.10536
65	239873007	Osteoarthritis of knee	3	65363002	Otitis media	1095	57	580	14	43	566	472	0.46370	-0.13337	0.27151	0.50237	0.14674	0.0000090252	0.0003864551	30.19178	-1.05620	30	277	7	27	303	7	-0.08760	0.08456
64	444448004	Injury of medial collateral ligament of knee	3	65363002	Otitis media	1095	32	580	16	16	564	499	0.94397	-0.01032	0.88475	1.78764	0.43789	0.8577117456	1.0000000000	16.94977	-0.07843	17	277	10	15	303	6	-0.58468	-0.25951
63	68496003	Polyp of colon	3	65363002	Otitis media	1095	91	580	18	73	562	442	0.37344	-0.20018	0.19393	0.32967	0.11407	0.0000000000	0.0000000017	48.20091	-1.37269	43	277	8	48	303	10	0.12943	0.09453
62	185086009	Chronic obstructive bronchitis (disorder)	3	65363002	Otitis media	1095	6	580	1	5	579	510	0.31466	-0.05399	0.17617	1.51286	0.02051	0.1051891019	0.6376726078	3.17808	-1.06284	4	277	1	2	303	0	5.62762	1.60944
59	262574004	Bullet wound	3	65363002	Otitis media	1095	20	580	9	11	571	504	0.84957	-0.02178	0.72218	1.75692	0.29685	0.5048725171	1.0000000000	10.59361	-0.21333	9	277	3	11	303	6	0.59460	0.34484
58	239720000	Tear of meniscus of knee	3	65363002	Otitis media	1095	20	580	9	11	571	504	0.84957	-0.02178	0.72218	1.75692	0.29685	0.5048725171	1.0000000000	10.59361	-0.21333	10	277	5	10	303	4	-0.30808	-0.15415
57	192127007	Child attention deficit disorder	3	65363002	Otitis media	1095	76	580	45	31	535	484	1.11785	0.03416	1.31323	2.10898	0.81774	0.2846294592	0.9659403678	40.25571	0.15704	24	277	16	52	303	29	0.46974	-0.11086
56	92691004	Carcinoma in situ of prostate (disorder)	3	65363002	Otitis media	1095	23	580	5	18	575	497	0.41042	-0.09165	0.24010	0.65138	0.08850	0.0026645276	0.0545203342	12.18265	-1.13561	0	277	0	23	303	5	-4.12066	-1.72277
54	5602001	Opioid abuse (disorder)	3	65363002	Otitis media	1095	7	580	4	3	576	512	1.07882	0.00671	1.18519	5.32054	0.26401	1.0000000000	1.0000000000	3.70776	0.08689	0	277	0	7	303	4	-4.34055	-1.01160
53	7200002	Alcoholism	3	65363002	Otitis media	1095	5	580	2	3	578	512	0.75517	-0.01760	0.59054	3.54817	0.09829	0.6706135333	1.0000000000	2.64840	-0.28230	0	277	0	5	303	2	-5.02716	-1.25276
52	124171000119105	Chronic intractable migraine without aura	3	65363002	Otitis media	1095	51	580	25	26	555	489	0.92546	-0.01748	0.84719	1.48658	0.48281	0.5693097007	1.0000000000	27.01370	-0.10762	21	277	10	30	303	15	0.30290	0.03279
50	446096008	Perennial allergic rhinitis	3	65363002	Otitis media	1095	26	580	16	10	564	505	1.16180	0.02678	1.43262	3.18569	0.64426	0.4301126672	1.0000000000	13.77169	0.20270	14	277	9	12	303	7	-0.33189	-0.06026
49	88805009	Chronic congestive heart failure (disorder)	3	65363002	Otitis media	1095	10	580	2	8	578	507	0.37759	-0.06341	0.21929	1.03740	0.04635	0.0528584566	0.4440110358	5.29680	-1.06966	5	277	1	5	303	1	-0.08941	0.00000
47	359817006	Closed fracture of hip	3	65363002	Otitis media	1095	29	580	16	13	564	502	1.04162	0.00728	1.09547	2.29984	0.52180	0.8524023474	1.0000000000	15.36073	0.05530	11	277	4	18	303	12	0.98439	0.40547
46	62564004	Concussion with loss of consciousness	3	65363002	Otitis media	1095	67	580	37	30	543	485	1.04259	0.01154	1.10160	1.81053	0.67025	0.8007650929	1.0000000000	35.48858	0.05855	36	277	24	31	303	13	-0.66174	-0.30295
45	263102004	Fracture subluxation of wrist	3	65363002	Otitis media	1095	109	580	57	52	523	463	0.98727	-0.00449	0.97040	1.44206	0.65301	0.9196023416	1.0000000000	57.73516	-0.01817	51	277	24	58	303	33	0.20845	0.12508
44	58150001	Fracture of clavicle	3	65363002	Otitis media	1095	112	580	60	52	520	463	1.01139	0.00408	1.02737	1.52028	0.69427	0.9206572786	1.0000000000	59.32420	0.01607	55	277	32	57	303	28	-0.20231	-0.11027
43	307731004	Injury of tendon of the rotator cuff of shoulder	3	65363002	Otitis media	1095	51	580	25	26	555	489	0.92546	-0.01748	0.84719	1.48658	0.48281	0.5693097007	1.0000000000	27.01370	-0.10762	26	277	15	25	303	10	-0.47491	-0.24724
42	16114001	Fracture of ankle	3	65363002	Otitis media	1095	108	580	50	58	530	457	0.87404	-0.04422	0.74333	1.10714	0.49907	0.1556196916	0.7747075658	57.20548	-0.19066	48	277	24	60	303	26	-0.00890	-0.09764
41	283385000	Laceration of thigh	3	65363002	Otitis media	1095	105	580	40	65	540	450	0.71921	-0.09704	0.51282	0.77525	0.33922	0.0014057202	0.0323021249	55.61644	-0.46560	50	277	21	55	303	19	-0.17754	-0.14147
40	428251008	History of appendectomy	3	65363002	Otitis media	1095	51	580	24	27	556	488	0.88844	-0.02617	0.78018	1.37012	0.44425	0.3931089545	1.0000000000	27.01370	-0.16420	27	277	14	24	303	10	-0.40935	-0.14926
39	74400008	Appendicitis	3	65363002	Otitis media	1095	51	580	24	27	556	488	0.88844	-0.02617	0.78018	1.37012	0.44425	0.3931089545	1.0000000000	27.01370	-0.16420	27	277	14	24	303	10	-0.40935	-0.14926
38	398254007	Preeclampsia	3	65363002	Otitis media	1095	101	580	48	53	532	462	0.89723	-0.03476	0.78649	1.18503	0.52199	0.2521666554	0.9133257124	53.49772	-0.15341	101	277	48	0	303	0	1.91262	1.13275
35	19169002	Miscarriage in first trimester	3	65363002	Otitis media	1095	174	580	67	107	513	408	0.72696	-0.12594	0.49801	0.69401	0.35736	0.0000328002	0.0012464081	92.16438	-0.45424	174	277	67	0	303	0	1.63595	1.28010
33	429007001	History of cardiac arrest (situation)	3	65363002	Otitis media	1095	42	580	16	26	564	489	0.71921	-0.05951	0.53355	1.00625	0.28291	0.0581840567	0.4685406893	22.24658	-0.45148	24	277	9	18	303	7	-0.33189	0.02632
32	410429000	Cardiac Arrest	3	65363002	Otitis media	1095	42	580	16	26	564	489	0.71921	-0.05951	0.53355	1.00625	0.28291	0.0581840567	0.4685406893	22.24658	-0.45148	24	277	9	18	303	7	-0.33189	0.02632
30	399211009	History of myocardial infarction (situation)	3	65363002	Otitis media	1095	31	580	15	16	565	499	0.91352	-0.01567	0.82799	1.69192	0.40520	0.7157471551	1.0000000000	16.42009	-0.12268	2	277	1	29	303	14	2.50778	-0.02353
29	22298006	Myocardial Infarction	3	65363002	Otitis media	1095	31	580	15	16	565	499	0.91352	-0.01567	0.82799	1.69192	0.40520	0.7157471551	1.0000000000	16.42009	-0.12268	2	277	1	29	303	14	2.50778	-0.02353
28	53741008	Coronary Heart Disease	3	65363002	Otitis media	1095	80	580	24	56	556	459	0.56638	-0.12919	0.35380	0.57977	0.21591	0.0000216542	0.0008448044	42.37443	-0.79492	24	277	5	56	303	19	1.20236	0.38481
27	408512008	Body mass index 40+ - severely obese (finding)	3	65363002	Otitis media	1095	97	580	39	58	541	457	0.75907	-0.07971	0.56801	0.86843	0.37152	0.0102859036	0.1582730098	51.37900	-0.38899	67	277	31	30	303	8	-1.36424	-0.40716
26	33737001	Fracture of rib	3	65363002	Otitis media	1095	54	580	21	33	559	482	0.73420	-0.06425	0.54871	0.96110	0.31327	0.0363094473	0.3585908408	28.60274	-0.42823	32	277	11	22	303	10	-0.17855	0.20015
24	162864005	Body mass index 30+ - obesity (finding)	3	65363002	Otitis media	1095	439	580	179	260	401	255	0.76979	-0.19985	0.43780	0.56032	0.34207	0.0000000000	0.0000000041	232.52968	-0.37561	226	277	90	213	303	89	-0.07707	0.03414
23	36971009	Sinusitis (disorder)	3	65363002	Otitis media	1095	190	580	81	109	499	406	0.80485	-0.09489	0.60462	0.82928	0.44082	0.0018114081	0.0395535819	100.63927	-0.30976	84	277	33	106	303	48	0.25048	0.09991
21	15777000	Prediabetes	3	65363002	Otitis media	1095	333	580	122	211	458	304	0.69167	-0.21630	0.38378	0.50070	0.29417	0.0000000000	0.0000000001	176.38356	-0.52821	159	277	56	174	303	66	0.06165	0.05430
20	80394007	Hyperglycemia (disorder)	3	65363002	Otitis media	1095	55	580	21	34	559	481	0.72085	-0.06813	0.53146	0.92807	0.30435	0.0266209715	0.2984404700	29.13242	-0.45381	23	277	8	32	303	13	0.38225	0.11283
19	237602007	Metabolic syndrome X (disorder)	3	65363002	Otitis media	1095	64	580	28	36	552	479	0.82597	-0.04601	0.67492	1.12259	0.40577	0.1553701117	0.7747075658	33.89954	-0.26716	28	277	12	36	303	16	0.18892	0.02532
18	302870006	Hypertriglyceridemia (disorder)	3	65363002	Otitis media	1095	64	580	28	36	552	479	0.82597	-0.04601	0.67492	1.12259	0.40577	0.1553701117	0.7747075658	33.89954	-0.26716	28	277	12	36	303	16	0.18892	0.02532
17	368581000119106	Neuropathy due to type 2 diabetes mellitus (disorder)	3	65363002	Otitis media	1095	28	580	9	19	571	496	0.60683	-0.06759	0.41147	0.91773	0.18448	0.0335166157	0.3393412372	14.83105	-0.66276	7	277	2	21	303	7	1.14740	0.11778
15	40055000	Chronic sinusitis (disorder)	3	65363002	Otitis media	1095	216	580	90	126	490	389	0.78664	-0.11224	0.56706	0.76657	0.41947	0.0002499230	0.0077520298	114.41096	-0.34284	104	277	42	112	303	48	0.03794	0.04196
14	10509002	Acute bronchitis (disorder)	3	65363002	Otitis media	1095	863	580	456	407	124	108	0.99756	-0.00499	0.97583	1.30482	0.72978	0.8824440492	1.0000000000	457.11416	-0.00351	418	277	215	445	303	241	0.01369	0.03375
13	370247008	Facial laceration	3	65363002	Otitis media	1095	109	580	48	61	532	454	0.83138	-0.05950	0.67151	1.00014	0.45087	0.0546585463	0.4520620234	57.73516	-0.26144	55	277	22	54	303	26	0.07144	0.12883
123	195967001	Asthma	11	38341003	Hypertension	1095	2	278	0	2	278	815	0.00000	-0.02495	0.00000	0.00000	0.00000	1.0000000000	1.0000000000	0.50776	-0.59241	1	131	0	1	147	0	0.00000	0.00000
10	62106007	Concussion with no loss of consciousness	3	65363002	Otitis media	1095	206	580	98	108	482	407	0.89814	-0.05203	0.76621	1.03802	0.56558	0.0887523862	0.5902033682	109.11416	-0.15350	96	277	40	110	303	58	0.24159	0.16025
9	44465007	Sprain of ankle	3	65363002	Otitis media	1095	362	580	194	168	386	347	1.01176	0.00877	1.03809	1.33609	0.80655	0.7969892724	1.0000000000	191.74429	0.01679	185	277	97	177	303	97	-0.06721	0.02878
8	233678006	Childhood asthma	3	65363002	Otitis media	1095	45	580	25	20	555	495	1.04885	0.01073	1.11486	2.03212	0.61164	0.7621256904	1.0000000000	23.83562	0.06610	25	277	13	20	303	12	-0.16273	0.09181
7	75498004	Acute bacterial sinusitis (disorder)	3	65363002	Otitis media	1095	187	580	91	96	489	419	0.91873	-0.03914	0.81222	1.11301	0.59272	0.1990778816	0.8425774565	99.05023	-0.12102	89	277	41	98	303	50	0.09403	0.06877
6	39848009	Whiplash injury to neck	3	65363002	Otitis media	1095	182	580	102	80	478	435	1.05807	0.02752	1.16030	1.59825	0.84236	0.3721635803	1.0000000000	96.40183	0.08062	92	277	49	90	303	53	-0.00956	0.06439
5	284549007	Laceration of hand	3	65363002	Otitis media	1095	104	580	59	45	521	470	1.07104	0.02442	1.18277	1.77769	0.78694	0.4700506976	1.0000000000	55.08676	0.09730	54	277	26	50	303	33	0.13503	0.20160
119	275272006	Brain damage - traumatic	61	198992004	Antepartum eclampsia	1095	4	96	0	4	96	995	0.00000	-0.01877	0.00000	0.00000	0.00000	1.0000000000	1.0000000000	0.35068	-0.43369	0	96	0	4	0	0	0.00000	0.00000
120	162573006	Suspected lung cancer (situation)	61	198992004	Antepartum eclampsia	1095	8	96	0	8	96	991	0.00000	-0.02659	0.00000	0.00000	0.00000	1.0000000000	1.0000000000	0.70137	-0.76670	0	96	0	8	0	0	0.00000	0.00000
121	254637007	Non-small cell lung cancer (disorder)	61	198992004	Antepartum eclampsia	1095	8	96	0	8	96	991	0.00000	-0.02659	0.00000	0.00000	0.00000	1.0000000000	1.0000000000	0.70137	-0.76670	0	96	0	8	0	0	0.00000	0.00000
1	444814009	Viral sinusitis (disorder)	3	65363002	Otitis media	1095	993	580	520	473	60	42	0.98864	-0.03760	0.76956	1.16367	0.50892	0.2518136938	0.9133257124	525.97260	-0.01644	478	277	248	515	303	272	0.00140	0.01170
123	195967001	Asthma	61	198992004	Antepartum eclampsia	1095	2	96	1	1	95	998	5.70312	0.06237	10.50526	169.29868	0.65187	0.1677293331	0.7942848378	0.17534	0.76692	1	96	1	1	0	0	4.57471	0.69315
124	1501000119109	Proliferative diabetic retinopathy due to type II diabetes mellitus (disorder)	61	198992004	Antepartum eclampsia	1095	1	96	0	1	96	998	0.00000	-0.00937	0.00000	0.00000	0.00000	1.0000000000	1.0000000000	0.08767	-0.12124	1	96	0	0	0	0	0.00000	0.00000
125	1734006	Fracture of the vertebral column with spinal cord injury	61	198992004	Antepartum eclampsia	1095	5	96	0	5	96	994	0.00000	-0.02100	0.00000	0.00000	0.00000	1.0000000000	1.0000000000	0.43836	-0.52442	3	96	0	2	0	0	0.00000	0.00000
126	698754002	Chronic paralysis due to lesion of spinal cord	61	198992004	Antepartum eclampsia	1095	2	96	0	2	96	997	0.00000	-0.01326	0.00000	0.00000	0.00000	1.0000000000	1.0000000000	0.17534	-0.23308	2	96	0	0	0	0	0.00000	0.00000
127	431856006	Chronic kidney disease stage 2 (disorder)	61	198992004	Antepartum eclampsia	1095	5	96	0	5	96	994	0.00000	-0.02100	0.00000	0.00000	0.00000	1.0000000000	1.0000000000	0.43836	-0.52442	3	96	0	2	0	0	0.00000	0.00000
128	86849004	Suicidal deliberate poisoning	3	65363002	Otitis media	1095	1	580	0	1	580	514	0.00000	-0.03208	0.00000	0.00000	0.00000	0.4703196347	1.0000000000	0.52968	-0.61323	0	277	0	1	303	0	0.00000	0.00000
129	47505003	Posttraumatic stress disorder	61	198992004	Antepartum eclampsia	1095	4	96	1	3	95	996	2.85156	0.03475	3.49474	33.92652	0.35999	0.3075693478	0.9977249576	0.35068	0.56631	1	96	1	3	0	0	4.57471	0.69315
130	314994000	Metastasis from malignant tumor of prostate (disorder)	61	198992004	Antepartum eclampsia	1095	1	96	0	1	96	998	0.00000	-0.00937	0.00000	0.00000	0.00000	1.0000000000	1.0000000000	0.08767	-0.12124	0	96	0	1	0	0	0.00000	0.00000
131	93761005	Primary malignant neoplasm of colon	61	198992004	Antepartum eclampsia	1095	5	96	0	5	96	994	0.00000	-0.02100	0.00000	0.00000	0.00000	1.0000000000	1.0000000000	0.43836	-0.52442	3	96	0	2	0	0	0.00000	0.00000
130	314994000	Metastasis from malignant tumor of prostate (disorder)	3	65363002	Otitis media	1095	1	580	0	1	580	514	0.00000	-0.03208	0.00000	0.00000	0.00000	0.4703196347	1.0000000000	0.52968	-0.61323	0	277	0	1	303	0	0.00000	0.00000
118	48333001	Burn injury(morphologic abnormality)	5	284549007	Laceration of hand	1095	1	104	0	1	104	990	0.00000	-0.00979	0.00000	0.00000	0.00000	1.0000000000	1.0000000000	0.09498	-0.13090	0	54	0	1	50	0	0.00000	0.00000
131	93761005	Primary malignant neoplasm of colon	3	65363002	Otitis media	1095	5	580	1	4	579	511	0.37759	-0.04474	0.22064	1.98042	0.02458	0.1933894282	0.8313283060	2.64840	-0.86726	3	277	1	2	303	0	5.62762	1.38629
119	275272006	Brain damage - traumatic	2	43878008	Streptococcal sore throat (disorder)	1095	4	523	0	4	523	568	0.00000	-0.05790	0.00000	0.00000	0.00000	0.1258171009	0.6946053535	1.91050	-1.54127	0	246	0	4	277	0	0.00000	0.00000
121	254637007	Non-small cell lung cancer (disorder)	2	43878008	Streptococcal sore throat (disorder)	1095	8	523	4	4	519	568	1.04685	0.00384	1.09441	4.39833	0.27232	1.0000000000	1.0000000000	3.82100	0.05259	0	246	0	8	277	4	-4.25206	-1.09861
130	314994000	Metastasis from malignant tumor of prostate (disorder)	5	284549007	Laceration of hand	1095	1	104	0	1	104	990	0.00000	-0.00979	0.00000	0.00000	0.00000	1.0000000000	1.0000000000	0.09498	-0.13090	0	54	0	1	50	0	0.00000	0.00000
125	1734006	Fracture of the vertebral column with spinal cord injury	115	36923009	Major depression  single episode	1095	5	6	0	5	6	1084	0.00000	-0.00503	0.00000	0.00000	0.00000	1.0000000000	1.0000000000	0.02740	-0.03899	3	3	0	2	3	0	0.00000	0.00000
130	314994000	Metastasis from malignant tumor of prostate (disorder)	2	43878008	Streptococcal sore throat (disorder)	1095	1	523	0	1	523	571	0.00000	-0.02891	0.00000	0.00000	0.00000	1.0000000000	1.0000000000	0.47763	-0.56328	0	246	0	1	277	0	0.00000	0.00000
131	93761005	Primary malignant neoplasm of colon	2	43878008	Streptococcal sore throat (disorder)	1095	5	523	2	3	521	569	0.83748	-0.01053	0.72809	4.37455	0.12118	1.0000000000	1.0000000000	2.38813	-0.17553	3	246	2	2	277	0	4.82028	0.91629
131	93761005	Primary malignant neoplasm of colon	116	370143000	Major depression disorder	1095	5	8	0	5	8	1082	0.00000	-0.00581	0.00000	0.00000	0.00000	1.0000000000	1.0000000000	0.03653	-0.05176	3	3	0	2	5	0	0.00000	0.00000
130	314994000	Metastasis from malignant tumor of prostate (disorder)	116	370143000	Major depression disorder	1095	1	8	0	1	8	1086	0.00000	-0.00259	0.00000	0.00000	0.00000	1.0000000000	1.0000000000	0.00731	-0.01050	0	3	0	1	5	0	0.00000	0.00000
129	47505003	Posttraumatic stress disorder	116	370143000	Major depression disorder	1095	4	8	1	3	7	1084	34.21875	0.17256	51.61905	558.89744	4.76747	0.0289442858	0.3121289194	0.02922	0.95844	1	3	0	3	5	1	-1.79176	-1.38629
128	86849004	Suicidal deliberate poisoning	116	370143000	Major depression disorder	1095	1	8	0	1	8	1086	0.00000	-0.00259	0.00000	0.00000	0.00000	1.0000000000	1.0000000000	0.00731	-0.01050	0	3	0	1	5	0	0.00000	0.00000
127	431856006	Chronic kidney disease stage 2 (disorder)	116	370143000	Major depression disorder	1095	5	8	0	5	8	1082	0.00000	-0.00581	0.00000	0.00000	0.00000	1.0000000000	1.0000000000	0.03653	-0.05176	3	3	0	2	5	0	0.00000	0.00000
126	698754002	Chronic paralysis due to lesion of spinal cord	116	370143000	Major depression disorder	1095	2	8	0	2	8	1085	0.00000	-0.00367	0.00000	0.00000	0.00000	1.0000000000	1.0000000000	0.01461	-0.02093	2	3	0	0	5	0	0.00000	0.00000
125	1734006	Fracture of the vertebral column with spinal cord injury	116	370143000	Major depression disorder	1095	5	8	0	5	8	1082	0.00000	-0.00581	0.00000	0.00000	0.00000	1.0000000000	1.0000000000	0.03653	-0.05176	3	3	0	2	5	0	0.00000	0.00000
124	1501000119109	Proliferative diabetic retinopathy due to type II diabetes mellitus (disorder)	116	370143000	Major depression disorder	1095	1	8	0	1	8	1086	0.00000	-0.00259	0.00000	0.00000	0.00000	1.0000000000	1.0000000000	0.00731	-0.01050	1	3	0	0	5	0	0.00000	0.00000
123	195967001	Asthma	116	370143000	Major depression disorder	1095	2	8	0	2	8	1085	0.00000	-0.00367	0.00000	0.00000	0.00000	1.0000000000	1.0000000000	0.01461	-0.02093	1	3	0	1	5	0	0.00000	0.00000
121	254637007	Non-small cell lung cancer (disorder)	116	370143000	Major depression disorder	1095	8	8	0	8	8	1079	0.00000	-0.00736	0.00000	0.00000	0.00000	1.0000000000	1.0000000000	0.05845	-0.08195	0	3	0	8	5	0	0.00000	0.00000
120	162573006	Suspected lung cancer (situation)	116	370143000	Major depression disorder	1095	8	8	0	8	8	1079	0.00000	-0.00736	0.00000	0.00000	0.00000	1.0000000000	1.0000000000	0.05845	-0.08195	0	3	0	8	5	0	0.00000	0.00000
119	275272006	Brain damage - traumatic	116	370143000	Major depression disorder	1095	4	8	0	4	8	1083	0.00000	-0.00519	0.00000	0.00000	0.00000	1.0000000000	1.0000000000	0.02922	-0.04156	0	3	0	4	5	0	0.00000	0.00000
118	48333001	Burn injury(morphologic abnormality)	116	370143000	Major depression disorder	1095	1	8	0	1	8	1086	0.00000	-0.00259	0.00000	0.00000	0.00000	1.0000000000	1.0000000000	0.00731	-0.01050	0	3	0	1	5	0	0.00000	0.00000
117	230265002	Familial Alzheimer's disease of early onset (disorder)	116	370143000	Major depression disorder	1095	6	8	0	6	8	1081	0.00000	-0.00637	0.00000	0.00000	0.00000	1.0000000000	1.0000000000	0.04384	-0.06189	2	3	0	4	5	0	0.00000	0.00000
115	36923009	Major depression  single episode	116	370143000	Major depression disorder	1095	6	8	6	0	2	1087	136.87500	0.86523	0.00000	0.00000	0.00000	0.0000000000	0.0000000000	0.04384	2.74546	3	3	3	3	5	3	-0.28768	0.00000
114	449868002	Smokes tobacco daily	116	370143000	Major depression disorder	1095	9	8	2	7	6	1080	30.41667	0.22974	51.42857	300.26134	8.80865	0.0016402331	0.0366360464	0.06575	1.49309	2	3	0	7	5	2	-1.25276	-1.50408
113	443165006	Pathological fracture due to osteoporosis (disorder)	116	370143000	Major depression disorder	1095	10	8	0	10	8	1077	0.00000	-0.00824	0.00000	0.00000	0.00000	1.0000000000	1.0000000000	0.07306	-0.10173	7	3	0	3	5	0	0.00000	0.00000
112	49436004	Atrial Fibrillation	116	370143000	Major depression disorder	1095	35	8	2	33	6	1054	7.82143	0.10634	10.64646	54.74103	2.07061	0.0246345822	0.2894810738	0.25571	1.25646	9	3	0	26	5	2	-1.25276	-2.63906
111	235919008	Cholelithiasis	116	370143000	Major depression disorder	1095	9	8	0	9	8	1078	0.00000	-0.00781	0.00000	0.00000	0.00000	1.0000000000	1.0000000000	0.06575	-0.09187	7	3	0	2	5	0	0.00000	0.00000
110	65275009	Acute Cholecystitis	116	370143000	Major depression disorder	1095	9	8	0	9	8	1078	0.00000	-0.00781	0.00000	0.00000	0.00000	1.0000000000	1.0000000000	0.06575	-0.09187	7	3	0	2	5	0	0.00000	0.00000
109	90560007	Gout	116	370143000	Major depression disorder	1095	4	8	0	4	8	1083	0.00000	-0.00519	0.00000	0.00000	0.00000	1.0000000000	1.0000000000	0.02922	-0.04156	0	3	0	4	5	0	0.00000	0.00000
108	40930008	Hypothyroidism (disorder)	116	370143000	Major depression disorder	1095	13	8	1	12	7	1075	10.52885	0.08960	12.79762	112.21552	1.45950	0.0914034373	0.5996557347	0.09498	0.86910	11	3	0	2	5	1	-1.79176	-1.09861
107	40275004	Contact dermatitis	116	370143000	Major depression disorder	1095	18	8	0	18	8	1069	0.00000	-0.01109	0.00000	0.00000	0.00000	1.0000000000	1.0000000000	0.13151	-0.17825	9	3	0	9	5	0	0.00000	0.00000
106	24079001	Atopic dermatitis	116	370143000	Major depression disorder	1095	20	8	0	20	8	1067	0.00000	-0.01170	0.00000	0.00000	0.00000	1.0000000000	1.0000000000	0.14612	-0.19676	13	3	0	7	5	0	0.00000	0.00000
105	363406005	Malignant tumor of colon	116	370143000	Major depression disorder	1095	6	8	0	6	8	1081	0.00000	-0.00637	0.00000	0.00000	0.00000	1.0000000000	1.0000000000	0.04384	-0.06189	4	3	0	2	5	0	0.00000	0.00000
104	367498001	Seasonal allergic rhinitis	116	370143000	Major depression disorder	1095	20	8	0	20	8	1067	0.00000	-0.01170	0.00000	0.00000	0.00000	1.0000000000	1.0000000000	0.14612	-0.19676	9	3	0	11	5	0	0.00000	0.00000
102	90781000119102	Microalbuminuria due to type 2 diabetes mellitus (disorder)	116	370143000	Major depression disorder	1095	6	8	0	6	8	1081	0.00000	-0.00637	0.00000	0.00000	0.00000	1.0000000000	1.0000000000	0.04384	-0.06189	3	3	0	3	5	0	0.00000	0.00000
101	433144002	Chronic kidney disease stage 3 (disorder)	116	370143000	Major depression disorder	1095	3	8	0	3	8	1084	0.00000	-0.00450	0.00000	0.00000	0.00000	1.0000000000	1.0000000000	0.02192	-0.03128	1	3	0	2	5	0	0.00000	0.00000
100	161622006	History of lower limb amputation (situation)	116	370143000	Major depression disorder	1095	1	8	0	1	8	1086	0.00000	-0.00259	0.00000	0.00000	0.00000	1.0000000000	1.0000000000	0.00731	-0.01050	0	3	0	1	5	0	0.00000	0.00000
99	30832001	Rupture of patellar tendon	116	370143000	Major depression disorder	1095	23	8	0	23	8	1064	0.00000	-0.01257	0.00000	0.00000	0.00000	1.0000000000	1.0000000000	0.16804	-0.22409	14	3	0	9	5	0	0.00000	0.00000
98	1551000119108	Nonproliferative diabetic retinopathy due to type 2 diabetes mellitus (disorder)	116	370143000	Major depression disorder	1095	12	8	0	12	8	1075	0.00000	-0.00903	0.00000	0.00000	0.00000	1.0000000000	1.0000000000	0.08767	-0.12124	7	3	0	5	5	0	0.00000	0.00000
97	403192003	Third degree burn	116	370143000	Major depression disorder	1095	8	8	0	8	8	1079	0.00000	-0.00736	0.00000	0.00000	0.00000	1.0000000000	1.0000000000	0.05845	-0.08195	3	3	0	5	5	0	0.00000	0.00000
96	283371005	Laceration of forearm	116	370143000	Major depression disorder	1095	75	8	2	73	6	1014	3.65000	0.06165	4.63014	23.34590	0.91828	0.0990661717	0.6251638067	0.54795	0.95461	39	3	2	36	5	0	0.91629	3.02042
95	84757009	Epilepsy	116	370143000	Major depression disorder	1095	30	8	0	30	8	1057	0.00000	-0.01440	0.00000	0.00000	0.00000	1.0000000000	1.0000000000	0.21918	-0.28591	13	3	0	17	5	0	0.00000	0.00000
94	703151001	History of single seizure (situation)	116	370143000	Major depression disorder	1095	39	8	0	39	8	1048	0.00000	-0.01649	0.00000	0.00000	0.00000	1.0000000000	1.0000000000	0.28493	-0.36169	14	3	0	25	5	0	0.00000	0.00000
93	128613002	Seizure disorder	116	370143000	Major depression disorder	1095	39	8	0	39	8	1048	0.00000	-0.01649	0.00000	0.00000	0.00000	1.0000000000	1.0000000000	0.28493	-0.36169	14	3	0	25	5	0	0.00000	0.00000
91	64859006	Osteoporosis (disorder)	116	370143000	Major depression disorder	1095	37	8	2	35	6	1052	7.39865	0.10265	10.01905	51.41054	1.95254	0.0273712891	0.3045186004	0.27032	1.23977	24	3	1	13	5	1	-0.40547	0.57982
89	47693006	Rupture of appendix	116	370143000	Major depression disorder	1095	20	8	0	20	8	1067	0.00000	-0.01170	0.00000	0.00000	0.00000	1.0000000000	1.0000000000	0.14612	-0.19676	10	3	0	10	5	0	0.00000	0.00000
86	713197008	Recurrent rectal polyp	116	370143000	Major depression disorder	1095	22	8	0	22	8	1065	0.00000	-0.01228	0.00000	0.00000	0.00000	1.0000000000	1.0000000000	0.16073	-0.21503	12	3	0	10	5	0	0.00000	0.00000
85	241929008	Acute allergic reaction	116	370143000	Major depression disorder	1095	47	8	0	47	8	1040	0.00000	-0.01817	0.00000	0.00000	0.00000	1.0000000000	1.0000000000	0.34338	-0.42587	25	3	0	22	5	0	0.00000	0.00000
83	110030002	Concussion injury of brain	116	370143000	Major depression disorder	1095	7	8	0	7	8	1080	0.00000	-0.00688	0.00000	0.00000	0.00000	1.0000000000	1.0000000000	0.05114	-0.07196	1	3	0	6	5	0	0.00000	0.00000
82	94260004	Secondary malignant neoplasm of colon	116	370143000	Major depression disorder	1095	4	8	0	4	8	1083	0.00000	-0.00519	0.00000	0.00000	0.00000	1.0000000000	1.0000000000	0.02922	-0.04156	2	3	0	2	5	0	0.00000	0.00000
81	236077008	Protracted diarrhea	116	370143000	Major depression disorder	1095	4	8	0	4	8	1083	0.00000	-0.00519	0.00000	0.00000	0.00000	1.0000000000	1.0000000000	0.02922	-0.04156	2	3	0	2	5	0	0.00000	0.00000
80	6072007	Bleeding from anus	116	370143000	Major depression disorder	1095	4	8	0	4	8	1083	0.00000	-0.00519	0.00000	0.00000	0.00000	1.0000000000	1.0000000000	0.02922	-0.04156	2	3	0	2	5	0	0.00000	0.00000
79	45816000	Pyelonephritis	116	370143000	Major depression disorder	1095	1	8	0	1	8	1086	0.00000	-0.00259	0.00000	0.00000	0.00000	1.0000000000	1.0000000000	0.00731	-0.01050	1	3	0	0	5	0	0.00000	0.00000
78	239872002	Osteoarthritis of hip	116	370143000	Major depression disorder	1095	21	8	0	21	8	1066	0.00000	-0.01200	0.00000	0.00000	0.00000	1.0000000000	1.0000000000	0.15342	-0.20592	13	3	0	8	5	0	0.00000	0.00000
76	127013003	Diabetic renal disease (disorder)	116	370143000	Major depression disorder	1095	28	8	2	26	6	1061	9.77679	0.12197	13.60256	70.61052	2.62043	0.0160596208	0.2162137295	0.20457	1.31645	10	3	0	18	5	2	-1.25276	-2.30259
75	431855005	Chronic kidney disease stage 1 (disorder)	116	370143000	Major depression disorder	1095	28	8	2	26	6	1061	9.77679	0.12197	13.60256	70.61052	2.62043	0.0160596208	0.2162137295	0.20457	1.31645	10	3	0	18	5	2	-1.25276	-2.30259
73	196416002	Impacted molars	116	370143000	Major depression disorder	1095	49	8	0	49	8	1038	0.00000	-0.01857	0.00000	0.00000	0.00000	1.0000000000	1.0000000000	0.35799	-0.44147	25	3	0	24	5	0	0.00000	0.00000
72	35999006	Blighted ovum	116	370143000	Major depression disorder	1095	53	8	1	52	7	1035	2.58255	0.03062	2.84341	23.54064	0.34345	0.3284763920	1.0000000000	0.38721	0.52781	53	3	1	0	5	0	1.38629	3.98898
71	201834006	Localized  primary osteoarthritis of the hand	116	370143000	Major depression disorder	1095	28	8	0	28	8	1059	0.00000	-0.01390	0.00000	0.00000	0.00000	1.0000000000	1.0000000000	0.20457	-0.26851	19	3	0	9	5	0	0.00000	0.00000
70	87433001	Pulmonary emphysema (disorder)	116	370143000	Major depression disorder	1095	17	8	0	17	8	1070	0.00000	-0.01077	0.00000	0.00000	0.00000	1.0000000000	1.0000000000	0.12420	-0.16890	9	3	0	8	5	0	0.00000	0.00000
69	233604007	Pneumonia	116	370143000	Major depression disorder	1095	7	8	0	7	8	1080	0.00000	-0.00688	0.00000	0.00000	0.00000	1.0000000000	1.0000000000	0.05114	-0.07196	3	3	0	4	5	0	0.00000	0.00000
68	26929004	Alzheimer's disease (disorder)	116	370143000	Major depression disorder	1095	23	8	0	23	8	1064	0.00000	-0.01257	0.00000	0.00000	0.00000	1.0000000000	1.0000000000	0.16804	-0.22409	15	3	0	8	5	0	0.00000	0.00000
67	403191005	Second degree burn	116	370143000	Major depression disorder	1095	49	8	1	48	7	1039	2.79337	0.03330	3.09226	25.63813	0.37296	0.3075030702	0.9977249576	0.35799	0.55853	23	3	1	26	5	0	1.38629	3.17805
65	239873007	Osteoarthritis of knee	116	370143000	Major depression disorder	1095	57	8	0	57	8	1030	0.00000	-0.02010	0.00000	0.00000	0.00000	1.0000000000	1.0000000000	0.41644	-0.50227	30	3	0	27	5	0	0.00000	0.00000
64	444448004	Injury of medial collateral ligament of knee	116	370143000	Major depression disorder	1095	32	8	0	32	8	1055	0.00000	-0.01488	0.00000	0.00000	0.00000	1.0000000000	1.0000000000	0.23379	-0.30310	17	3	0	15	5	0	0.00000	0.00000
63	68496003	Polyp of colon	116	370143000	Major depression disorder	1095	91	8	1	90	7	997	1.50412	0.01302	1.58254	13.00584	0.19256	0.5016374865	1.0000000000	0.66484	0.26462	43	3	0	48	5	1	-1.79176	-3.89182
62	185086009	Chronic obstructive bronchitis (disorder)	116	370143000	Major depression disorder	1095	6	8	0	6	8	1081	0.00000	-0.00637	0.00000	0.00000	0.00000	1.0000000000	1.0000000000	0.04384	-0.06189	4	3	0	2	5	0	0.00000	0.00000
60	301011002	Escherichia coli urinary tract infection	116	370143000	Major depression disorder	1095	92	8	0	92	8	995	0.00000	-0.02598	0.00000	0.00000	0.00000	1.0000000000	1.0000000000	0.67215	-0.74170	85	3	0	7	5	0	0.00000	0.00000
59	262574004	Bullet wound	116	370143000	Major depression disorder	1095	20	8	0	20	8	1067	0.00000	-0.01170	0.00000	0.00000	0.00000	1.0000000000	1.0000000000	0.14612	-0.19676	9	3	0	11	5	0	0.00000	0.00000
58	239720000	Tear of meniscus of knee	116	370143000	Major depression disorder	1095	20	8	0	20	8	1067	0.00000	-0.01170	0.00000	0.00000	0.00000	1.0000000000	1.0000000000	0.14612	-0.19676	10	3	0	10	5	0	0.00000	0.00000
57	192127007	Child attention deficit disorder	116	370143000	Major depression disorder	1095	76	8	1	75	7	1012	1.80099	0.01877	1.92762	15.87373	0.23408	0.4386311466	1.0000000000	0.55525	0.36285	24	3	0	52	5	1	-1.79176	-3.97029
56	92691004	Carcinoma in situ of prostate (disorder)	116	370143000	Major depression disorder	1095	23	8	3	20	5	1067	17.85326	0.21178	32.01000	143.19387	7.15561	0.0004241152	0.0122061759	0.16804	1.77591	0	3	0	23	5	3	-0.98083	-2.15948
54	5602001	Opioid abuse (disorder)	116	370143000	Major depression disorder	1095	7	8	0	7	8	1080	0.00000	-0.00688	0.00000	0.00000	0.00000	1.0000000000	1.0000000000	0.05114	-0.07196	0	3	0	7	5	0	0.00000	0.00000
53	7200002	Alcoholism	116	370143000	Major depression disorder	1095	5	8	0	5	8	1082	0.00000	-0.00581	0.00000	0.00000	0.00000	1.0000000000	1.0000000000	0.03653	-0.05176	0	3	0	5	5	0	0.00000	0.00000
52	124171000119105	Chronic intractable migraine without aura	116	370143000	Major depression disorder	1095	51	8	0	51	8	1036	0.00000	-0.01896	0.00000	0.00000	0.00000	1.0000000000	1.0000000000	0.37260	-0.45691	21	3	0	30	5	0	0.00000	0.00000
50	446096008	Perennial allergic rhinitis	116	370143000	Major depression disorder	1095	26	8	0	26	8	1061	0.00000	-0.01338	0.00000	0.00000	0.00000	1.0000000000	1.0000000000	0.18995	-0.25091	14	3	0	12	5	0	0.00000	0.00000
49	88805009	Chronic congestive heart failure (disorder)	116	370143000	Major depression disorder	1095	10	8	0	10	8	1077	0.00000	-0.00824	0.00000	0.00000	0.00000	1.0000000000	1.0000000000	0.07306	-0.10173	5	3	0	5	5	0	0.00000	0.00000
47	359817006	Closed fracture of hip	116	370143000	Major depression disorder	1095	29	8	0	29	8	1058	0.00000	-0.01415	0.00000	0.00000	0.00000	1.0000000000	1.0000000000	0.21187	-0.27724	11	3	0	18	5	0	0.00000	0.00000
46	62564004	Concussion with loss of consciousness	116	370143000	Major depression disorder	1095	67	8	0	67	8	1020	0.00000	-0.02190	0.00000	0.00000	0.00000	1.0000000000	1.0000000000	0.48950	-0.57483	36	3	0	31	5	0	0.00000	0.00000
45	263102004	Fracture subluxation of wrist	116	370143000	Major depression disorder	1095	109	8	0	109	8	978	0.00000	-0.02852	0.00000	0.00000	0.00000	1.0000000000	1.0000000000	0.79635	-0.84507	51	3	0	58	5	0	0.00000	0.00000
44	58150001	Fracture of clavicle	116	370143000	Major depression disorder	1095	112	8	1	111	7	976	1.22210	0.00643	1.25611	10.30359	0.15313	0.5794247115	1.0000000000	0.81826	0.13744	55	3	1	57	5	0	1.38629	4.02535
43	307731004	Injury of tendon of the rotator cuff of shoulder	116	370143000	Major depression disorder	1095	51	8	0	51	8	1036	0.00000	-0.01896	0.00000	0.00000	0.00000	1.0000000000	1.0000000000	0.37260	-0.45691	26	3	0	25	5	0	0.00000	0.00000
42	16114001	Fracture of ankle	116	370143000	Major depression disorder	1095	108	8	1	107	7	980	1.26736	0.00759	1.30841	10.73583	0.15946	0.5654865541	1.0000000000	0.78904	0.16081	48	3	1	60	5	0	1.38629	3.89182
41	283385000	Laceration of thigh	116	370143000	Major depression disorder	1095	105	8	1	104	7	983	1.30357	0.00848	1.35027	11.08203	0.16452	0.5547693232	1.0000000000	0.76712	0.17860	50	3	1	55	5	0	1.38629	3.93183
40	428251008	History of appendectomy	116	370143000	Major depression disorder	1095	51	8	0	51	8	1036	0.00000	-0.01896	0.00000	0.00000	0.00000	1.0000000000	1.0000000000	0.37260	-0.45691	27	3	0	24	5	0	0.00000	0.00000
39	74400008	Appendicitis	116	370143000	Major depression disorder	1095	51	8	0	51	8	1036	0.00000	-0.01896	0.00000	0.00000	0.00000	1.0000000000	1.0000000000	0.37260	-0.45691	27	3	0	24	5	0	0.00000	0.00000
38	398254007	Preeclampsia	116	370143000	Major depression disorder	1095	101	8	0	101	8	986	0.00000	-0.02735	0.00000	0.00000	0.00000	1.0000000000	1.0000000000	0.73790	-0.79734	101	3	0	0	5	0	0.00000	0.00000
37	38822007	Cystitis	116	370143000	Major depression disorder	1095	71	8	1	70	7	1017	1.92782	0.02096	2.07551	17.10635	0.25182	0.4161341830	1.0000000000	0.51872	0.39714	68	3	1	3	5	0	1.38629	4.23411
35	19169002	Miscarriage in first trimester	116	370143000	Major depression disorder	1095	174	8	1	173	7	914	0.78664	-0.00796	0.75475	6.17317	0.09228	1.0000000000	1.0000000000	1.27123	-0.18348	174	3	1	0	5	0	1.38629	5.16479
33	429007001	History of cardiac arrest (situation)	116	370143000	Major depression disorder	1095	42	8	0	42	8	1045	0.00000	-0.01713	0.00000	0.00000	0.00000	1.0000000000	1.0000000000	0.30685	-0.38609	24	3	0	18	5	0	0.00000	0.00000
32	410429000	Cardiac Arrest	116	370143000	Major depression disorder	1095	42	8	0	42	8	1045	0.00000	-0.01713	0.00000	0.00000	0.00000	1.0000000000	1.0000000000	0.30685	-0.38609	24	3	0	18	5	0	0.00000	0.00000
30	399211009	History of myocardial infarction (situation)	116	370143000	Major depression disorder	1095	31	8	1	30	7	1057	4.41532	0.05001	5.03333	42.20615	0.60025	0.2058637726	0.8544076578	0.22648	0.70547	2	3	0	29	5	1	-1.79176	-3.40120
29	22298006	Myocardial Infarction	116	370143000	Major depression disorder	1095	31	8	1	30	7	1057	4.41532	0.05001	5.03333	42.20615	0.60025	0.2058637726	0.8544076578	0.22648	0.70547	2	3	0	29	5	1	-1.79176	-3.40120
28	53741008	Coronary Heart Disease	116	370143000	Major depression disorder	1095	80	8	1	79	7	1008	1.71094	0.01712	1.82278	15.00125	0.22148	0.4560788859	1.0000000000	0.58447	0.33600	24	3	0	56	5	1	-1.79176	-4.04305
27	408512008	Body mass index 40+ - severely obese (finding)	116	370143000	Major depression disorder	1095	97	8	0	97	8	990	0.00000	-0.02675	0.00000	0.00000	0.00000	1.0000000000	1.0000000000	0.70868	-0.77288	67	3	0	30	5	0	0.00000	0.00000
26	33737001	Fracture of rib	116	370143000	Major depression disorder	1095	54	8	0	54	8	1033	0.00000	-0.01954	0.00000	0.00000	0.00000	1.0000000000	1.0000000000	0.39452	-0.47977	32	3	0	22	5	0	0.00000	0.00000
24	162864005	Body mass index 30+ - obesity (finding)	116	370143000	Major depression disorder	1095	439	8	2	437	6	650	0.62358	-0.02642	0.49580	2.46778	0.09961	0.4869543036	1.0000000000	3.20731	-0.48793	226	3	1	213	5	1	-0.40547	0.05897
23	36971009	Sinusitis (disorder)	116	370143000	Major depression disorder	1095	190	8	2	188	6	899	1.44079	0.01733	1.59397	7.95846	0.31925	0.6334783673	1.0000000000	1.38813	0.32908	84	3	1	106	5	1	-0.40547	-0.23018
21	15777000	Prediabetes	116	370143000	Major depression disorder	1095	333	8	2	331	6	756	0.82207	-0.01009	0.76133	3.79173	0.15286	1.0000000000	1.0000000000	2.43288	-0.19446	159	3	1	174	5	1	-0.40547	-0.08961
20	80394007	Hyperglycemia (disorder)	116	370143000	Major depression disorder	1095	55	8	1	54	7	1033	2.48864	0.02937	2.73280	22.61036	0.33030	0.3387530268	1.0000000000	0.40183	0.51269	23	3	0	32	5	1	-1.79176	-3.49651
19	237602007	Metabolic syndrome X (disorder)	116	370143000	Major depression disorder	1095	64	8	2	62	6	1025	4.27734	0.07005	5.51075	27.86598	1.08980	0.0749717423	0.5403135912	0.46758	1.03152	28	3	0	36	5	2	-1.25276	-2.94444
18	302870006	Hypertriglyceridemia (disorder)	116	370143000	Major depression disorder	1095	64	8	2	62	6	1025	4.27734	0.07005	5.51075	27.86598	1.08980	0.0749717423	0.5403135912	0.46758	1.03152	28	3	0	36	5	2	-1.25276	-2.94444
17	368581000119106	Neuropathy due to type 2 diabetes mellitus (disorder)	116	370143000	Major depression disorder	1095	28	8	1	27	7	1060	4.88839	0.05404	5.60847	47.18618	0.66661	0.1877127711	0.8181443419	0.20457	0.73149	7	3	0	21	5	1	-1.79176	-3.09104
129	47505003	Posttraumatic stress disorder	90	444470001	Injury of anterior cruciate ligament	1095	4	19	0	4	19	1072	0.00000	-0.00805	0.00000	0.00000	0.00000	1.0000000000	1.0000000000	0.06941	-0.09681	1	10	0	3	9	0	0.00000	0.00000
15	40055000	Chronic sinusitis (disorder)	116	370143000	Major depression disorder	1095	216	8	1	215	7	872	0.63368	-0.01558	0.57940	4.73434	0.07091	1.0000000000	1.0000000000	1.57808	-0.36630	104	3	1	112	5	0	1.38629	4.65396
14	10509002	Acute bronchitis (disorder)	116	370143000	Major depression disorder	1095	863	8	8	855	0	232	1.26883	0.04448	0.00000	0.00000	0.00000	0.2149446036	0.8672161313	6.30502	0.30104	418	3	3	445	5	5	0.00000	0.44421
13	370247008	Facial laceration	116	370143000	Major depression disorder	1095	109	8	0	109	8	978	0.00000	-0.02852	0.00000	0.00000	0.00000	1.0000000000	1.0000000000	0.79635	-0.84507	55	3	0	54	5	0	0.00000	0.00000
125	1734006	Fracture of the vertebral column with spinal cord injury	90	444470001	Injury of anterior cruciate ligament	1095	5	19	0	5	19	1071	0.00000	-0.00900	0.00000	0.00000	0.00000	1.0000000000	1.0000000000	0.08676	-0.12003	3	10	0	2	9	0	0.00000	0.00000
124	1501000119109	Proliferative diabetic retinopathy due to type II diabetes mellitus (disorder)	90	444470001	Injury of anterior cruciate ligament	1095	1	19	0	1	19	1075	0.00000	-0.00402	0.00000	0.00000	0.00000	1.0000000000	1.0000000000	0.01735	-0.02482	1	10	0	0	9	0	0.00000	0.00000
10	62106007	Concussion with no loss of consciousness	116	370143000	Major depression disorder	1095	206	8	1	205	7	882	0.66444	-0.01386	0.61463	5.02320	0.07521	1.0000000000	1.0000000000	1.50502	-0.32482	96	3	0	110	5	1	-1.79176	-4.70953
9	44465007	Sprain of ankle	116	370143000	Major depression disorder	1095	362	8	2	360	6	727	0.75622	-0.01470	0.67315	3.35179	0.13519	1.0000000000	1.0000000000	2.64475	-0.28086	185	3	1	177	5	1	-0.40547	0.04396
8	233678006	Childhood asthma	116	370143000	Major depression disorder	1095	45	8	1	44	7	1043	3.04167	0.03626	3.38636	28.12476	0.40774	0.2859588044	0.9673011117	0.32877	0.58991	25	3	0	20	5	1	-1.79176	-3.04452
7	75498004	Acute bacterial sinusitis (disorder)	116	370143000	Major depression disorder	1095	187	8	1	186	7	901	0.73195	-0.01044	0.69201	5.65804	0.08464	1.0000000000	1.0000000000	1.36621	-0.24258	89	3	0	98	5	1	-1.79176	-4.59512
6	39848009	Whiplash injury to neck	116	370143000	Major depression disorder	1095	182	8	2	180	6	907	1.50412	0.01931	1.67963	8.38841	0.33632	0.6265250190	1.0000000000	1.32968	0.36483	92	3	0	90	5	2	-1.25276	-3.82864
5	284549007	Laceration of hand	116	370143000	Major depression disorder	1095	104	8	2	102	6	985	2.63221	0.04536	3.21895	16.15607	0.64135	0.1716269478	0.7972585288	0.75982	0.76954	54	3	0	50	5	2	-1.25276	-3.25810
4	195662009	Acute viral pharyngitis (disorder)	116	370143000	Major depression disorder	1095	890	8	8	882	0	205	1.23034	0.04117	0.00000	0.00000	0.00000	0.3643124531	1.0000000000	6.50228	0.26260	430	3	3	460	5	5	0.00000	0.43953
3	65363002	Otitis media	116	370143000	Major depression disorder	1095	580	8	5	575	3	512	1.17996	0.01638	1.48406	6.24064	0.35292	0.7294274978	1.0000000000	4.23744	0.19610	277	3	2	303	5	3	-0.06454	0.31309
115	36923009	Major depression  single episode	90	444470001	Injury of anterior cruciate ligament	1095	6	19	1	5	18	1071	9.60526	0.08488	11.90000	107.07484	1.32253	0.0999150396	0.6256881010	0.10411	0.85712	3	10	1	3	9	0	2.39790	1.38629
1	444814009	Viral sinusitis (disorder)	116	370143000	Major depression disorder	1095	993	8	8	985	0	102	1.10272	0.02750	0.00000	0.00000	0.00000	1.0000000000	1.0000000000	7.25479	0.12469	478	3	3	515	5	5	0.00000	0.43286
113	443165006	Pathological fracture due to osteoporosis (disorder)	90	444470001	Injury of anterior cruciate ligament	1095	10	19	0	10	19	1066	0.00000	-0.01276	0.00000	0.00000	0.00000	1.0000000000	1.0000000000	0.17352	-0.23084	7	10	0	3	9	0	0.00000	0.00000
112	49436004	Atrial Fibrillation	90	444470001	Injury of anterior cruciate ligament	1095	35	19	0	35	19	1041	0.00000	-0.02415	0.00000	0.00000	0.00000	1.0000000000	1.0000000000	0.60731	-0.68464	9	10	0	26	9	0	0.00000	0.00000
111	235919008	Cholelithiasis	90	444470001	Injury of anterior cruciate ligament	1095	9	19	0	9	19	1067	0.00000	-0.01210	0.00000	0.00000	0.00000	1.0000000000	1.0000000000	0.15616	-0.20935	7	10	0	2	9	0	0.00000	0.00000
110	65275009	Acute Cholecystitis	90	444470001	Injury of anterior cruciate ligament	1095	9	19	0	9	19	1067	0.00000	-0.01210	0.00000	0.00000	0.00000	1.0000000000	1.0000000000	0.15616	-0.20935	7	10	0	2	9	0	0.00000	0.00000
109	90560007	Gout	90	444470001	Injury of anterior cruciate ligament	1095	4	19	0	4	19	1072	0.00000	-0.00805	0.00000	0.00000	0.00000	1.0000000000	1.0000000000	0.06941	-0.09681	0	10	0	4	9	0	0.00000	0.00000
108	40930008	Hypothyroidism (disorder)	90	444470001	Injury of anterior cruciate ligament	1095	13	19	0	13	19	1063	0.00000	-0.01457	0.00000	0.00000	0.00000	1.0000000000	1.0000000000	0.22557	-0.29345	11	10	0	2	9	0	0.00000	0.00000
107	40275004	Contact dermatitis	90	444470001	Injury of anterior cruciate ligament	1095	18	19	0	18	19	1058	0.00000	-0.01718	0.00000	0.00000	0.00000	1.0000000000	1.0000000000	0.31233	-0.39213	9	10	0	9	9	0	0.00000	0.00000
106	24079001	Atopic dermatitis	90	444470001	Injury of anterior cruciate ligament	1095	20	19	1	19	18	1057	2.88158	0.03410	3.09064	24.34985	0.39228	0.2975486779	0.9848726602	0.34703	0.57022	13	10	1	7	9	0	2.39790	2.63906
105	363406005	Malignant tumor of colon	90	444470001	Injury of anterior cruciate ligament	1095	6	19	0	6	19	1070	0.00000	-0.00986	0.00000	0.00000	0.00000	1.0000000000	1.0000000000	0.10411	-0.14288	4	10	0	2	9	0	0.00000	0.00000
104	367498001	Seasonal allergic rhinitis	90	444470001	Injury of anterior cruciate ligament	1095	20	19	1	19	18	1057	2.88158	0.03410	3.09064	24.34985	0.39228	0.2975486779	0.9848726602	0.34703	0.57022	9	10	1	11	9	0	2.39790	2.30259
103	157141000119108	Proteinuria due to type 2 diabetes mellitus (disorder)	90	444470001	Injury of anterior cruciate ligament	1095	3	19	0	3	19	1073	0.00000	-0.00696	0.00000	0.00000	0.00000	1.0000000000	1.0000000000	0.05205	-0.07321	1	10	0	2	9	0	0.00000	0.00000
102	90781000119102	Microalbuminuria due to type 2 diabetes mellitus (disorder)	90	444470001	Injury of anterior cruciate ligament	1095	6	19	0	6	19	1070	0.00000	-0.00986	0.00000	0.00000	0.00000	1.0000000000	1.0000000000	0.10411	-0.14288	3	10	0	3	9	0	0.00000	0.00000
101	433144002	Chronic kidney disease stage 3 (disorder)	90	444470001	Injury of anterior cruciate ligament	1095	3	19	0	3	19	1073	0.00000	-0.00696	0.00000	0.00000	0.00000	1.0000000000	1.0000000000	0.05205	-0.07321	1	10	0	2	9	0	0.00000	0.00000
100	161622006	History of lower limb amputation (situation)	90	444470001	Injury of anterior cruciate ligament	1095	1	19	0	1	19	1075	0.00000	-0.00402	0.00000	0.00000	0.00000	1.0000000000	1.0000000000	0.01735	-0.02482	0	10	0	1	9	0	0.00000	0.00000
99	30832001	Rupture of patellar tendon	90	444470001	Injury of anterior cruciate ligament	1095	23	19	1	22	18	1054	2.50572	0.02931	2.66162	20.82998	0.34010	0.3341739918	1.0000000000	0.39909	0.51551	14	10	1	9	9	0	2.39790	2.70805
98	1551000119108	Nonproliferative diabetic retinopathy due to type 2 diabetes mellitus (disorder)	90	444470001	Injury of anterior cruciate ligament	1095	12	19	0	12	19	1064	0.00000	-0.01399	0.00000	0.00000	0.00000	1.0000000000	1.0000000000	0.20822	-0.27288	7	10	0	5	9	0	0.00000	0.00000
97	403192003	Third degree burn	90	444470001	Injury of anterior cruciate ligament	1095	8	19	0	8	19	1068	0.00000	-0.01140	0.00000	0.00000	0.00000	1.0000000000	1.0000000000	0.13881	-0.18753	3	10	0	5	9	0	0.00000	0.00000
96	283371005	Laceration of forearm	90	444470001	Injury of anterior cruciate ligament	1095	75	19	1	74	18	1002	0.76842	-0.00834	0.75225	5.71323	0.09905	1.0000000000	1.0000000000	1.30137	-0.20249	39	10	1	36	9	0	2.39790	3.68888
95	84757009	Epilepsy	90	444470001	Injury of anterior cruciate ligament	1095	30	19	0	30	19	1046	0.00000	-0.02230	0.00000	0.00000	0.00000	1.0000000000	1.0000000000	0.52055	-0.60459	13	10	0	17	9	0	0.00000	0.00000
94	703151001	History of single seizure (situation)	90	444470001	Injury of anterior cruciate ligament	1095	39	19	1	38	18	1038	1.47773	0.01220	1.51754	11.66533	0.19742	0.5008715700	1.0000000000	0.67671	0.25436	14	10	0	25	9	1	-2.30259	-3.25810
93	128613002	Seizure disorder	90	444470001	Injury of anterior cruciate ligament	1095	39	19	1	38	18	1038	1.47773	0.01220	1.51754	11.66533	0.19742	0.5008715700	1.0000000000	0.67671	0.25436	14	10	0	25	9	1	-2.30259	-3.25810
92	82423001	Chronic pain	90	444470001	Injury of anterior cruciate ligament	1095	52	19	0	52	19	1024	0.00000	-0.02967	0.00000	0.00000	0.00000	1.0000000000	1.0000000000	0.90228	-0.92773	24	10	0	28	9	0	0.00000	0.00000
91	64859006	Osteoporosis (disorder)	90	444470001	Injury of anterior cruciate ligament	1095	37	19	5	32	14	1044	7.78805	0.16868	11.65179	34.31093	3.95688	0.0002756308	0.0084302703	0.64201	1.86950	24	10	5	13	9	0	1.09861	1.75786
89	47693006	Rupture of appendix	90	444470001	Injury of anterior cruciate ligament	1095	20	19	0	20	19	1056	0.00000	-0.01813	0.00000	0.00000	0.00000	1.0000000000	1.0000000000	0.34703	-0.42978	10	10	0	10	9	0	0.00000	0.00000
88	197927001	Recurrent urinary tract infection	90	444470001	Injury of anterior cruciate ligament	1095	8	19	0	8	19	1068	0.00000	-0.01140	0.00000	0.00000	0.00000	1.0000000000	1.0000000000	0.13881	-0.18753	8	10	0	0	9	0	0.00000	0.00000
87	109838007	Overlapping malignant neoplasm of colon	90	444470001	Injury of anterior cruciate ligament	1095	8	19	0	8	19	1068	0.00000	-0.01140	0.00000	0.00000	0.00000	1.0000000000	1.0000000000	0.13881	-0.18753	5	10	0	3	9	0	0.00000	0.00000
86	713197008	Recurrent rectal polyp	90	444470001	Injury of anterior cruciate ligament	1095	22	19	0	22	19	1054	0.00000	-0.01903	0.00000	0.00000	0.00000	1.0000000000	1.0000000000	0.38174	-0.46648	12	10	0	10	9	0	0.00000	0.00000
85	241929008	Acute allergic reaction	90	444470001	Injury of anterior cruciate ligament	1095	47	19	0	47	19	1029	0.00000	-0.02814	0.00000	0.00000	0.00000	1.0000000000	1.0000000000	0.81553	-0.86039	25	10	0	22	9	0	0.00000	0.00000
84	232353008	Perennial allergic rhinitis with seasonal variation	90	444470001	Injury of anterior cruciate ligament	1095	29	19	0	29	19	1047	0.00000	-0.02192	0.00000	0.00000	0.00000	1.0000000000	1.0000000000	0.50320	-0.58803	14	10	0	15	9	0	0.00000	0.00000
83	110030002	Concussion injury of brain	90	444470001	Injury of anterior cruciate ligament	1095	7	19	1	6	18	1070	8.23308	0.07710	9.90741	86.56844	1.13386	0.1156190013	0.6739067685	0.12146	0.83462	1	10	1	6	9	0	2.39790	0.69315
82	94260004	Secondary malignant neoplasm of colon	90	444470001	Injury of anterior cruciate ligament	1095	4	19	0	4	19	1072	0.00000	-0.00805	0.00000	0.00000	0.00000	1.0000000000	1.0000000000	0.06941	-0.09681	2	10	0	2	9	0	0.00000	0.00000
81	236077008	Protracted diarrhea	90	444470001	Injury of anterior cruciate ligament	1095	4	19	0	4	19	1072	0.00000	-0.00805	0.00000	0.00000	0.00000	1.0000000000	1.0000000000	0.06941	-0.09681	2	10	0	2	9	0	0.00000	0.00000
80	6072007	Bleeding from anus	90	444470001	Injury of anterior cruciate ligament	1095	4	19	0	4	19	1072	0.00000	-0.00805	0.00000	0.00000	0.00000	1.0000000000	1.0000000000	0.06941	-0.09681	2	10	0	2	9	0	0.00000	0.00000
79	45816000	Pyelonephritis	90	444470001	Injury of anterior cruciate ligament	1095	1	19	0	1	19	1075	0.00000	-0.00402	0.00000	0.00000	0.00000	1.0000000000	1.0000000000	0.01735	-0.02482	1	10	0	0	9	0	0.00000	0.00000
78	239872002	Osteoarthritis of hip	90	444470001	Injury of anterior cruciate ligament	1095	21	19	0	21	19	1055	0.00000	-0.01858	0.00000	0.00000	0.00000	1.0000000000	1.0000000000	0.36438	-0.44825	13	10	0	8	9	0	0.00000	0.00000
77	422034002	Diabetic retinopathy associated with type II diabetes mellitus (disorder)	90	444470001	Injury of anterior cruciate ligament	1095	20	19	1	19	18	1057	2.88158	0.03410	3.09064	24.34985	0.39228	0.2975486779	0.9848726602	0.34703	0.57022	8	10	0	12	9	1	-2.30259	-2.56495
76	127013003	Diabetic renal disease (disorder)	90	444470001	Injury of anterior cruciate ligament	1095	28	19	1	27	18	1049	2.05827	0.02278	2.15844	16.75966	0.27798	0.3912270066	1.0000000000	0.48584	0.42872	10	10	0	18	9	1	-2.30259	-2.94444
75	431855005	Chronic kidney disease stage 1 (disorder)	90	444470001	Injury of anterior cruciate ligament	1095	28	19	1	27	18	1049	2.05827	0.02278	2.15844	16.75966	0.27798	0.3912270066	1.0000000000	0.48584	0.42872	10	10	0	18	9	1	-2.30259	-2.94444
73	196416002	Impacted molars	90	444470001	Injury of anterior cruciate ligament	1095	49	19	0	49	19	1027	0.00000	-0.02876	0.00000	0.00000	0.00000	1.0000000000	1.0000000000	0.85023	-0.88770	25	10	0	24	9	0	0.00000	0.00000
72	35999006	Blighted ovum	90	444470001	Injury of anterior cruciate ligament	1095	53	19	0	53	19	1023	0.00000	-0.02997	0.00000	0.00000	0.00000	1.0000000000	1.0000000000	0.91963	-0.94083	53	10	0	0	9	0	0.00000	0.00000
71	201834006	Localized  primary osteoarthritis of the hand	90	444470001	Injury of anterior cruciate ligament	1095	28	19	0	28	19	1048	0.00000	-0.02153	0.00000	0.00000	0.00000	1.0000000000	1.0000000000	0.48584	-0.57128	19	10	0	9	9	0	0.00000	0.00000
70	87433001	Pulmonary emphysema (disorder)	90	444470001	Injury of anterior cruciate ligament	1095	17	19	1	16	18	1060	3.39009	0.03988	3.68056	29.26435	0.46290	0.2590202242	0.9238844079	0.29498	0.62707	9	10	1	8	9	0	2.39790	2.30259
69	233604007	Pneumonia	90	444470001	Injury of anterior cruciate ligament	1095	7	19	0	7	19	1069	0.00000	-0.01066	0.00000	0.00000	0.00000	1.0000000000	1.0000000000	0.12146	-0.16538	3	10	0	4	9	0	0.00000	0.00000
68	26929004	Alzheimer's disease (disorder)	90	444470001	Injury of anterior cruciate ligament	1095	23	19	0	23	19	1053	0.00000	-0.01946	0.00000	0.00000	0.00000	1.0000000000	1.0000000000	0.39909	-0.48449	15	10	0	8	9	0	0.00000	0.00000
67	403191005	Second degree burn	90	444470001	Injury of anterior cruciate ligament	1095	49	19	1	48	18	1028	1.17615	0.00507	1.18981	9.09900	0.15558	0.5840706772	1.0000000000	0.85023	0.11230	23	10	1	26	9	0	2.39790	3.17805
66	55822004	Hyperlipidemia	90	444470001	Injury of anterior cruciate ligament	1095	119	19	2	117	17	959	0.96860	-0.00146	0.96430	4.22632	0.22002	1.0000000000	1.0000000000	2.06484	-0.03085	64	10	2	55	9	0	1.79176	3.49651
65	239873007	Osteoarthritis of knee	90	444470001	Injury of anterior cruciate ligament	1095	57	19	1	56	18	1020	1.01108	0.00035	1.01190	7.71678	0.13269	1.0000000000	1.0000000000	0.98904	0.00793	30	10	1	27	9	0	2.39790	3.43399
64	444448004	Injury of medial collateral ligament of knee	90	444470001	Injury of anterior cruciate ligament	1095	32	19	0	32	19	1044	0.00000	-0.02306	0.00000	0.00000	0.00000	1.0000000000	1.0000000000	0.55525	-0.63715	17	10	0	15	9	0	0.00000	0.00000
63	68496003	Polyp of colon	90	444470001	Injury of anterior cruciate ligament	1095	91	19	0	91	19	985	0.00000	-0.04001	0.00000	0.00000	0.00000	0.3946580353	1.0000000000	1.57900	-1.36681	43	10	0	48	9	0	0.00000	0.00000
62	185086009	Chronic obstructive bronchitis (disorder)	90	444470001	Injury of anterior cruciate ligament	1095	6	19	0	6	19	1070	0.00000	-0.00986	0.00000	0.00000	0.00000	1.0000000000	1.0000000000	0.10411	-0.14288	4	10	0	2	9	0	0.00000	0.00000
61	198992004	Antepartum eclampsia	90	444470001	Injury of anterior cruciate ligament	1095	96	19	0	96	19	980	0.00000	-0.04119	0.00000	0.00000	0.00000	0.4007139458	1.0000000000	1.66575	-1.41454	96	10	0	0	9	0	0.00000	0.00000
60	301011002	Escherichia coli urinary tract infection	90	444470001	Injury of anterior cruciate ligament	1095	92	19	2	90	17	986	1.25286	0.01018	1.28889	5.66753	0.29311	0.6698893812	1.0000000000	1.59635	0.20848	85	10	2	7	9	0	1.79176	3.77276
59	262574004	Bullet wound	90	444470001	Injury of anterior cruciate ligament	1095	20	19	1	19	18	1057	2.88158	0.03410	3.09064	24.34985	0.39228	0.2975486779	0.9848726602	0.34703	0.57022	9	10	0	11	9	1	-2.30259	-2.48491
58	239720000	Tear of meniscus of knee	90	444470001	Injury of anterior cruciate ligament	1095	20	19	0	20	19	1056	0.00000	-0.01813	0.00000	0.00000	0.00000	1.0000000000	1.0000000000	0.34703	-0.42978	10	10	0	10	9	0	0.00000	0.00000
57	192127007	Child attention deficit disorder	90	444470001	Injury of anterior cruciate ligament	1095	76	19	0	76	19	1000	0.00000	-0.03629	0.00000	0.00000	0.00000	0.6365403962	1.0000000000	1.31872	-1.21333	24	10	0	52	9	0	0.00000	0.00000
56	92691004	Carcinoma in situ of prostate (disorder)	90	444470001	Injury of anterior cruciate ligament	1095	23	19	0	23	19	1053	0.00000	-0.01946	0.00000	0.00000	0.00000	1.0000000000	1.0000000000	0.39909	-0.48449	0	10	0	23	9	0	0.00000	0.00000
55	126906006	Neoplasm of prostate	90	444470001	Injury of anterior cruciate ligament	1095	24	19	0	24	19	1052	0.00000	-0.01989	0.00000	0.00000	0.00000	1.0000000000	1.0000000000	0.41644	-0.50227	0	10	0	24	9	0	0.00000	0.00000
54	5602001	Opioid abuse (disorder)	90	444470001	Injury of anterior cruciate ligament	1095	7	19	0	7	19	1069	0.00000	-0.01066	0.00000	0.00000	0.00000	1.0000000000	1.0000000000	0.12146	-0.16538	0	10	0	7	9	0	0.00000	0.00000
53	7200002	Alcoholism	90	444470001	Injury of anterior cruciate ligament	1095	5	19	0	5	19	1071	0.00000	-0.00900	0.00000	0.00000	0.00000	1.0000000000	1.0000000000	0.08676	-0.12003	0	10	0	5	9	0	0.00000	0.00000
52	124171000119105	Chronic intractable migraine without aura	90	444470001	Injury of anterior cruciate ligament	1095	51	19	1	50	18	1026	1.13003	0.00382	1.14000	8.71121	0.14919	0.5990507842	1.0000000000	0.88493	0.08549	21	10	1	30	9	0	2.39790	3.09104
51	403190006	First degree burn	90	444470001	Injury of anterior cruciate ligament	1095	79	19	1	78	18	998	0.72951	-0.01002	0.71083	5.39509	0.09365	1.0000000000	1.0000000000	1.37078	-0.24536	43	10	0	36	9	1	-2.30259	-3.61092
50	446096008	Perennial allergic rhinitis	90	444470001	Injury of anterior cruciate ligament	1095	26	19	0	26	19	1050	0.00000	-0.02072	0.00000	0.00000	0.00000	1.0000000000	1.0000000000	0.45114	-0.53719	14	10	0	12	9	0	0.00000	0.00000
49	88805009	Chronic congestive heart failure (disorder)	90	444470001	Injury of anterior cruciate ligament	1095	10	19	0	10	19	1066	0.00000	-0.01276	0.00000	0.00000	0.00000	1.0000000000	1.0000000000	0.17352	-0.23084	5	10	0	5	9	0	0.00000	0.00000
48	55680006	Drug overdose	90	444470001	Injury of anterior cruciate ligament	1095	50	19	0	50	19	1026	0.00000	-0.02907	0.00000	0.00000	0.00000	1.0000000000	1.0000000000	0.86758	-0.90117	24	10	0	26	9	0	0.00000	0.00000
47	359817006	Closed fracture of hip	90	444470001	Injury of anterior cruciate ligament	1095	29	19	0	29	19	1047	0.00000	-0.02192	0.00000	0.00000	0.00000	1.0000000000	1.0000000000	0.50320	-0.58803	11	10	0	18	9	0	0.00000	0.00000
46	62564004	Concussion with loss of consciousness	90	444470001	Injury of anterior cruciate ligament	1095	67	19	2	65	17	1011	1.72035	0.02444	1.82986	8.09070	0.41386	0.3259174278	1.0000000000	1.16256	0.47222	36	10	1	31	9	1	0.09531	0.14518
45	263102004	Fracture subluxation of wrist	90	444470001	Injury of anterior cruciate ligament	1095	109	19	2	107	17	969	1.05746	0.00254	1.06542	4.67428	0.24284	1.0000000000	1.0000000000	1.89132	0.05323	51	10	1	58	9	1	0.09531	-0.12629
44	58150001	Fracture of clavicle	90	444470001	Injury of anterior cruciate ligament	1095	112	19	2	110	17	966	1.02914	0.00131	1.03316	4.53124	0.23557	1.0000000000	1.0000000000	1.94338	0.02749	55	10	1	57	9	1	0.09531	-0.03509
43	307731004	Injury of tendon of the rotator cuff of shoulder	90	444470001	Injury of anterior cruciate ligament	1095	51	19	1	50	18	1026	1.13003	0.00382	1.14000	8.71121	0.14919	0.5990507842	1.0000000000	0.88493	0.08549	26	10	1	25	9	0	2.39790	3.29584
42	16114001	Fracture of ankle	90	444470001	Injury of anterior cruciate ligament	1095	108	19	1	107	18	969	0.53363	-0.02050	0.50312	3.80613	0.06650	1.0000000000	1.0000000000	1.87397	-0.52305	48	10	0	60	9	1	-2.30259	-4.11087
41	283385000	Laceration of thigh	90	444470001	Injury of anterior cruciate ligament	1095	105	19	4	101	15	975	2.19549	0.05174	2.57426	7.90395	0.83842	0.1004687404	0.6275578005	1.82192	0.82525	50	10	0	55	9	4	-1.17865	-2.69124
40	428251008	History of appendectomy	90	444470001	Injury of anterior cruciate ligament	1095	51	19	0	51	19	1025	0.00000	-0.02937	0.00000	0.00000	0.00000	1.0000000000	1.0000000000	0.88493	-0.91451	27	10	0	24	9	0	0.00000	0.00000
39	74400008	Appendicitis	90	444470001	Injury of anterior cruciate ligament	1095	51	19	0	51	19	1025	0.00000	-0.02937	0.00000	0.00000	0.00000	1.0000000000	1.0000000000	0.88493	-0.91451	27	10	0	24	9	0	0.00000	0.00000
38	398254007	Preeclampsia	90	444470001	Injury of anterior cruciate ligament	1095	101	19	2	99	17	977	1.14122	0.00598	1.16102	5.09865	0.26438	0.6923023141	1.0000000000	1.75251	0.12421	101	10	2	0	9	0	1.79176	3.94158
37	38822007	Cystitis	90	444470001	Injury of anterior cruciate ligament	1095	71	19	2	69	17	1007	1.62342	0.02181	1.71697	7.58281	0.38877	0.3521628376	1.0000000000	1.23196	0.42665	68	10	2	3	9	0	1.79176	3.55535
36	156073000	Fetus with unknown complication	90	444470001	Injury of anterior cruciate ligament	1095	125	19	3	122	16	954	1.38316	0.01828	1.46619	5.10439	0.42115	0.4695519430	1.0000000000	2.16895	0.33600	125	10	3	0	9	0	1.46634	3.75342
35	19169002	Miscarriage in first trimester	90	444470001	Injury of anterior cruciate ligament	1095	174	19	3	171	16	905	0.99365	-0.00037	0.99232	3.44249	0.28604	1.0000000000	1.0000000000	3.01918	-0.00690	174	10	3	0	9	0	1.46634	4.07754
33	429007001	History of cardiac arrest (situation)	90	444470001	Injury of anterior cruciate ligament	1095	42	19	1	41	18	1035	1.37218	0.00988	1.40244	10.76101	0.18277	0.5273559657	1.0000000000	0.72877	0.21026	24	10	1	18	9	0	2.39790	3.21888
32	410429000	Cardiac Arrest	90	444470001	Injury of anterior cruciate ligament	1095	42	19	1	41	18	1035	1.37218	0.00988	1.40244	10.76101	0.18277	0.5273559657	1.0000000000	0.72877	0.21026	24	10	1	18	9	0	2.39790	3.21888
31	230690007	Stroke	90	444470001	Injury of anterior cruciate ligament	1095	62	19	2	60	17	1016	1.85908	0.02797	1.99216	8.82281	0.44982	0.2928818380	0.9786512274	1.07580	0.53130	32	10	1	30	9	1	0.09531	0.06252
30	399211009	History of myocardial infarction (situation)	90	444470001	Injury of anterior cruciate ligament	1095	31	19	0	31	19	1045	0.00000	-0.02268	0.00000	0.00000	0.00000	1.0000000000	1.0000000000	0.53790	-0.62096	2	10	0	29	9	0	0.00000	0.00000
29	22298006	Myocardial Infarction	90	444470001	Injury of anterior cruciate ligament	1095	31	19	0	31	19	1045	0.00000	-0.02268	0.00000	0.00000	0.00000	1.0000000000	1.0000000000	0.53790	-0.62096	2	10	0	29	9	0	0.00000	0.00000
28	53741008	Coronary Heart Disease	90	444470001	Injury of anterior cruciate ligament	1095	80	19	0	80	19	996	0.00000	-0.03731	0.00000	0.00000	0.00000	0.3899891649	1.0000000000	1.38813	-1.25588	24	10	0	56	9	0	0.00000	0.00000
27	408512008	Body mass index 40+ - severely obese (finding)	90	444470001	Injury of anterior cruciate ligament	1095	97	19	2	95	17	981	1.18828	0.00780	1.21486	5.33800	0.27649	0.6821366009	1.0000000000	1.68311	0.16106	67	10	2	30	9	0	1.79176	3.54096
26	33737001	Fracture of rib	90	444470001	Injury of anterior cruciate ligament	1095	54	19	0	54	19	1022	0.00000	-0.03027	0.00000	0.00000	0.00000	0.6194532431	1.0000000000	0.93699	-0.95381	32	10	0	22	9	0	0.00000	0.00000
25	284551006	Laceration of foot	90	444470001	Injury of anterior cruciate ligament	1095	118	19	2	116	17	960	0.97681	-0.00107	0.97363	4.26760	0.22213	1.0000000000	1.0000000000	2.04749	-0.02266	53	10	0	65	9	2	-1.70475	-3.51155
24	162864005	Body mass index 30+ - obesity (finding)	90	444470001	Injury of anterior cruciate ligament	1095	439	19	13	426	6	650	1.70663	0.07681	3.30595	8.76482	1.24695	0.0162515716	0.2173568050	7.61735	0.70011	226	10	6	213	9	7	0.15415	0.20726
23	36971009	Sinusitis (disorder)	90	444470001	Injury of anterior cruciate ligament	1095	190	19	2	188	17	888	0.60665	-0.02395	0.55569	2.42553	0.12731	0.5549397077	1.0000000000	3.29680	-0.51830	84	10	2	106	9	0	1.79176	3.76120
22	70704007	Sprain of wrist	90	444470001	Injury of anterior cruciate ligament	1095	195	19	2	193	17	883	0.59109	-0.02529	0.53825	2.34899	0.12334	0.5532915297	1.0000000000	3.38356	-0.54714	90	10	0	105	9	2	-1.70475	-3.97968
21	15777000	Prediabetes	90	444470001	Injury of anterior cruciate ligament	1095	333	19	8	325	11	751	1.38454	0.03378	1.68056	4.21688	0.66976	0.3140234499	1.0000000000	5.77808	0.40905	159	10	4	174	9	4	0.07411	-0.08803
20	80394007	Hyperglycemia (disorder)	90	444470001	Injury of anterior cruciate ligament	1095	55	19	1	54	18	1022	1.04785	0.00146	1.05144	8.02328	0.13779	1.0000000000	1.0000000000	0.95434	0.03332	23	10	0	32	9	1	-2.30259	-3.49651
19	237602007	Metabolic syndrome X (disorder)	90	444470001	Injury of anterior cruciate ligament	1095	64	19	1	63	18	1013	0.90049	-0.00329	0.89330	6.79956	0.11736	1.0000000000	1.0000000000	1.11050	-0.07759	28	10	0	36	9	1	-2.30259	-3.61092
18	302870006	Hypertriglyceridemia (disorder)	90	444470001	Injury of anterior cruciate ligament	1095	64	19	1	63	18	1013	0.90049	-0.00329	0.89330	6.79956	0.11736	1.0000000000	1.0000000000	1.11050	-0.07759	28	10	0	36	9	1	-2.30259	-3.61092
17	368581000119106	Neuropathy due to type 2 diabetes mellitus (disorder)	90	444470001	Injury of anterior cruciate ligament	1095	28	19	1	27	18	1049	2.05827	0.02278	2.15844	16.75966	0.27798	0.3912270066	1.0000000000	0.48584	0.42872	7	10	0	21	9	1	-2.30259	-3.09104
16	44054006	Diabetes	90	444470001	Injury of anterior cruciate ligament	1095	68	19	1	67	18	1009	0.84752	-0.00521	0.83665	6.36268	0.11001	1.0000000000	1.0000000000	1.17991	-0.12427	29	10	0	39	9	1	-2.30259	-3.68888
15	40055000	Chronic sinusitis (disorder)	90	444470001	Injury of anterior cruciate ligament	1095	216	19	5	211	14	865	1.33406	0.02201	1.46412	4.10991	0.52158	0.5582743429	1.0000000000	3.74795	0.33766	104	10	4	112	9	1	-1.04982	-1.43155
14	10509002	Acute bronchitis (disorder)	90	444470001	Injury of anterior cruciate ligament	1095	863	19	18	845	1	231	1.20205	0.05178	4.92071	37.05406	0.65346	0.0956128162	0.6155535021	14.97443	0.25024	418	10	9	445	9	9	0.05407	-0.06131
13	370247008	Facial laceration	90	444470001	Injury of anterior cruciate ligament	1095	109	19	2	107	17	969	1.05746	0.00254	1.06542	4.67428	0.24284	1.0000000000	1.0000000000	1.89132	0.05323	55	10	1	54	9	1	0.09531	0.01802
12	65966004	Fracture of forearm	90	444470001	Injury of anterior cruciate ligament	1095	123	19	3	120	16	956	1.40565	0.01918	1.49375	5.20142	0.42898	0.4634623922	1.0000000000	2.13425	0.35188	55	10	1	68	9	2	0.69315	0.47000
11	38341003	Hypertension	90	444470001	Injury of anterior cruciate ligament	1095	278	19	6	272	13	804	1.24385	0.01890	1.36425	3.62432	0.51353	0.5946699438	1.0000000000	4.82374	0.26541	131	10	1	147	9	5	1.36828	1.46836
10	62106007	Concussion with no loss of consciousness	90	444470001	Injury of anterior cruciate ligament	1095	206	19	3	203	16	873	0.83929	-0.01028	0.80634	2.79349	0.23275	1.0000000000	1.0000000000	3.57443	-0.19359	96	10	3	110	9	0	1.46634	3.49651
9	44465007	Sprain of ankle	90	444470001	Injury of anterior cruciate ligament	1095	362	19	7	355	12	721	1.11442	0.01069	1.18474	3.03526	0.46244	0.8064217289	1.0000000000	6.28128	0.13581	185	10	5	177	9	2	-0.60614	-0.85665
8	233678006	Childhood asthma	90	444470001	Injury of anterior cruciate ligament	1095	45	19	0	45	19	1031	0.00000	-0.02751	0.00000	0.00000	0.00000	1.0000000000	1.0000000000	0.78082	-0.83254	25	10	0	20	9	0	0.00000	0.00000
7	75498004	Acute bacterial sinusitis (disorder)	90	444470001	Injury of anterior cruciate ligament	1095	187	19	4	183	15	893	1.23276	0.01404	1.30128	3.96572	0.42699	0.5499987704	1.0000000000	3.24475	0.23625	89	10	3	98	9	1	-0.83625	-1.17194
6	39848009	Whiplash injury to neck	90	444470001	Injury of anterior cruciate ligament	1095	182	19	1	181	18	895	0.31666	-0.04054	0.27471	2.07084	0.03644	0.3447367751	1.0000000000	3.15799	-1.05589	92	10	0	90	9	1	-2.30259	-4.51086
5	284549007	Laceration of hand	90	444470001	Injury of anterior cruciate ligament	1095	104	19	3	101	16	975	1.66245	0.02852	1.81002	6.31775	0.51857	0.4146367669	1.0000000000	1.80457	0.51222	54	10	2	50	9	1	-0.51083	-0.59962
4	195662009	Acute viral pharyngitis (disorder)	90	444470001	Injury of anterior cruciate ligament	1095	890	19	15	875	4	201	0.97132	-0.00794	0.86143	2.62315	0.28289	0.7677890279	1.0000000000	15.44292	-0.03939	430	10	7	460	9	8	0.13353	0.06500
3	65363002	Otitis media	90	444470001	Injury of anterior cruciate ligament	1095	580	19	9	571	10	505	0.89428	-0.01491	0.79597	1.97442	0.32089	0.6498038431	1.0000000000	10.06393	-0.14586	277	10	4	303	9	5	0.22314	0.13140
2	43878008	Streptococcal sore throat (disorder)	90	444470001	Injury of anterior cruciate ligament	1095	523	19	11	512	8	564	1.21214	0.02695	1.51465	3.79516	0.60450	0.4882862782	1.0000000000	9.07489	0.25227	246	10	6	277	9	5	-0.04879	-0.29480
1	444814009	Viral sinusitis (disorder)	90	444470001	Injury of anterior cruciate ligament	1095	993	19	19	974	0	102	1.10272	0.04259	0.00000	0.00000	0.00000	0.2458900444	0.9133257124	17.23014	0.13367	478	10	10	515	9	9	0.00000	-0.17654
96	283371005	Laceration of forearm	64	444448004	Injury of medial collateral ligament of knee	1095	75	32	4	71	28	992	1.82500	0.03881	1.99598	5.84796	0.68125	0.2704256284	0.9408625312	2.19178	0.64757	39	17	2	36	15	2	0.11123	0.07599
94	703151001	History of single seizure (situation)	64	444448004	Injury of medial collateral ligament of knee	1095	39	32	0	39	32	1024	0.00000	-0.03334	0.00000	0.00000	0.00000	0.6249631818	1.0000000000	1.13973	-1.09743	14	17	0	25	15	0	0.00000	0.00000
86	713197008	Recurrent rectal polyp	64	444448004	Injury of medial collateral ligament of knee	1095	22	32	3	19	29	1044	4.66619	0.09108	5.68421	20.28779	1.59260	0.0239399824	0.2839799539	0.64292	1.28374	12	17	2	10	15	1	-0.52130	-0.45199
75	431855005	Chronic kidney disease stage 1 (disorder)	64	444448004	Injury of medial collateral ligament of knee	1095	28	32	3	25	29	1038	3.66629	0.07494	4.29517	15.03849	1.22675	0.0452227229	0.4084765375	0.81826	1.13744	10	17	2	18	15	1	-0.52130	-1.15268
44	58150001	Fracture of clavicle	64	444448004	Injury of medial collateral ligament of knee	1095	112	32	2	110	30	953	0.61105	-0.02278	0.57758	2.44975	0.13617	0.7646473566	1.0000000000	3.27306	-0.51031	55	17	2	57	15	0	2.25129	3.34990
43	307731004	Injury of tendon of the rotator cuff of shoulder	64	444448004	Injury of medial collateral ligament of knee	1095	51	32	2	49	30	1014	1.34191	0.01311	1.37959	5.93918	0.32046	0.6576488290	1.0000000000	1.49041	0.26858	26	17	0	25	15	2	-2.14007	-2.60269
42	16114001	Fracture of ankle	64	444448004	Injury of medial collateral ligament of knee	1095	108	32	4	104	28	959	1.26736	0.01534	1.31731	3.82898	0.45320	0.5477268823	1.0000000000	3.15616	0.26668	48	17	3	60	15	1	-0.87547	-1.27766
41	283385000	Laceration of thigh	64	444448004	Injury of medial collateral ligament of knee	1095	105	32	4	101	28	962	1.30357	0.01715	1.36068	3.95705	0.46789	0.5389572670	1.0000000000	3.06849	0.29743	50	17	2	55	15	2	0.11123	-0.09181
33	429007001	History of cardiac arrest (situation)	64	444448004	Injury of medial collateral ligament of knee	1095	42	32	0	42	32	1021	0.00000	-0.03465	0.00000	0.00000	0.00000	0.6306815061	1.0000000000	1.22740	-1.15536	24	17	0	18	15	0	0.00000	0.00000
32	410429000	Cardiac Arrest	64	444448004	Injury of medial collateral ligament of knee	1095	42	32	0	42	32	1021	0.00000	-0.03465	0.00000	0.00000	0.00000	0.6306815061	1.0000000000	1.22740	-1.15536	24	17	0	18	15	0	0.00000	0.00000
27	408512008	Body mass index 40+ - severely obese (finding)	64	444448004	Injury of medial collateral ligament of knee	1095	97	32	5	92	27	971	1.76385	0.04132	1.95451	5.19676	0.73509	0.1951080774	0.8340316782	2.83470	0.64585	67	17	3	30	15	2	-0.24295	0.37729
21	15777000	Prediabetes	64	444448004	Injury of medial collateral ligament of knee	1095	333	32	11	322	21	741	1.13035	0.01495	1.20541	2.52931	0.57447	0.6967346563	1.0000000000	9.73151	0.16118	159	17	8	174	15	3	-0.65233	-1.03899
15	40055000	Chronic sinusitis (disorder)	64	444448004	Injury of medial collateral ligament of knee	1095	216	32	5	211	27	852	0.79210	-0.01788	0.74776	1.96481	0.28458	0.6578143997	1.0000000000	6.31233	-0.28537	104	17	2	112	15	3	0.45953	0.32397
14	10509002	Acute bronchitis (disorder)	64	444448004	Injury of medial collateral ligament of knee	1095	863	32	27	836	5	227	1.07058	0.02362	1.46627	3.85036	0.55837	0.5171407580	1.0000000000	25.22009	0.09475	418	17	14	445	15	13	0.02767	-0.13255
125	1734006	Fracture of the vertebral column with spinal cord injury	38	398254007	Preeclampsia	1095	5	101	0	5	101	989	0.00000	-0.02159	0.00000	0.00000	0.00000	1.0000000000	1.0000000000	0.46119	-0.54714	3	101	0	2	0	0	0.00000	0.00000
118	48333001	Burn injury(morphologic abnormality)	38	398254007	Preeclampsia	1095	1	101	0	1	101	993	0.00000	-0.00964	0.00000	0.00000	0.00000	1.0000000000	1.0000000000	0.09224	-0.12729	0	101	0	1	0	0	0.00000	0.00000
96	283371005	Laceration of forearm	38	398254007	Preeclampsia	1095	75	101	8	67	93	927	1.15644	0.01352	1.19018	2.55391	0.55465	0.6776509114	1.0000000000	6.91781	0.18482	39	101	8	36	0	0	2.61191	1.77071
94	703151001	History of single seizure (situation)	38	398254007	Preeclampsia	1095	39	101	3	36	98	958	0.83397	-0.01017	0.81463	2.69384	0.24635	1.0000000000	1.0000000000	3.59726	-0.20077	14	101	3	25	0	0	3.54578	1.73460
86	713197008	Recurrent rectal polyp	38	398254007	Preeclampsia	1095	22	101	2	20	99	974	0.98560	-0.00066	0.98384	4.27117	0.22662	1.0000000000	1.0000000000	2.02922	-0.01399	12	101	2	10	0	0	3.94158	1.94591
75	431855005	Chronic kidney disease stage 1 (disorder)	38	398254007	Preeclampsia	1095	28	101	4	24	97	970	1.54880	0.02834	1.66667	4.90233	0.56662	0.3182638415	1.0000000000	2.58265	0.48090	10	101	4	18	0	0	3.26767	1.25276
64	444448004	Injury of medial collateral ligament of knee	38	398254007	Preeclampsia	1095	32	101	2	30	99	964	0.67760	-0.01783	0.64916	2.75701	0.15285	0.7612633452	1.0000000000	2.95160	-0.39747	17	101	2	15	0	0	3.94158	2.25129
44	58150001	Fracture of clavicle	38	398254007	Preeclampsia	1095	112	101	13	99	88	895	1.25840	0.02780	1.33551	2.47831	0.71968	0.3870056996	1.0000000000	10.33059	0.30520	55	101	13	57	0	0	2.17125	1.65456
43	307731004	Injury of tendon of the rotator cuff of shoulder	38	398254007	Preeclampsia	1095	51	101	2	49	99	945	0.42516	-0.04050	0.38961	1.62641	0.09333	0.2219004422	0.8794911525	4.70411	-0.92704	26	101	2	25	0	0	3.94158	2.63906
42	16114001	Fracture of ankle	38	398254007	Preeclampsia	1095	108	101	11	97	90	897	1.10424	0.01099	1.13024	2.18710	0.58408	0.7255927048	1.0000000000	9.96164	0.13057	48	101	11	60	0	0	2.32060	1.67964
41	283385000	Laceration of thigh	38	398254007	Preeclampsia	1095	105	101	13	92	88	902	1.34229	0.03553	1.44837	2.69407	0.77866	0.2845930460	0.9659403678	9.68493	0.38985	50	101	13	55	0	0	2.17125	1.57819
35	19169002	Miscarriage in first trimester	38	398254007	Preeclampsia	1095	174	101	55	119	46	875	3.42694	0.33626	8.79156	13.59514	5.68523	0.0000000000	0.0000000000	16.04932	1.71571	174	101	55	0	0	0	1.04252	1.42639
33	429007001	History of cardiac arrest (situation)	38	398254007	Preeclampsia	1095	42	101	7	35	94	959	1.80693	0.05137	2.04043	4.72021	0.88202	0.0995724003	0.6255159994	3.87397	0.71490	24	101	7	18	0	0	2.73622	1.48808
32	410429000	Cardiac Arrest	38	398254007	Preeclampsia	1095	42	101	7	35	94	959	1.80693	0.05137	2.04043	4.72021	0.88202	0.0995724003	0.6255159994	3.87397	0.71490	24	101	7	18	0	0	2.73622	1.48808
27	408512008	Body mass index 40+ - severely obese (finding)	38	398254007	Preeclampsia	1095	97	101	18	79	83	915	2.01184	0.10055	2.51182	4.39314	1.43616	0.0025773926	0.0531088071	8.94703	0.93366	67	101	18	30	0	0	1.88875	1.55228
21	15777000	Prediabetes	38	398254007	Preeclampsia	1095	333	101	47	286	54	708	1.53019	0.11172	2.15462	3.26095	1.42364	0.0003857130	0.0112484662	30.71507	0.59787	159	101	47	174	0	0	1.14706	1.47773
132	69896004	Rheumatoid arthritis	12	65966004	Fracture of forearm	1095	3	123	1	2	122	970	2.96748	0.03668	3.97541	44.16616	0.35783	0.3007932279	0.9911272351	0.33699	0.58102	2	55	1	1	68	0	4.02535	1.09861
131	93761005	Primary malignant neoplasm of colon	12	65966004	Fracture of forearm	1095	5	123	0	5	123	967	0.00000	-0.02409	0.00000	0.00000	0.00000	1.0000000000	1.0000000000	0.56164	-0.64307	3	55	0	2	68	0	0.00000	0.00000
130	314994000	Metastasis from malignant tumor of prostate (disorder)	12	65966004	Fracture of forearm	1095	1	123	0	1	123	971	0.00000	-0.01076	0.00000	0.00000	0.00000	1.0000000000	1.0000000000	0.11233	-0.15358	0	55	0	1	68	0	0.00000	0.00000
129	47505003	Posttraumatic stress disorder	12	65966004	Fracture of forearm	1095	4	123	0	4	123	968	0.00000	-0.02154	0.00000	0.00000	0.00000	1.0000000000	1.0000000000	0.44932	-0.53537	1	55	0	3	68	0	0.00000	0.00000
15	40055000	Chronic sinusitis (disorder)	38	398254007	Preeclampsia	1095	216	101	25	191	76	803	1.25481	0.04026	1.38296	2.23193	0.85691	0.1898920601	0.8236596920	19.92329	0.31340	104	101	25	112	0	0	1.61741	1.64094
14	10509002	Acute bronchitis (disorder)	38	398254007	Preeclampsia	1095	863	101	92	771	9	223	1.15577	0.09576	2.95662	5.95728	1.46738	0.0008321869	0.0214221006	79.60091	0.20643	418	101	92	445	0	0	0.74090	1.71262
126	698754002	Chronic paralysis due to lesion of spinal cord	12	65966004	Fracture of forearm	1095	2	123	0	2	123	970	0.00000	-0.01522	0.00000	0.00000	0.00000	1.0000000000	1.0000000000	0.22466	-0.29238	2	55	0	0	68	0	0.00000	0.00000
125	1734006	Fracture of the vertebral column with spinal cord injury	12	65966004	Fracture of forearm	1095	5	123	2	3	121	969	3.56098	0.06170	5.33884	32.27063	0.88326	0.0997504169	0.6255159994	0.56164	0.94190	3	55	0	2	68	2	-3.55535	-0.69315
124	1501000119109	Proliferative diabetic retinopathy due to type II diabetes mellitus (disorder)	12	65966004	Fracture of forearm	1095	1	123	0	1	123	971	0.00000	-0.01076	0.00000	0.00000	0.00000	1.0000000000	1.0000000000	0.11233	-0.15358	1	55	0	0	68	0	0.00000	0.00000
123	195967001	Asthma	12	65966004	Fracture of forearm	1095	2	123	1	1	122	971	4.45122	0.05252	7.95902	128.06048	0.49466	0.2121309258	0.8671354646	0.22466	0.70762	1	55	1	1	68	0	4.02535	0.69315
121	254637007	Non-small cell lung cancer (disorder)	12	65966004	Fracture of forearm	1095	8	123	1	7	122	965	1.11280	0.00344	1.12998	9.26215	0.13786	1.0000000000	1.0000000000	0.89863	0.07504	0	55	0	8	68	1	-4.23411	-2.19722
120	162573006	Suspected lung cancer (situation)	12	65966004	Fracture of forearm	1095	8	123	1	7	122	965	1.11280	0.00344	1.12998	9.26215	0.13786	1.0000000000	1.0000000000	0.89863	0.07504	0	55	0	8	68	1	-4.23411	-2.19722
119	275272006	Brain damage - traumatic	12	65966004	Fracture of forearm	1095	4	123	0	4	123	968	0.00000	-0.02154	0.00000	0.00000	0.00000	1.0000000000	1.0000000000	0.44932	-0.53537	0	55	0	4	68	0	0.00000	0.00000
118	48333001	Burn injury(morphologic abnormality)	12	65966004	Fracture of forearm	1095	1	123	0	1	123	971	0.00000	-0.01076	0.00000	0.00000	0.00000	1.0000000000	1.0000000000	0.11233	-0.15358	0	55	0	1	68	0	0.00000	0.00000
117	230265002	Familial Alzheimer's disease of early onset (disorder)	12	65966004	Fracture of forearm	1095	6	123	0	6	123	966	0.00000	-0.02640	0.00000	0.00000	0.00000	1.0000000000	1.0000000000	0.67397	-0.74328	2	55	0	4	68	0	0.00000	0.00000
116	370143000	Major depression disorder	12	65966004	Fracture of forearm	1095	8	123	0	8	123	964	0.00000	-0.03052	0.00000	0.00000	0.00000	0.6081924529	1.0000000000	0.89863	-0.92496	3	55	0	5	68	0	0.00000	0.00000
115	36923009	Major depression  single episode	12	65966004	Fracture of forearm	1095	6	123	0	6	123	966	0.00000	-0.02640	0.00000	0.00000	0.00000	1.0000000000	1.0000000000	0.67397	-0.74328	3	55	0	3	68	0	0.00000	0.00000
114	449868002	Smokes tobacco daily	12	65966004	Fracture of forearm	1095	9	123	1	8	122	964	0.98916	-0.00035	0.98770	7.96456	0.12249	1.0000000000	1.0000000000	1.01096	-0.00788	2	55	0	7	68	1	-4.23411	-2.07944
113	443165006	Pathological fracture due to osteoporosis (disorder)	12	65966004	Fracture of forearm	1095	10	123	4	6	119	966	3.56098	0.08746	5.41176	19.45253	1.50557	0.0185932116	0.2372255983	1.12329	1.23563	7	55	2	3	68	2	-0.20544	0.58779
112	49436004	Atrial Fibrillation	12	65966004	Fracture of forearm	1095	35	123	5	30	118	942	1.27178	0.01757	1.33051	3.49547	0.50644	0.5825210213	1.0000000000	3.93151	0.28293	9	55	2	26	68	3	0.18584	-0.56394
111	235919008	Cholelithiasis	12	65966004	Fracture of forearm	1095	9	123	0	9	123	963	0.00000	-0.03238	0.00000	0.00000	0.00000	0.6086880696	1.0000000000	1.01096	-1.00788	7	55	0	2	68	0	0.00000	0.00000
110	65275009	Acute Cholecystitis	12	65966004	Fracture of forearm	1095	9	123	0	9	123	963	0.00000	-0.03238	0.00000	0.00000	0.00000	0.6086880696	1.0000000000	1.01096	-1.00788	7	55	0	2	68	0	0.00000	0.00000
109	90560007	Gout	12	65966004	Fracture of forearm	1095	4	123	0	4	123	968	0.00000	-0.02154	0.00000	0.00000	0.00000	1.0000000000	1.0000000000	0.44932	-0.53537	0	55	0	4	68	0	0.00000	0.00000
108	40930008	Hypothyroidism (disorder)	12	65966004	Fracture of forearm	1095	13	123	1	12	122	960	0.68480	-0.01229	0.65574	5.08697	0.08453	1.0000000000	1.0000000000	1.46027	-0.29882	11	55	1	2	68	0	4.02535	2.48491
107	40275004	Contact dermatitis	12	65966004	Fracture of forearm	1095	18	123	4	14	119	958	1.97832	0.04499	2.30012	7.10195	0.74494	0.1340355065	0.7192732770	2.02192	0.72646	9	55	1	9	68	3	0.86128	0.91629
106	24079001	Atopic dermatitis	12	65966004	Fracture of forearm	1095	20	123	1	19	122	953	0.44512	-0.02692	0.41113	3.09829	0.05456	0.7170158247	1.0000000000	2.24658	-0.69892	13	55	1	7	68	0	4.02535	2.63906
105	363406005	Malignant tumor of colon	12	65966004	Fracture of forearm	1095	6	123	0	6	123	966	0.00000	-0.02640	0.00000	0.00000	0.00000	1.0000000000	1.0000000000	0.67397	-0.74328	4	55	0	2	68	0	0.00000	0.00000
104	367498001	Seasonal allergic rhinitis	12	65966004	Fracture of forearm	1095	20	123	1	19	122	953	0.44512	-0.02692	0.41113	3.09829	0.05456	0.7170158247	1.0000000000	2.24658	-0.69892	9	55	0	11	68	1	-4.23411	-2.48491
102	90781000119102	Microalbuminuria due to type 2 diabetes mellitus (disorder)	12	65966004	Fracture of forearm	1095	6	123	1	5	122	967	1.48374	0.01277	1.58525	13.68113	0.18368	0.5116205881	1.0000000000	0.67397	0.25672	3	55	0	3	68	1	-4.23411	-1.38629
101	433144002	Chronic kidney disease stage 3 (disorder)	12	65966004	Fracture of forearm	1095	3	123	1	2	122	970	2.96748	0.03668	3.97541	44.16616	0.35783	0.3007932279	0.9911272351	0.33699	0.58102	1	55	0	2	68	1	-4.23411	-1.09861
100	161622006	History of lower limb amputation (situation)	12	65966004	Fracture of forearm	1095	1	123	0	1	123	971	0.00000	-0.01076	0.00000	0.00000	0.00000	1.0000000000	1.0000000000	0.11233	-0.15358	0	55	0	1	68	0	0.00000	0.00000
99	30832001	Rupture of patellar tendon	12	65966004	Fracture of forearm	1095	23	123	6	17	117	955	2.32238	0.06890	2.88084	7.45126	1.11381	0.0359245069	0.3569070239	2.58356	0.96596	14	55	2	9	68	4	0.45953	0.90079
98	1551000119108	Nonproliferative diabetic retinopathy due to type 2 diabetes mellitus (disorder)	12	65966004	Fracture of forearm	1095	12	123	2	10	121	962	1.48374	0.01811	1.59008	7.34262	0.34434	0.6352029035	1.0000000000	1.34795	0.35356	7	55	0	5	68	2	-3.55535	-1.25276
97	403192003	Third degree burn	12	65966004	Fracture of forearm	1095	8	123	1	7	122	965	1.11280	0.00344	1.12998	9.26215	0.13786	1.0000000000	1.0000000000	0.89863	0.07504	3	55	0	5	68	1	-4.23411	-1.79176
96	283371005	Laceration of forearm	12	65966004	Fracture of forearm	1095	75	123	4	71	119	901	0.47480	-0.05066	0.42656	1.18909	0.15302	0.1266519437	0.6972941899	8.42466	-0.91451	39	55	1	36	68	3	0.86128	1.12393
95	84757009	Epilepsy	12	65966004	Fracture of forearm	1095	30	123	2	28	121	944	0.59350	-0.02427	0.55726	2.36850	0.13111	0.5668879608	1.0000000000	3.36986	-0.54263	13	55	0	17	68	2	-3.55535	-2.25129
94	703151001	History of single seizure (situation)	12	65966004	Fracture of forearm	1095	39	123	3	36	120	936	0.68480	-0.02155	0.65000	2.14308	0.19715	0.6119350424	1.0000000000	4.38082	-0.42783	14	55	0	25	68	3	-3.16407	-2.23359
93	128613002	Seizure disorder	12	65966004	Fracture of forearm	1095	39	123	3	36	120	936	0.68480	-0.02155	0.65000	2.14308	0.19715	0.6119350424	1.0000000000	4.38082	-0.42783	14	55	0	25	68	3	-3.16407	-2.23359
91	64859006	Osteoporosis (disorder)	12	65966004	Fracture of forearm	1095	37	123	7	30	116	942	1.68425	0.04552	1.89483	4.41111	0.81394	0.1771931708	0.8029498763	4.15616	0.63370	24	55	4	13	68	3	-0.47282	0.27193
89	47693006	Rupture of appendix	12	65966004	Fracture of forearm	1095	20	123	1	19	122	953	0.44512	-0.02692	0.41113	3.09829	0.05456	0.7170158247	1.0000000000	2.24658	-0.69892	10	55	1	10	68	0	4.02535	2.39790
88	197927001	Recurrent urinary tract infection	12	65966004	Fracture of forearm	1095	8	123	0	8	123	964	0.00000	-0.03052	0.00000	0.00000	0.00000	0.6081924529	1.0000000000	0.89863	-0.92496	8	55	0	0	68	0	0.00000	0.00000
86	713197008	Recurrent rectal polyp	12	65966004	Fracture of forearm	1095	22	123	2	20	121	952	0.80931	-0.00971	0.78678	3.40756	0.18166	1.0000000000	1.0000000000	2.47123	-0.21049	12	55	1	10	68	1	-0.20875	0.16705
85	241929008	Acute allergic reaction	12	65966004	Fracture of forearm	1095	47	123	3	44	120	928	0.56824	-0.03253	0.52727	1.72434	0.16123	0.3523182451	1.0000000000	5.27945	-0.65064	25	55	1	22	68	2	0.47000	0.77319
83	110030002	Concussion injury of brain	12	65966004	Fracture of forearm	1095	7	123	0	7	123	965	0.00000	-0.02853	0.00000	0.00000	0.00000	1.0000000000	1.0000000000	0.78630	-0.83698	1	55	0	6	68	0	0.00000	0.00000
82	94260004	Secondary malignant neoplasm of colon	12	65966004	Fracture of forearm	1095	4	123	0	4	123	968	0.00000	-0.02154	0.00000	0.00000	0.00000	1.0000000000	1.0000000000	0.44932	-0.53537	2	55	0	2	68	0	0.00000	0.00000
81	236077008	Protracted diarrhea	12	65966004	Fracture of forearm	1095	4	123	0	4	123	968	0.00000	-0.02154	0.00000	0.00000	0.00000	1.0000000000	1.0000000000	0.44932	-0.53537	2	55	0	2	68	0	0.00000	0.00000
80	6072007	Bleeding from anus	12	65966004	Fracture of forearm	1095	4	123	0	4	123	968	0.00000	-0.02154	0.00000	0.00000	0.00000	1.0000000000	1.0000000000	0.44932	-0.53537	2	55	0	2	68	0	0.00000	0.00000
79	45816000	Pyelonephritis	12	65966004	Fracture of forearm	1095	1	123	0	1	123	971	0.00000	-0.01076	0.00000	0.00000	0.00000	1.0000000000	1.0000000000	0.11233	-0.15358	1	55	0	0	68	0	0.00000	0.00000
78	239872002	Osteoarthritis of hip	12	65966004	Fracture of forearm	1095	21	123	1	20	122	952	0.42393	-0.02866	0.39016	2.93294	0.05190	0.4994678432	1.0000000000	2.35890	-0.74799	13	55	1	8	68	0	4.02535	2.63906
76	127013003	Diabetic renal disease (disorder)	12	65966004	Fracture of forearm	1095	28	123	2	26	121	946	0.63589	-0.02098	0.60140	2.56541	0.14098	0.7609629343	1.0000000000	3.14521	-0.46648	10	55	0	18	68	2	-3.55535	-2.30259
75	431855005	Chronic kidney disease stage 1 (disorder)	12	65966004	Fracture of forearm	1095	28	123	2	26	121	946	0.63589	-0.02098	0.60140	2.56541	0.14098	0.7609629343	1.0000000000	3.14521	-0.46648	10	55	0	18	68	2	-3.55535	-2.30259
73	196416002	Impacted molars	12	65966004	Fracture of forearm	1095	49	123	4	45	119	927	0.72673	-0.02104	0.69244	1.95958	0.24468	0.6449010205	1.0000000000	5.50411	-0.37942	25	55	2	24	68	2	-0.20544	0.03774
72	35999006	Blighted ovum	12	65966004	Fracture of forearm	1095	53	123	3	50	120	922	0.50391	-0.03980	0.46100	1.50096	0.14159	0.2632035234	0.9289909644	5.95342	-0.79772	53	55	3	0	68	0	2.96183	2.92674
71	201834006	Localized  primary osteoarthritis of the hand	12	65966004	Fracture of forearm	1095	28	123	2	26	121	946	0.63589	-0.02098	0.60140	2.56541	0.14098	0.7609629343	1.0000000000	3.14521	-0.46648	19	55	2	9	68	0	3.34990	2.35138
70	87433001	Pulmonary emphysema (disorder)	12	65966004	Fracture of forearm	1095	17	123	2	15	121	957	1.04735	0.00212	1.05455	4.66734	0.23827	1.0000000000	1.0000000000	1.90959	0.04415	9	55	1	8	68	1	-0.20875	0.10536
69	233604007	Pneumonia	12	65966004	Fracture of forearm	1095	7	123	1	6	122	966	1.27178	0.00775	1.31967	11.05351	0.15755	0.5667818991	1.0000000000	0.78630	0.16302	3	55	0	4	68	1	-4.23411	-1.60944
68	26929004	Alzheimer's disease (disorder)	12	65966004	Fracture of forearm	1095	23	123	5	18	118	954	1.93531	0.04874	2.24576	6.16044	0.81868	0.1684741597	0.7953568293	2.58356	0.74357	15	55	2	8	68	3	0.18584	0.84078
67	403191005	Second degree burn	12	65966004	Fracture of forearm	1095	49	123	7	42	116	930	1.27178	0.02092	1.33621	3.04327	0.58669	0.4855992808	1.0000000000	5.50411	0.29865	23	55	4	26	68	3	-0.47282	-0.35914
65	239873007	Osteoarthritis of knee	12	65966004	Fracture of forearm	1095	57	123	11	46	112	926	1.71801	0.05985	1.97710	3.92771	0.99521	0.0538344358	0.4488876049	6.40274	0.69690	30	55	4	27	68	7	0.31967	0.55962
64	444448004	Injury of medial collateral ligament of knee	12	65966004	Fracture of forearm	1095	32	123	3	29	120	943	0.83460	-0.01021	0.81293	2.70920	0.24393	1.0000000000	1.0000000000	3.59452	-0.19991	17	55	1	15	68	2	0.47000	0.75031
63	68496003	Polyp of colon	12	65966004	Fracture of forearm	1095	91	123	7	84	116	888	0.68480	-0.03376	0.63793	1.41260	0.28809	0.3028396664	0.9949586182	10.22192	-0.48825	43	55	2	48	68	5	0.66888	0.75266
62	185086009	Chronic obstructive bronchitis (disorder)	12	65966004	Fracture of forearm	1095	6	123	0	6	123	966	0.00000	-0.02640	0.00000	0.00000	0.00000	1.0000000000	1.0000000000	0.67397	-0.74328	4	55	0	2	68	0	0.00000	0.00000
60	301011002	Escherichia coli urinary tract infection	12	65966004	Fracture of forearm	1095	92	123	9	83	114	889	0.87089	-0.01391	0.84559	1.72844	0.41368	0.7328228564	1.0000000000	10.33425	-0.18069	85	55	8	7	68	1	-2.17041	0.37372
59	262574004	Bullet wound	12	65966004	Fracture of forearm	1095	20	123	3	17	120	955	1.33537	0.01627	1.40441	4.86268	0.40561	0.4840849331	1.0000000000	2.24658	0.30108	9	55	1	11	68	2	0.47000	0.43078
58	239720000	Tear of meniscus of knee	12	65966004	Fracture of forearm	1095	20	123	3	17	120	955	1.33537	0.01627	1.40441	4.86268	0.40561	0.4840849331	1.0000000000	2.24658	0.30108	10	55	0	10	68	3	-3.16407	-1.46634
57	192127007	Child attention deficit disorder	12	65966004	Fracture of forearm	1095	76	123	6	70	117	902	0.70282	-0.02887	0.66081	1.55488	0.28083	0.4509089276	1.0000000000	8.53699	-0.44618	24	55	2	52	68	4	0.45953	-0.07411
56	92691004	Carcinoma in situ of prostate (disorder)	12	65966004	Fracture of forearm	1095	23	123	2	21	121	951	0.77413	-0.01177	0.74852	3.23178	0.17337	1.0000000000	1.0000000000	2.58356	-0.25643	0	55	0	23	68	2	-3.55535	-2.52573
118	48333001	Burn injury(morphologic abnormality)	79	45816000	Pyelonephritis	1095	1	1	0	1	1	1093	0.00000	-0.00091	0.00000	0.00000	0.00000	1.0000000000	1.0000000000	0.00091	-0.00132	0	1	0	1	0	0	0.00000	0.00000
54	5602001	Opioid abuse (disorder)	12	65966004	Fracture of forearm	1095	7	123	0	7	123	965	0.00000	-0.02853	0.00000	0.00000	0.00000	1.0000000000	1.0000000000	0.78630	-0.83698	0	55	0	7	68	0	0.00000	0.00000
53	7200002	Alcoholism	12	65966004	Fracture of forearm	1095	5	123	0	5	123	967	0.00000	-0.02409	0.00000	0.00000	0.00000	1.0000000000	1.0000000000	0.56164	-0.64307	0	55	0	5	68	0	0.00000	0.00000
52	124171000119105	Chronic intractable migraine without aura	12	65966004	Fracture of forearm	1095	51	123	3	48	120	924	0.52367	-0.03745	0.48125	1.56901	0.14761	0.2624482760	0.9281913645	5.72877	-0.75034	21	55	0	30	68	3	-3.16407	-2.39790
50	446096008	Perennial allergic rhinitis	12	65966004	Fracture of forearm	1095	26	123	0	26	123	946	0.00000	-0.05548	0.00000	0.00000	0.00000	0.1053625820	0.6378432720	2.92055	-1.97106	14	55	0	12	68	0	0.00000	0.00000
49	88805009	Chronic congestive heart failure (disorder)	12	65966004	Fracture of forearm	1095	10	123	0	10	123	962	0.00000	-0.03415	0.00000	0.00000	0.00000	0.6140528945	1.0000000000	1.12329	-1.08630	5	55	0	5	68	0	0.00000	0.00000
47	359817006	Closed fracture of hip	12	65966004	Fracture of forearm	1095	29	123	4	25	119	947	1.22792	0.01337	1.27328	3.72156	0.43563	0.5578068687	1.0000000000	3.25753	0.23191	11	55	2	18	68	2	-0.20544	-0.43078
46	62564004	Concussion with loss of consciousness	12	65966004	Fracture of forearm	1095	67	123	6	61	117	911	0.79723	-0.01841	0.76587	1.81057	0.32396	0.6903756025	1.0000000000	7.52603	-0.28452	36	55	3	31	68	3	-0.20224	0.13720
45	263102004	Fracture subluxation of wrist	12	65966004	Fracture of forearm	1095	109	123	10	99	113	873	0.81674	-0.02168	0.78037	1.53916	0.39566	0.6307705650	1.0000000000	12.24384	-0.26782	51	55	6	58	68	4	-0.57126	-0.48955
44	58150001	Fracture of clavicle	12	65966004	Fracture of forearm	1095	112	123	9	103	114	869	0.71537	-0.03418	0.66607	1.35301	0.32790	0.3421614120	1.0000000000	12.58082	-0.44157	55	55	3	57	68	6	0.44953	0.61046
43	307731004	Injury of tendon of the rotator cuff of shoulder	12	65966004	Fracture of forearm	1095	51	123	9	42	114	930	1.57102	0.04490	1.74812	3.68502	0.82928	0.1676660300	0.7942848378	5.72877	0.57159	26	55	2	25	68	7	0.97833	1.11923
42	16114001	Fracture of ankle	12	65966004	Fracture of forearm	1095	108	123	13	95	110	877	1.07159	0.00842	1.09100	2.01308	0.59128	0.7489971373	1.0000000000	12.13151	0.09239	48	55	7	60	68	6	-0.33108	-0.33647
41	283385000	Laceration of thigh	12	65966004	Fracture of forearm	1095	105	123	13	92	110	880	1.10221	0.01184	1.13043	2.08805	0.61200	0.7445540366	1.0000000000	11.79452	0.12990	50	55	5	55	68	8	0.23361	0.33420
40	428251008	History of appendectomy	12	65966004	Fracture of forearm	1095	51	123	3	48	120	924	0.52367	-0.03745	0.48125	1.56901	0.14761	0.2624482760	0.9281913645	5.72877	-0.75034	27	55	1	24	68	2	0.47000	0.76726
39	74400008	Appendicitis	12	65966004	Fracture of forearm	1095	51	123	3	48	120	924	0.52367	-0.03745	0.48125	1.56901	0.14761	0.2624482760	0.9281913645	5.72877	-0.75034	27	55	1	24	68	2	0.47000	0.76726
38	398254007	Preeclampsia	12	65966004	Fracture of forearm	1095	101	123	13	88	110	884	1.14586	0.01654	1.18719	2.19624	0.64174	0.6188598953	1.0000000000	11.34521	0.18148	101	55	13	0	68	0	1.65456	2.17125
37	38822007	Cystitis	12	65966004	Fracture of forearm	1095	71	123	7	64	116	908	0.87771	-0.01146	0.85614	1.91270	0.38322	0.8467873048	1.0000000000	7.97534	-0.16597	68	55	6	3	68	1	-1.91499	1.12601
35	19169002	Miscarriage in first trimester	12	65966004	Fracture of forearm	1095	174	123	17	157	106	815	0.86978	-0.02013	0.83253	1.42835	0.48525	0.6006867832	1.0000000000	19.54521	-0.19080	174	55	17	0	68	0	1.44345	2.41906
33	429007001	History of cardiac arrest (situation)	12	65966004	Fracture of forearm	1095	42	123	3	39	120	933	0.63589	-0.02587	0.59808	1.96512	0.18202	0.6157369241	1.0000000000	4.71781	-0.51546	24	55	1	18	68	2	0.47000	0.91629
32	410429000	Cardiac Arrest	12	65966004	Fracture of forearm	1095	42	123	3	39	120	933	0.63589	-0.02587	0.59808	1.96512	0.18202	0.6157369241	1.0000000000	4.71781	-0.51546	24	55	1	18	68	2	0.47000	0.91629
30	399211009	History of myocardial infarction (situation)	12	65966004	Fracture of forearm	1095	31	123	2	29	121	943	0.57435	-0.02585	0.53748	2.28067	0.12666	0.5670286538	1.0000000000	3.48219	-0.57924	2	55	1	29	68	1	-0.20875	-2.30259
29	22298006	Myocardial Infarction	12	65966004	Fracture of forearm	1095	31	123	2	29	121	943	0.57435	-0.02585	0.53748	2.28067	0.12666	0.5670286538	1.0000000000	3.48219	-0.57924	2	55	1	29	68	1	-0.20875	-2.30259
28	53741008	Coronary Heart Disease	12	65966004	Fracture of forearm	1095	80	123	11	69	112	903	1.22409	0.02238	1.28533	2.50161	0.66040	0.4612371818	1.0000000000	8.98630	0.26501	24	55	3	56	68	8	0.71054	0.11778
27	408512008	Body mass index 40+ - severely obese (finding)	12	65966004	Fracture of forearm	1095	97	123	6	91	117	881	0.55067	-0.04983	0.49648	1.15964	0.21256	0.1276422906	0.7011539591	10.89589	-0.76504	67	55	2	30	68	4	0.45953	1.40089
26	33737001	Fracture of rib	12	65966004	Fracture of forearm	1095	54	123	3	51	120	921	0.49458	-0.04095	0.45147	1.46900	0.13875	0.2653625403	0.9339825096	6.06575	-0.82084	32	55	1	22	68	2	0.47000	1.01160
24	162864005	Body mass index 30+ - obesity (finding)	12	65966004	Fracture of forearm	1095	439	123	49	390	74	582	0.99367	-0.00184	0.98815	1.44943	0.67367	1.0000000000	1.0000000000	49.31233	-0.00898	226	55	22	213	68	27	-0.00528	0.23758
23	36971009	Sinusitis (disorder)	12	65966004	Fracture of forearm	1095	190	123	25	165	98	807	1.17137	0.02793	1.24768	1.99628	0.77980	0.3761278377	1.0000000000	21.34247	0.21872	84	55	12	106	68	13	-0.10971	-0.13473
22	70704007	Sprain of wrist	12	65966004	Fracture of forearm	1095	195	123	30	165	93	807	1.36961	0.06120	1.57771	2.46027	1.01175	0.0460248762	0.4109932484	21.90411	0.43666	90	55	14	105	68	16	-0.06318	-0.01787
21	15777000	Prediabetes	12	65966004	Fracture of forearm	1095	333	123	45	288	78	684	1.20303	0.04775	1.37019	2.02756	0.92596	0.1193448300	0.6843537581	37.40548	0.26032	159	55	18	174	68	27	0.14205	0.27831
20	80394007	Hyperglycemia (disorder)	12	65966004	Fracture of forearm	1095	55	123	11	44	112	928	1.78049	0.06385	2.07143	4.12645	1.03983	0.0461470184	0.4112472365	6.17808	0.74136	23	55	4	32	68	7	0.31967	0.19189
19	237602007	Metabolic syndrome X (disorder)	12	65966004	Fracture of forearm	1095	64	123	12	52	111	920	1.66921	0.05931	1.91268	3.69273	0.99069	0.0636507187	0.4914037016	7.18904	0.66675	28	55	4	36	68	8	0.43995	0.37469
18	302870006	Hypertriglyceridemia (disorder)	12	65966004	Fracture of forearm	1095	64	123	12	52	111	920	1.66921	0.05931	1.91268	3.69273	0.99069	0.0636507187	0.4914037016	7.18904	0.66675	28	55	4	36	68	8	0.43995	0.37469
17	368581000119106	Neuropathy due to type 2 diabetes mellitus (disorder)	12	65966004	Fracture of forearm	1095	28	123	5	23	118	949	1.58972	0.03398	1.74834	4.68575	0.65234	0.2320017951	0.8920331834	3.14521	0.53352	7	55	1	21	68	4	1.13498	0.24686
15	40055000	Chronic sinusitis (disorder)	12	65966004	Fracture of forearm	1095	216	123	22	194	101	778	0.90673	-0.01645	0.87353	1.42193	0.53664	0.6323663996	1.0000000000	24.26301	-0.13539	104	55	8	112	68	14	0.29603	0.44183
14	10509002	Acute bronchitis (disorder)	12	65966004	Fracture of forearm	1095	863	123	101	762	22	210	1.04188	0.02874	1.26521	2.05652	0.77838	0.4121936141	1.0000000000	96.93973	0.05860	418	55	44	445	68	57	0.02567	0.17583
13	370247008	Facial laceration	12	65966004	Fracture of forearm	1095	109	123	12	97	111	875	0.98009	-0.00236	0.97520	1.83370	0.51863	1.0000000000	1.0000000000	12.24384	-0.02681	55	55	7	54	68	5	-0.49980	-0.28688
10	62106007	Concussion with no loss of consciousness	12	65966004	Fracture of forearm	1095	206	123	25	181	98	791	1.08039	0.01377	1.11484	1.78001	0.69824	0.6258725542	1.0000000000	23.13973	0.10710	96	55	10	110	68	15	0.16101	0.24059
9	44465007	Sprain of ankle	12	65966004	Fracture of forearm	1095	362	123	44	318	79	654	1.08206	0.02052	1.14545	1.69568	0.77377	0.5417225981	1.0000000000	40.66301	0.11116	185	55	23	177	68	21	-0.22290	-0.04170
8	233678006	Childhood asthma	12	65966004	Fracture of forearm	1095	45	123	4	41	119	931	0.79133	-0.01537	0.76327	2.16867	0.26864	0.8100970195	1.0000000000	5.05479	-0.27615	25	55	2	20	68	2	-0.20544	0.20479
7	75498004	Acute bacterial sinusitis (disorder)	12	65966004	Fracture of forearm	1095	187	123	19	168	104	804	0.90453	-0.01541	0.87431	1.46547	0.52162	0.7031610387	1.0000000000	21.00548	-0.13786	89	55	5	98	68	14	0.71724	0.85442
6	39848009	Whiplash injury to neck	12	65966004	Fracture of forearm	1095	182	123	23	159	100	813	1.12503	0.01986	1.17604	1.90831	0.72476	0.5206208582	1.0000000000	20.44384	0.16247	92	55	12	90	68	11	-0.25177	-0.05774
5	284549007	Laceration of hand	12	65966004	Fracture of forearm	1095	104	123	10	94	113	878	0.85600	-0.01659	0.82659	1.63276	0.41846	0.7436914666	1.0000000000	11.68219	-0.20530	54	55	3	50	68	7	0.59025	0.84730
4	195662009	Acute viral pharyngitis (disorder)	12	65966004	Fracture of forearm	1095	890	123	111	779	12	193	1.11030	0.08176	2.29172	4.24351	1.23765	0.0065677338	0.1121625814	99.97260	0.14953	430	55	47	460	68	64	0.05091	0.21476
3	65363002	Otitis media	12	65966004	Fracture of forearm	1095	580	123	66	514	57	458	1.01304	0.00492	1.03174	1.50285	0.70832	0.9237054491	1.0000000000	65.15068	0.01841	277	55	30	303	68	36	-0.01942	0.08317
1	444814009	Viral sinusitis (disorder)	12	65966004	Fracture of forearm	1095	993	123	118	875	5	97	1.05789	0.06426	2.61623	6.55932	1.04350	0.0317811214	0.3282620135	111.54247	0.08049	478	55	52	515	68	66	0.01340	0.14654
114	449868002	Smokes tobacco daily	48	55680006	Drug overdose	1095	9	50	1	8	49	1037	2.43333	0.02854	2.64541	21.57074	0.32443	0.3444093764	1.0000000000	0.41096	0.50332	2	24	0	7	26	1	-3.29584	-2.07944
116	370143000	Major depression disorder	48	55680006	Drug overdose	1095	8	50	0	8	50	1037	0.00000	-0.01877	0.00000	0.00000	0.00000	1.0000000000	1.0000000000	0.36530	-0.44921	3	24	0	5	26	0	0.00000	0.00000
119	275272006	Brain damage - traumatic	48	55680006	Drug overdose	1095	4	50	0	4	50	1041	0.00000	-0.01324	0.00000	0.00000	0.00000	1.0000000000	1.0000000000	0.18265	-0.24202	0	24	0	4	26	0	0.00000	0.00000
120	162573006	Suspected lung cancer (situation)	48	55680006	Drug overdose	1095	8	50	0	8	50	1037	0.00000	-0.01877	0.00000	0.00000	0.00000	1.0000000000	1.0000000000	0.36530	-0.44921	0	24	0	8	26	0	0.00000	0.00000
121	254637007	Non-small cell lung cancer (disorder)	48	55680006	Drug overdose	1095	8	50	0	8	50	1037	0.00000	-0.01877	0.00000	0.00000	0.00000	1.0000000000	1.0000000000	0.36530	-0.44921	0	24	0	8	26	0	0.00000	0.00000
124	1501000119109	Proliferative diabetic retinopathy due to type II diabetes mellitus (disorder)	48	55680006	Drug overdose	1095	1	50	0	1	50	1044	0.00000	-0.00661	0.00000	0.00000	0.00000	1.0000000000	1.0000000000	0.04566	-0.06442	1	24	0	0	26	0	0.00000	0.00000
127	431856006	Chronic kidney disease stage 2 (disorder)	48	55680006	Drug overdose	1095	5	50	0	5	50	1040	0.00000	-0.01481	0.00000	0.00000	0.00000	1.0000000000	1.0000000000	0.22831	-0.29668	3	24	0	2	26	0	0.00000	0.00000
128	86849004	Suicidal deliberate poisoning	48	55680006	Drug overdose	1095	1	50	1	0	49	1045	21.90000	0.13822	0.00000	0.00000	0.00000	0.0456621005	0.4094197322	0.04566	0.93558	0	24	0	1	26	1	-3.29584	-0.69315
118	48333001	Burn injury(morphologic abnormality)	125	1734006	Fracture of the vertebral column with spinal cord injury	1095	1	5	0	1	5	1089	0.00000	-0.00205	0.00000	0.00000	0.00000	1.0000000000	1.0000000000	0.00457	-0.00657	0	3	0	1	2	0	0.00000	0.00000
118	48333001	Burn injury(morphologic abnormality)	88	197927001	Recurrent urinary tract infection	1095	1	8	0	1	8	1086	0.00000	-0.00259	0.00000	0.00000	0.00000	1.0000000000	1.0000000000	0.00731	-0.01050	0	8	0	1	0	0	0.00000	0.00000
119	275272006	Brain damage - traumatic	88	197927001	Recurrent urinary tract infection	1095	4	8	0	4	8	1083	0.00000	-0.00519	0.00000	0.00000	0.00000	1.0000000000	1.0000000000	0.02922	-0.04156	0	8	0	4	0	0	0.00000	0.00000
120	162573006	Suspected lung cancer (situation)	88	197927001	Recurrent urinary tract infection	1095	8	8	0	8	8	1079	0.00000	-0.00736	0.00000	0.00000	0.00000	1.0000000000	1.0000000000	0.05845	-0.08195	0	8	0	8	0	0	0.00000	0.00000
123	195967001	Asthma	88	197927001	Recurrent urinary tract infection	1095	2	8	0	2	8	1085	0.00000	-0.00367	0.00000	0.00000	0.00000	1.0000000000	1.0000000000	0.01461	-0.02093	1	8	0	1	0	0	0.00000	0.00000
96	283371005	Laceration of forearm	125	1734006	Fracture of the vertebral column with spinal cord injury	1095	75	5	0	75	5	1015	0.00000	-0.01837	0.00000	0.00000	0.00000	1.0000000000	1.0000000000	0.34247	-0.42489	39	3	0	36	2	0	0.00000	0.00000
126	698754002	Chronic paralysis due to lesion of spinal cord	88	197927001	Recurrent urinary tract infection	1095	2	8	0	2	8	1085	0.00000	-0.00367	0.00000	0.00000	0.00000	1.0000000000	1.0000000000	0.01461	-0.02093	2	8	0	0	0	0	0.00000	0.00000
94	703151001	History of single seizure (situation)	125	1734006	Fracture of the vertebral column with spinal cord injury	1095	39	5	0	39	5	1051	0.00000	-0.01302	0.00000	0.00000	0.00000	1.0000000000	1.0000000000	0.17808	-0.23644	14	3	0	25	2	0	0.00000	0.00000
128	86849004	Suicidal deliberate poisoning	88	197927001	Recurrent urinary tract infection	1095	1	8	0	1	8	1086	0.00000	-0.00259	0.00000	0.00000	0.00000	1.0000000000	1.0000000000	0.00731	-0.01050	0	8	0	1	0	0	0.00000	0.00000
130	314994000	Metastasis from malignant tumor of prostate (disorder)	88	197927001	Recurrent urinary tract infection	1095	1	8	0	1	8	1086	0.00000	-0.00259	0.00000	0.00000	0.00000	1.0000000000	1.0000000000	0.00731	-0.01050	0	8	0	1	0	0	0.00000	0.00000
131	93761005	Primary malignant neoplasm of colon	88	197927001	Recurrent urinary tract infection	1095	5	8	0	5	8	1082	0.00000	-0.00581	0.00000	0.00000	0.00000	1.0000000000	1.0000000000	0.03653	-0.05176	3	8	0	2	0	0	0.00000	0.00000
75	431855005	Chronic kidney disease stage 1 (disorder)	125	1734006	Fracture of the vertebral column with spinal cord injury	1095	28	5	0	28	5	1062	0.00000	-0.01097	0.00000	0.00000	0.00000	1.0000000000	1.0000000000	0.12785	-0.17358	10	3	0	18	2	0	0.00000	0.00000
44	58150001	Fracture of clavicle	125	1734006	Fracture of the vertebral column with spinal cord injury	1095	112	5	1	111	4	979	1.95536	0.02184	2.20495	19.90141	0.24430	0.4175699306	1.0000000000	0.51142	0.40410	55	3	1	57	2	0	1.38629	4.02535
42	16114001	Fracture of ankle	125	1734006	Fracture of the vertebral column with spinal cord injury	1095	108	5	0	108	5	982	0.00000	-0.02240	0.00000	0.00000	0.00000	1.0000000000	1.0000000000	0.49315	-0.57836	48	3	0	60	2	0	0.00000	0.00000
130	314994000	Metastasis from malignant tumor of prostate (disorder)	99	30832001	Rupture of patellar tendon	1095	1	23	0	1	23	1071	0.00000	-0.00443	0.00000	0.00000	0.00000	1.0000000000	1.0000000000	0.02100	-0.02999	0	14	0	1	9	0	0.00000	0.00000
129	47505003	Posttraumatic stress disorder	99	30832001	Rupture of patellar tendon	1095	4	23	0	4	23	1068	0.00000	-0.00887	0.00000	0.00000	0.00000	1.0000000000	1.0000000000	0.08402	-0.11639	1	14	0	3	9	0	0.00000	0.00000
15	40055000	Chronic sinusitis (disorder)	125	1734006	Fracture of the vertebral column with spinal cord injury	1095	216	5	1	215	4	875	1.01389	0.00047	1.01744	9.14926	0.11314	1.0000000000	1.0000000000	0.98630	0.00992	104	3	1	112	2	0	1.38629	4.65396
127	431856006	Chronic kidney disease stage 2 (disorder)	99	30832001	Rupture of patellar tendon	1095	5	23	0	5	23	1067	0.00000	-0.00992	0.00000	0.00000	0.00000	1.0000000000	1.0000000000	0.10502	-0.14408	3	14	0	2	9	0	0.00000	0.00000
125	1734006	Fracture of the vertebral column with spinal cord injury	99	30832001	Rupture of patellar tendon	1095	5	23	0	5	23	1067	0.00000	-0.00992	0.00000	0.00000	0.00000	1.0000000000	1.0000000000	0.10502	-0.14408	3	14	0	2	9	0	0.00000	0.00000
124	1501000119109	Proliferative diabetic retinopathy due to type II diabetes mellitus (disorder)	99	30832001	Rupture of patellar tendon	1095	1	23	0	1	23	1071	0.00000	-0.00443	0.00000	0.00000	0.00000	1.0000000000	1.0000000000	0.02100	-0.02999	1	14	0	0	9	0	0.00000	0.00000
121	254637007	Non-small cell lung cancer (disorder)	99	30832001	Rupture of patellar tendon	1095	8	23	1	7	22	1065	5.95109	0.06222	6.91558	58.62581	0.81577	0.1566536716	0.7747075658	0.16804	0.77591	0	14	0	8	9	1	-2.30259	-2.19722
120	162573006	Suspected lung cancer (situation)	99	30832001	Rupture of patellar tendon	1095	8	23	1	7	22	1065	5.95109	0.06222	6.91558	58.62581	0.81577	0.1566536716	0.7747075658	0.16804	0.77591	0	14	0	8	9	1	-2.30259	-2.19722
118	48333001	Burn injury(morphologic abnormality)	99	30832001	Rupture of patellar tendon	1095	1	23	0	1	23	1071	0.00000	-0.00443	0.00000	0.00000	0.00000	1.0000000000	1.0000000000	0.02100	-0.02999	0	14	0	1	9	0	0.00000	0.00000
117	230265002	Familial Alzheimer's disease of early onset (disorder)	99	30832001	Rupture of patellar tendon	1095	6	23	1	5	22	1067	7.93478	0.07540	9.70000	86.51085	1.08761	0.1198515648	0.6843537581	0.12603	0.82876	2	14	0	4	9	1	-2.30259	-1.60944
115	36923009	Major depression  single episode	99	30832001	Rupture of patellar tendon	1095	6	23	0	6	23	1066	0.00000	-0.01087	0.00000	0.00000	0.00000	1.0000000000	1.0000000000	0.12603	-0.17124	3	14	0	3	9	0	0.00000	0.00000
114	449868002	Smokes tobacco daily	99	30832001	Rupture of patellar tendon	1095	9	23	0	9	23	1063	0.00000	-0.01333	0.00000	0.00000	0.00000	1.0000000000	1.0000000000	0.18904	-0.24980	2	14	0	7	9	0	0.00000	0.00000
112	49436004	Atrial Fibrillation	99	30832001	Rupture of patellar tendon	1095	35	23	2	33	21	1039	2.72050	0.04579	2.99856	13.32126	0.67496	0.1654006716	0.7915572889	0.73516	0.78989	9	14	1	26	9	1	0.40547	-0.99325
111	235919008	Cholelithiasis	99	30832001	Rupture of patellar tendon	1095	9	23	0	9	23	1063	0.00000	-0.01333	0.00000	0.00000	0.00000	1.0000000000	1.0000000000	0.18904	-0.24980	7	14	0	2	9	0	0.00000	0.00000
109	90560007	Gout	99	30832001	Rupture of patellar tendon	1095	4	23	0	4	23	1068	0.00000	-0.00887	0.00000	0.00000	0.00000	1.0000000000	1.0000000000	0.08402	-0.11639	0	14	0	4	9	0	0.00000	0.00000
108	40930008	Hypothyroidism (disorder)	99	30832001	Rupture of patellar tendon	1095	13	23	0	13	23	1059	0.00000	-0.01606	0.00000	0.00000	0.00000	1.0000000000	1.0000000000	0.27306	-0.34830	11	14	0	2	9	0	0.00000	0.00000
107	40275004	Contact dermatitis	99	30832001	Rupture of patellar tendon	1095	18	23	0	18	23	1054	0.00000	-0.01894	0.00000	0.00000	0.00000	1.0000000000	1.0000000000	0.37808	-0.46266	9	14	0	9	9	0	0.00000	0.00000
106	24079001	Atopic dermatitis	99	30832001	Rupture of patellar tendon	1095	20	23	0	20	23	1052	0.00000	-0.01998	0.00000	0.00000	0.00000	1.0000000000	1.0000000000	0.42009	-0.50598	13	14	0	7	9	0	0.00000	0.00000
105	363406005	Malignant tumor of colon	99	30832001	Rupture of patellar tendon	1095	6	23	0	6	23	1066	0.00000	-0.01087	0.00000	0.00000	0.00000	1.0000000000	1.0000000000	0.12603	-0.17124	4	14	0	2	9	0	0.00000	0.00000
104	367498001	Seasonal allergic rhinitis	99	30832001	Rupture of patellar tendon	1095	20	23	0	20	23	1052	0.00000	-0.01998	0.00000	0.00000	0.00000	1.0000000000	1.0000000000	0.42009	-0.50598	9	14	0	11	9	0	0.00000	0.00000
102	90781000119102	Microalbuminuria due to type 2 diabetes mellitus (disorder)	99	30832001	Rupture of patellar tendon	1095	6	23	0	6	23	1066	0.00000	-0.01087	0.00000	0.00000	0.00000	1.0000000000	1.0000000000	0.12603	-0.17124	3	14	0	3	9	0	0.00000	0.00000
101	433144002	Chronic kidney disease stage 3 (disorder)	99	30832001	Rupture of patellar tendon	1095	3	23	0	3	23	1069	0.00000	-0.00768	0.00000	0.00000	0.00000	1.0000000000	1.0000000000	0.06301	-0.08816	1	14	0	2	9	0	0.00000	0.00000
100	161622006	History of lower limb amputation (situation)	99	30832001	Rupture of patellar tendon	1095	1	23	0	1	23	1071	0.00000	-0.00443	0.00000	0.00000	0.00000	1.0000000000	1.0000000000	0.02100	-0.02999	0	14	0	1	9	0	0.00000	0.00000
98	1551000119108	Nonproliferative diabetic retinopathy due to type 2 diabetes mellitus (disorder)	99	30832001	Rupture of patellar tendon	1095	12	23	0	12	23	1060	0.00000	-0.01542	0.00000	0.00000	0.00000	1.0000000000	1.0000000000	0.25205	-0.32430	7	14	0	5	9	0	0.00000	0.00000
97	403192003	Third degree burn	99	30832001	Rupture of patellar tendon	1095	8	23	0	8	23	1064	0.00000	-0.01257	0.00000	0.00000	0.00000	1.0000000000	1.0000000000	0.16804	-0.22409	3	14	0	5	9	0	0.00000	0.00000
96	283371005	Laceration of forearm	99	30832001	Rupture of patellar tendon	1095	75	23	3	72	20	1000	1.90435	0.03592	2.08333	7.17644	0.60480	0.2048261543	0.8533859271	1.57534	0.63524	39	14	3	36	9	0	1.73460	2.63906
95	84757009	Epilepsy	99	30832001	Rupture of patellar tendon	1095	30	23	1	29	22	1043	1.58696	0.01443	1.63480	12.54372	0.21306	0.4756156025	1.0000000000	0.63014	0.29501	13	14	1	17	9	0	2.70805	2.63906
94	703151001	History of single seizure (situation)	99	30832001	Rupture of patellar tendon	1095	39	23	1	38	22	1034	1.22074	0.00621	1.23684	9.41739	0.16244	0.5694863071	1.0000000000	0.81918	0.13671	14	14	1	25	9	0	2.70805	2.70805
93	128613002	Seizure disorder	99	30832001	Rupture of patellar tendon	1095	39	23	1	38	22	1034	1.22074	0.00621	1.23684	9.41739	0.16244	0.5694863071	1.0000000000	0.81918	0.13671	14	14	1	25	9	0	2.70805	2.70805
89	47693006	Rupture of appendix	99	30832001	Rupture of patellar tendon	1095	20	23	0	20	23	1052	0.00000	-0.01998	0.00000	0.00000	0.00000	1.0000000000	1.0000000000	0.42009	-0.50598	10	14	0	10	9	0	0.00000	0.00000
86	713197008	Recurrent rectal polyp	99	30832001	Rupture of patellar tendon	1095	22	23	0	22	23	1050	0.00000	-0.02097	0.00000	0.00000	0.00000	1.0000000000	1.0000000000	0.46210	-0.54804	12	14	0	10	9	0	0.00000	0.00000
82	94260004	Secondary malignant neoplasm of colon	99	30832001	Rupture of patellar tendon	1095	4	23	0	4	23	1068	0.00000	-0.00887	0.00000	0.00000	0.00000	1.0000000000	1.0000000000	0.08402	-0.11639	2	14	0	2	9	0	0.00000	0.00000
80	6072007	Bleeding from anus	99	30832001	Rupture of patellar tendon	1095	4	23	0	4	23	1068	0.00000	-0.00887	0.00000	0.00000	0.00000	1.0000000000	1.0000000000	0.08402	-0.11639	2	14	0	2	9	0	0.00000	0.00000
78	239872002	Osteoarthritis of hip	99	30832001	Rupture of patellar tendon	1095	21	23	0	21	23	1051	0.00000	-0.02048	0.00000	0.00000	0.00000	1.0000000000	1.0000000000	0.44110	-0.52717	13	14	0	8	9	0	0.00000	0.00000
76	127013003	Diabetic renal disease (disorder)	99	30832001	Rupture of patellar tendon	1095	28	23	0	28	23	1044	0.00000	-0.02373	0.00000	0.00000	0.00000	1.0000000000	1.0000000000	0.58813	-0.66733	10	14	0	18	9	0	0.00000	0.00000
75	431855005	Chronic kidney disease stage 1 (disorder)	99	30832001	Rupture of patellar tendon	1095	28	23	0	28	23	1044	0.00000	-0.02373	0.00000	0.00000	0.00000	1.0000000000	1.0000000000	0.58813	-0.66733	10	14	0	18	9	0	0.00000	0.00000
73	196416002	Impacted molars	99	30832001	Rupture of patellar tendon	1095	49	23	1	48	22	1024	0.97161	-0.00090	0.96970	7.34515	0.12802	1.0000000000	1.0000000000	1.02922	-0.02093	25	14	1	24	9	0	2.70805	3.25810
72	35999006	Blighted ovum	99	30832001	Rupture of patellar tendon	1095	53	23	1	52	22	1020	0.89828	-0.00336	0.89161	6.74341	0.11789	1.0000000000	1.0000000000	1.11324	-0.07946	53	14	1	0	9	0	2.70805	3.98898
71	201834006	Localized  primary osteoarthritis of the hand	99	30832001	Rupture of patellar tendon	1095	28	23	0	28	23	1044	0.00000	-0.02373	0.00000	0.00000	0.00000	1.0000000000	1.0000000000	0.58813	-0.66733	19	14	0	9	9	0	0.00000	0.00000
70	87433001	Pulmonary emphysema (disorder)	99	30832001	Rupture of patellar tendon	1095	17	23	2	15	21	1057	5.60102	0.08463	6.71111	31.22121	1.44258	0.0474083685	0.4185289102	0.35708	1.14446	9	14	1	8	9	1	0.40547	0.10536
69	233604007	Pneumonia	99	30832001	Rupture of patellar tendon	1095	7	23	2	5	21	1067	13.60248	0.14807	20.32381	110.77922	3.72865	0.0083176033	0.1347083433	0.14703	1.38706	3	14	1	4	9	1	0.40547	-0.22314
68	26929004	Alzheimer's disease (disorder)	99	30832001	Rupture of patellar tendon	1095	23	23	2	21	21	1051	4.13989	0.06737	4.76644	21.64890	1.04943	0.0817414655	0.5636501052	0.48311	1.01634	15	14	1	8	9	1	0.40547	0.57536
67	403191005	Second degree burn	99	30832001	Rupture of patellar tendon	1095	49	23	2	47	21	1025	1.94321	0.02990	2.07700	9.12028	0.47300	0.2751020356	0.9503524867	1.02922	0.56403	23	14	1	26	9	1	0.40547	-0.11778
65	239873007	Osteoarthritis of knee	99	30832001	Rupture of patellar tendon	1095	57	23	1	56	22	1016	0.83524	-0.00566	0.82468	6.22908	0.10918	1.0000000000	1.0000000000	1.19726	-0.13571	30	14	1	27	9	0	2.70805	3.43399
64	444448004	Injury of medial collateral ligament of knee	99	30832001	Rupture of patellar tendon	1095	32	23	1	31	22	1041	1.48777	0.01240	1.52639	11.68742	0.19935	0.4980309114	1.0000000000	0.67215	0.25830	17	14	0	15	9	1	-2.30259	-2.77259
63	68496003	Polyp of colon	99	30832001	Rupture of patellar tendon	1095	91	23	1	90	22	982	0.52317	-0.02103	0.49596	3.72232	0.06608	0.7143312120	1.0000000000	1.91142	-0.54172	43	14	1	48	9	0	2.70805	3.78419
62	185086009	Chronic obstructive bronchitis (disorder)	99	30832001	Rupture of patellar tendon	1095	6	23	0	6	23	1066	0.00000	-0.01087	0.00000	0.00000	0.00000	1.0000000000	1.0000000000	0.12603	-0.17124	4	14	0	2	9	0	0.00000	0.00000
59	262574004	Bullet wound	99	30832001	Rupture of patellar tendon	1095	20	23	0	20	23	1052	0.00000	-0.01998	0.00000	0.00000	0.00000	1.0000000000	1.0000000000	0.42009	-0.50598	9	14	0	11	9	0	0.00000	0.00000
58	239720000	Tear of meniscus of knee	99	30832001	Rupture of patellar tendon	1095	20	23	2	18	21	1054	4.76087	0.07514	5.57672	25.58463	1.21557	0.0637595257	0.4918111744	0.42009	1.07898	10	14	1	10	9	1	0.40547	0.00000
57	192127007	Child attention deficit disorder	99	30832001	Rupture of patellar tendon	1095	76	23	1	75	22	997	0.62643	-0.01494	0.60424	4.54456	0.08034	1.0000000000	1.0000000000	1.59635	-0.37648	24	14	0	52	9	1	-2.30259	-3.97029
56	92691004	Carcinoma in situ of prostate (disorder)	99	30832001	Rupture of patellar tendon	1095	23	23	0	23	23	1049	0.00000	-0.02146	0.00000	0.00000	0.00000	1.0000000000	1.0000000000	0.48311	-0.56862	0	14	0	23	9	0	0.00000	0.00000
54	5602001	Opioid abuse (disorder)	99	30832001	Rupture of patellar tendon	1095	7	23	0	7	23	1065	0.00000	-0.01175	0.00000	0.00000	0.00000	1.0000000000	1.0000000000	0.14703	-0.19791	0	14	0	7	9	0	0.00000	0.00000
52	124171000119105	Chronic intractable migraine without aura	99	30832001	Rupture of patellar tendon	1095	51	23	1	50	22	1022	0.93350	-0.00215	0.92909	7.03202	0.12275	1.0000000000	1.0000000000	1.07123	-0.05049	21	14	1	30	9	0	2.70805	3.09104
50	446096008	Perennial allergic rhinitis	99	30832001	Rupture of patellar tendon	1095	26	23	0	26	23	1046	0.00000	-0.02284	0.00000	0.00000	0.00000	1.0000000000	1.0000000000	0.54612	-0.62865	14	14	0	12	9	0	0.00000	0.00000
49	88805009	Chronic congestive heart failure (disorder)	99	30832001	Rupture of patellar tendon	1095	10	23	0	10	23	1062	0.00000	-0.01406	0.00000	0.00000	0.00000	1.0000000000	1.0000000000	0.21005	-0.27506	5	14	0	5	9	0	0.00000	0.00000
47	359817006	Closed fracture of hip	99	30832001	Rupture of patellar tendon	1095	29	23	0	29	23	1043	0.00000	-0.02416	0.00000	0.00000	0.00000	1.0000000000	1.0000000000	0.60913	-0.68628	11	14	0	18	9	0	0.00000	0.00000
46	62564004	Concussion with loss of consciousness	99	30832001	Rupture of patellar tendon	1095	67	23	1	66	22	1006	0.71058	-0.01082	0.69284	5.21986	0.09196	1.0000000000	1.0000000000	1.40731	-0.26742	36	14	0	31	9	1	-2.30259	-3.46574
45	263102004	Fracture subluxation of wrist	99	30832001	Rupture of patellar tendon	1095	109	23	4	105	19	967	1.74711	0.03639	1.93885	5.80637	0.64741	0.2761296428	0.9505356881	2.28950	0.60406	51	14	2	58	9	2	0.37469	-0.12405
44	58150001	Fracture of clavicle	99	30832001	Rupture of patellar tendon	1095	112	23	5	107	18	965	2.12539	0.05564	2.50519	6.88333	0.91177	0.0768756527	0.5486296578	2.35251	0.83972	55	14	3	57	9	2	0.02985	-0.42256
43	307731004	Injury of tendon of the rotator cuff of shoulder	99	30832001	Rupture of patellar tendon	1095	51	23	3	48	20	1024	2.80051	0.05829	3.20000	11.14160	0.91908	0.0873973862	0.5838464658	1.07123	0.94951	26	14	1	25	9	2	1.00330	0.69315
42	16114001	Fracture of ankle	99	30832001	Rupture of patellar tendon	1095	108	23	4	104	19	968	1.76329	0.03698	1.95951	5.86920	0.65421	0.2738517513	0.9493960002	2.26849	0.61330	48	14	2	60	9	2	0.37469	-0.21511
41	283385000	Laceration of thigh	99	30832001	Rupture of patellar tendon	1095	105	23	0	105	23	967	0.00000	-0.04770	0.00000	0.00000	0.00000	0.1571447810	0.7753889195	2.20548	-1.68054	50	14	0	55	9	0	0.00000	0.00000
39	74400008	Appendicitis	99	30832001	Rupture of patellar tendon	1095	51	23	3	48	20	1024	2.80051	0.05829	3.20000	11.14160	0.91908	0.0873973862	0.5838464658	1.07123	0.94951	27	14	2	24	9	1	-0.22314	-0.54473
38	398254007	Preeclampsia	99	30832001	Rupture of patellar tendon	1095	101	23	7	94	16	978	3.29961	0.10737	4.55186	11.34288	1.82665	0.0032823448	0.0646018438	2.12146	1.35778	101	14	7	0	9	0	1.09861	2.73622
35	19169002	Miscarriage in first trimester	99	30832001	Rupture of patellar tendon	1095	174	23	6	168	17	904	1.64168	0.04085	1.89916	4.88697	0.73805	0.2414127553	0.9102754149	3.65479	0.58864	174	14	6	0	9	0	1.20397	3.40120
33	429007001	History of cardiac arrest (situation)	99	30832001	Rupture of patellar tendon	1095	42	23	2	40	21	1032	2.26708	0.03707	2.45714	10.84161	0.55689	0.2194727604	0.8768098041	0.88219	0.67255	24	14	1	18	9	1	0.40547	0.27444
32	410429000	Cardiac Arrest	99	30832001	Rupture of patellar tendon	1095	42	23	2	40	21	1032	2.26708	0.03707	2.45714	10.84161	0.55689	0.2194727604	0.8768098041	0.88219	0.67255	24	14	1	18	9	1	0.40547	0.27444
30	399211009	History of myocardial infarction (situation)	99	30832001	Rupture of patellar tendon	1095	31	23	0	31	23	1041	0.00000	-0.02500	0.00000	0.00000	0.00000	1.0000000000	1.0000000000	0.65114	-0.72346	2	14	0	29	9	0	0.00000	0.00000
29	22298006	Myocardial Infarction	99	30832001	Rupture of patellar tendon	1095	31	23	0	31	23	1041	0.00000	-0.02500	0.00000	0.00000	0.00000	1.0000000000	1.0000000000	0.65114	-0.72346	2	14	0	29	9	0	0.00000	0.00000
28	53741008	Coronary Heart Disease	99	30832001	Rupture of patellar tendon	1095	80	23	2	78	21	994	1.19022	0.00782	1.21368	5.27116	0.27945	0.6822837078	1.0000000000	1.68037	0.16253	24	14	1	56	9	1	0.40547	-0.82418
27	408512008	Body mass index 40+ - severely obese (finding)	99	30832001	Rupture of patellar tendon	1095	97	23	6	91	17	981	2.94487	0.08881	3.80478	9.88903	1.46388	0.0120621274	0.1744338623	2.03744	1.20450	67	14	5	30	9	1	-0.96758	-0.76676
26	33737001	Fracture of rib	99	30832001	Rupture of patellar tendon	1095	54	23	1	53	22	1019	0.88164	-0.00395	0.87393	6.60742	0.11559	1.0000000000	1.0000000000	1.13425	-0.09373	32	14	0	22	9	1	-2.30259	-3.13549
24	162864005	Body mass index 30+ - obesity (finding)	99	30832001	Rupture of patellar tendon	1095	439	23	14	425	9	647	1.51827	0.06210	2.36810	5.51998	1.01593	0.0517750619	0.4398325680	9.22100	0.55343	226	14	8	213	9	6	0.09531	-0.22143
23	36971009	Sinusitis (disorder)	99	30832001	Rupture of patellar tendon	1095	190	23	6	184	17	888	1.50343	0.03379	1.70332	4.37861	0.66261	0.2659117269	0.9347910049	3.99087	0.48806	84	14	3	106	9	3	0.34831	-0.22544
21	15777000	Prediabetes	99	30832001	Rupture of patellar tendon	1095	333	23	9	324	14	748	1.28672	0.02776	1.48413	3.46357	0.63594	0.3648417432	1.0000000000	6.99452	0.32292	159	14	4	174	9	5	0.47446	0.12951
20	80394007	Hyperglycemia (disorder)	99	30832001	Rupture of patellar tendon	1095	55	23	5	50	18	1022	4.32806	0.11210	5.67778	15.91461	2.02563	0.0044762185	0.0837787757	1.15525	1.47711	23	14	3	32	9	2	0.02985	-0.67373
19	237602007	Metabolic syndrome X (disorder)	99	30832001	Rupture of patellar tendon	1095	64	23	5	59	18	1013	3.71943	0.09924	4.76930	13.29241	1.71122	0.0086404962	0.1381535070	1.34429	1.35581	28	14	3	36	9	2	0.02985	-0.60906
18	302870006	Hypertriglyceridemia (disorder)	99	30832001	Rupture of patellar tendon	1095	64	23	5	59	18	1013	3.71943	0.09924	4.76930	13.29241	1.71122	0.0086404962	0.1381535070	1.34429	1.35581	28	14	3	36	9	2	0.02985	-0.60906
17	368581000119106	Neuropathy due to type 2 diabetes mellitus (disorder)	99	30832001	Rupture of patellar tendon	1095	28	23	2	26	21	1046	3.40062	0.05696	3.83150	17.20070	0.85348	0.1146806889	0.6697718480	0.58813	0.91764	7	14	0	21	9	2	-1.70475	-2.44235
129	47505003	Posttraumatic stress disorder	73	196416002	Impacted molars	1095	4	49	1	3	48	1043	5.58673	0.06011	7.24306	70.92601	0.73967	0.1675492660	0.7942848378	0.17900	0.76244	1	25	0	3	24	1	-3.21888	-1.38629
15	40055000	Chronic sinusitis (disorder)	99	30832001	Rupture of patellar tendon	1095	216	23	5	211	18	861	1.10205	0.00741	1.13349	3.08789	0.41608	0.7919872525	1.0000000000	4.53699	0.11586	104	14	3	112	9	2	0.02985	-0.46883
14	10509002	Acute bronchitis (disorder)	99	30832001	Rupture of patellar tendon	1095	863	23	21	842	2	230	1.15850	0.04478	2.86817	12.32201	0.66762	0.1963466663	0.8342357389	18.12694	0.20190	418	14	12	445	9	9	0.08004	-0.34199
13	370247008	Facial laceration	99	30832001	Rupture of patellar tendon	1095	109	23	2	107	21	965	0.87355	-0.00616	0.85892	3.71363	0.19866	1.0000000000	1.0000000000	2.28950	-0.13290	55	14	2	54	9	0	2.07944	3.34990
125	1734006	Fracture of the vertebral column with spinal cord injury	73	196416002	Impacted molars	1095	5	49	0	5	49	1041	0.00000	-0.01466	0.00000	0.00000	0.00000	1.0000000000	1.0000000000	0.22374	-0.29130	3	25	0	2	24	0	0.00000	0.00000
124	1501000119109	Proliferative diabetic retinopathy due to type II diabetes mellitus (disorder)	73	196416002	Impacted molars	1095	1	49	0	1	49	1045	0.00000	-0.00654	0.00000	0.00000	0.00000	1.0000000000	1.0000000000	0.04475	-0.06316	1	25	0	0	24	0	0.00000	0.00000
10	62106007	Concussion with no loss of consciousness	99	30832001	Rupture of patellar tendon	1095	206	23	3	203	20	869	0.69333	-0.02162	0.64212	2.18167	0.18899	0.5982877166	1.0000000000	4.32694	-0.41331	96	14	2	110	9	1	-0.22314	-0.81771
9	44465007	Sprain of ankle	99	30832001	Rupture of patellar tendon	1095	362	23	13	349	10	723	1.70970	0.07305	2.69312	6.20246	1.16936	0.0231654968	0.2762863192	7.60365	0.70241	185	14	7	177	9	6	0.18232	-0.10614
8	233678006	Childhood asthma	99	30832001	Rupture of patellar tendon	1095	45	23	1	44	22	1028	1.05797	0.00176	1.06198	8.05862	0.13995	1.0000000000	1.0000000000	0.94521	0.04008	25	14	1	20	9	0	2.70805	3.25810
7	75498004	Acute bacterial sinusitis (disorder)	99	30832001	Rupture of patellar tendon	1095	187	23	2	185	21	887	0.50918	-0.03263	0.45663	1.96431	0.10615	0.4039413151	1.0000000000	3.92785	-0.71600	89	14	1	98	9	1	0.40547	-0.09531
6	39848009	Whiplash injury to neck	99	30832001	Rupture of patellar tendon	1095	182	23	4	178	19	894	1.04634	0.00303	1.05736	3.14536	0.35545	1.0000000000	1.0000000000	3.82283	0.05205	92	14	2	90	9	2	0.37469	0.02151
5	284549007	Laceration of hand	99	30832001	Rupture of patellar tendon	1095	104	23	2	102	21	970	0.91555	-0.00401	0.90570	3.91818	0.20935	1.0000000000	1.0000000000	2.18447	-0.08609	54	14	1	50	9	1	0.40547	0.07551
117	230265002	Familial Alzheimer's disease of early onset (disorder)	73	196416002	Impacted molars	1095	6	49	1	5	48	1041	3.72449	0.04377	4.33750	37.85423	0.49701	0.2406784239	0.9095097439	0.26849	0.65688	2	25	0	4	24	1	-3.21888	-1.60944
115	36923009	Major depression  single episode	73	196416002	Impacted molars	1095	6	49	0	6	49	1040	0.00000	-0.01607	0.00000	0.00000	0.00000	1.0000000000	1.0000000000	0.26849	-0.34312	3	25	0	3	24	0	0.00000	0.00000
1	444814009	Viral sinusitis (disorder)	99	30832001	Rupture of patellar tendon	1095	993	23	23	970	0	102	1.10272	0.04695	0.00000	0.00000	0.00000	0.1580460463	0.7763448205	20.85753	0.13490	478	14	14	515	9	9	0.00000	-0.50485
111	235919008	Cholelithiasis	73	196416002	Impacted molars	1095	9	49	0	9	49	1037	0.00000	-0.01970	0.00000	0.00000	0.00000	1.0000000000	1.0000000000	0.40274	-0.48825	7	25	0	2	24	0	0.00000	0.00000
109	90560007	Gout	73	196416002	Impacted molars	1095	4	49	0	4	49	1042	0.00000	-0.01311	0.00000	0.00000	0.00000	1.0000000000	1.0000000000	0.17900	-0.23756	0	25	0	4	24	0	0.00000	0.00000
108	40930008	Hypothyroidism (disorder)	73	196416002	Impacted molars	1095	13	49	1	12	48	1034	1.71900	0.01706	1.79514	14.09054	0.22870	0.4503733786	1.0000000000	0.58174	0.33849	11	25	1	2	24	0	3.25810	2.48491
107	40275004	Contact dermatitis	73	196416002	Impacted molars	1095	18	49	1	17	48	1029	1.24150	0.00676	1.26103	9.67338	0.16439	0.5642452523	1.0000000000	0.80548	0.14762	9	25	0	9	24	1	-3.21888	-2.30259
106	24079001	Atopic dermatitis	73	196416002	Impacted molars	1095	20	49	0	20	49	1026	0.00000	-0.02952	0.00000	0.00000	0.00000	1.0000000000	1.0000000000	0.89498	-0.92218	13	25	0	7	24	0	0.00000	0.00000
105	363406005	Malignant tumor of colon	73	196416002	Impacted molars	1095	6	49	1	5	48	1041	3.72449	0.04377	4.33750	37.85423	0.49701	0.2406784239	0.9095097439	0.26849	0.65688	4	25	0	2	24	1	-3.21888	-1.09861
102	90781000119102	Microalbuminuria due to type 2 diabetes mellitus (disorder)	73	196416002	Impacted molars	1095	6	49	0	6	49	1040	0.00000	-0.01607	0.00000	0.00000	0.00000	1.0000000000	1.0000000000	0.26849	-0.34312	3	25	0	3	24	0	0.00000	0.00000
101	433144002	Chronic kidney disease stage 3 (disorder)	73	196416002	Impacted molars	1095	3	49	0	3	49	1043	0.00000	-0.01134	0.00000	0.00000	0.00000	1.0000000000	1.0000000000	0.13425	-0.18173	1	25	0	2	24	0	0.00000	0.00000
100	161622006	History of lower limb amputation (situation)	73	196416002	Impacted molars	1095	1	49	0	1	49	1045	0.00000	-0.00654	0.00000	0.00000	0.00000	1.0000000000	1.0000000000	0.04475	-0.06316	0	25	0	1	24	0	0.00000	0.00000
98	1551000119108	Nonproliferative diabetic retinopathy due to type 2 diabetes mellitus (disorder)	73	196416002	Impacted molars	1095	12	49	0	12	49	1034	0.00000	-0.02278	0.00000	0.00000	0.00000	1.0000000000	1.0000000000	0.53699	-0.62010	7	25	0	5	24	0	0.00000	0.00000
97	403192003	Third degree burn	73	196416002	Impacted molars	1095	8	49	0	8	49	1038	0.00000	-0.01857	0.00000	0.00000	0.00000	1.0000000000	1.0000000000	0.35799	-0.44147	3	25	0	5	24	0	0.00000	0.00000
96	283371005	Laceration of forearm	73	196416002	Impacted molars	1095	75	49	6	69	43	977	1.78776	0.04623	1.97573	4.80329	0.81268	0.1403091566	0.7366230723	3.35616	0.68430	39	25	3	36	24	3	0.03637	0.07411
94	703151001	History of single seizure (situation)	73	196416002	Impacted molars	1095	39	49	0	39	49	1007	0.00000	-0.04159	0.00000	0.00000	0.00000	0.4139771747	1.0000000000	1.74521	-1.45691	14	25	0	25	24	0	0.00000	0.00000
93	128613002	Seizure disorder	73	196416002	Impacted molars	1095	39	49	0	39	49	1007	0.00000	-0.04159	0.00000	0.00000	0.00000	0.4139771747	1.0000000000	1.74521	-1.45691	14	25	0	25	24	0	0.00000	0.00000
89	47693006	Rupture of appendix	73	196416002	Impacted molars	1095	20	49	2	18	47	1028	2.23469	0.03645	2.43026	10.78156	0.54780	0.2241913097	0.8794911525	0.89498	0.66278	10	25	1	10	24	1	0.03922	0.00000
86	713197008	Recurrent rectal polyp	73	196416002	Impacted molars	1095	22	49	2	20	47	1026	2.03154	0.03197	2.18298	9.61526	0.49561	0.2580893607	0.9228140157	0.98447	0.59621	12	25	0	10	24	2	-2.56495	-1.79176
82	94260004	Secondary malignant neoplasm of colon	73	196416002	Impacted molars	1095	4	49	0	4	49	1042	0.00000	-0.01311	0.00000	0.00000	0.00000	1.0000000000	1.0000000000	0.17900	-0.23756	2	25	0	2	24	0	0.00000	0.00000
78	239872002	Osteoarthritis of hip	73	196416002	Impacted molars	1095	21	49	1	20	48	1026	1.06414	0.00194	1.06875	8.13037	0.14049	1.0000000000	1.0000000000	0.93973	0.04415	13	25	1	8	24	0	3.25810	2.63906
76	127013003	Diabetic renal disease (disorder)	73	196416002	Impacted molars	1095	28	49	1	27	48	1019	0.79810	-0.00708	0.78627	5.90828	0.10464	1.0000000000	1.0000000000	1.25297	-0.17183	10	25	0	18	24	1	-3.21888	-2.94444
75	431855005	Chronic kidney disease stage 1 (disorder)	73	196416002	Impacted molars	1095	28	49	1	27	48	1019	0.79810	-0.00708	0.78627	5.90828	0.10464	1.0000000000	1.0000000000	1.25297	-0.17183	10	25	0	18	24	1	-3.21888	-2.94444
72	35999006	Blighted ovum	73	196416002	Impacted molars	1095	53	49	5	48	44	998	2.10820	0.05409	2.36269	6.22808	0.89631	0.0826869731	0.5681818225	2.37169	0.83149	53	25	5	0	24	0	1.79176	2.45101
71	201834006	Localized  primary osteoarthritis of the hand	73	196416002	Impacted molars	1095	28	49	1	27	48	1019	0.79810	-0.00708	0.78627	5.90828	0.10464	1.0000000000	1.0000000000	1.25297	-0.17183	19	25	1	9	24	0	3.25810	2.99573
70	87433001	Pulmonary emphysema (disorder)	73	196416002	Impacted molars	1095	17	49	1	16	48	1030	1.31453	0.00855	1.34115	10.32363	0.17423	0.5434950262	1.0000000000	0.76073	0.18383	9	25	0	8	24	1	-3.21888	-2.19722
69	233604007	Pneumonia	73	196416002	Impacted molars	1095	7	49	1	6	48	1040	3.19242	0.03806	3.61111	30.59094	0.42627	0.2748444085	0.9503524867	0.31324	0.60687	3	25	0	4	24	1	-3.21888	-1.60944
68	26929004	Alzheimer's disease (disorder)	73	196416002	Impacted molars	1095	23	49	0	23	49	1023	0.00000	-0.03170	0.00000	0.00000	0.00000	0.6201952553	1.0000000000	1.02922	-1.02093	15	25	0	8	24	0	0.00000	0.00000
67	403191005	Second degree burn	73	196416002	Impacted molars	1095	49	49	2	47	47	999	0.91212	-0.00412	0.90448	3.83671	0.21323	1.0000000000	1.0000000000	2.19269	-0.08981	23	25	1	26	24	1	0.03922	-0.11778
65	239873007	Osteoarthritis of knee	73	196416002	Impacted molars	1095	57	49	2	55	47	991	0.78410	-0.01095	0.76673	3.23905	0.18150	1.0000000000	1.0000000000	2.55068	-0.24313	30	25	0	27	24	2	-2.56495	-2.67415
64	444448004	Injury of medial collateral ligament of knee	73	196416002	Impacted molars	1095	32	49	1	31	48	1015	0.69834	-0.01133	0.68212	5.10244	0.09119	1.0000000000	1.0000000000	1.43196	-0.28212	17	25	1	15	24	0	3.25810	2.89037
63	68496003	Polyp of colon	73	196416002	Impacted molars	1095	91	49	6	85	43	961	1.47342	0.03085	1.57756	3.81280	0.65273	0.2887474960	0.9714931084	4.07215	0.46476	43	25	1	48	24	5	1.50024	1.42334
59	262574004	Bullet wound	73	196416002	Impacted molars	1095	20	49	2	18	47	1028	2.23469	0.03645	2.43026	10.78156	0.54780	0.2241913097	0.8794911525	0.89498	0.66278	9	25	1	11	24	1	0.03922	-0.18232
58	239720000	Tear of meniscus of knee	73	196416002	Impacted molars	1095	20	49	2	18	47	1028	2.23469	0.03645	2.43026	10.78156	0.54780	0.2241913097	0.8794911525	0.89498	0.66278	10	25	0	10	24	2	-2.56495	-1.79176
57	192127007	Child attention deficit disorder	73	196416002	Impacted molars	1095	76	49	1	75	48	971	0.29404	-0.04173	0.26972	1.98139	0.03672	0.2485042880	0.9133257124	3.40091	-1.13780	24	25	1	52	24	0	3.25810	3.21888
56	92691004	Carcinoma in situ of prostate (disorder)	73	196416002	Impacted molars	1095	23	49	2	21	47	1025	1.94321	0.02990	2.07700	9.12028	0.47300	0.2751020356	0.9503524867	1.02922	0.56403	0	25	0	23	24	2	-2.56495	-2.52573
54	5602001	Opioid abuse (disorder)	73	196416002	Impacted molars	1095	7	49	1	6	48	1040	3.19242	0.03806	3.61111	30.59094	0.42627	0.2748444085	0.9503524867	0.31324	0.60687	0	25	0	7	24	1	-3.21888	-2.07944
52	124171000119105	Chronic intractable migraine without aura	73	196416002	Impacted molars	1095	51	49	41	10	8	1036	17.96519	0.81157	530.95000	1415.65492	199.13603	0.0000000000	0.0000000000	2.28219	3.67766	21	25	18	30	24	23	0.15617	-0.06161
50	446096008	Perennial allergic rhinitis	73	196416002	Impacted molars	1095	26	49	2	24	47	1022	1.71900	0.02427	1.81206	7.89551	0.41588	0.3259725061	1.0000000000	1.16347	0.47162	14	25	0	12	24	2	-2.56495	-1.94591
49	88805009	Chronic congestive heart failure (disorder)	73	196416002	Impacted molars	1095	10	49	1	9	48	1037	2.23469	0.02566	2.40046	19.33302	0.29805	0.3685563607	1.0000000000	0.44749	0.46645	5	25	0	5	24	1	-3.21888	-1.79176
47	359817006	Closed fracture of hip	73	196416002	Impacted molars	1095	29	49	1	28	48	1018	0.77058	-0.00819	0.75744	5.68452	0.10093	1.0000000000	1.0000000000	1.29772	-0.20020	11	25	0	18	24	1	-3.21888	-2.94444
45	263102004	Fracture subluxation of wrist	73	196416002	Impacted molars	1095	109	49	4	105	45	941	0.82007	-0.01295	0.79661	2.25900	0.28092	0.8108237008	1.0000000000	4.87763	-0.23331	51	25	1	58	24	3	1.06087	0.93898
44	58150001	Fracture of clavicle	73	196416002	Impacted molars	1095	112	49	4	108	45	938	0.79810	-0.01475	0.77202	2.18819	0.27238	0.8105992886	1.0000000000	5.01187	-0.26589	55	25	3	57	24	1	-0.98528	-1.09861
43	307731004	Injury of tendon of the rotator cuff of shoulder	73	196416002	Impacted molars	1095	51	49	0	51	49	995	0.00000	-0.04784	0.00000	0.00000	0.00000	0.1638931441	0.7887357560	2.28219	-1.71466	26	25	0	25	24	0	0.00000	0.00000
42	16114001	Fracture of ankle	73	196416002	Impacted molars	1095	108	49	5	103	44	943	1.03458	0.00248	1.04038	2.68229	0.40353	0.8096666592	1.0000000000	4.83288	0.04075	48	25	3	60	24	2	-0.33136	-0.60077
41	283385000	Laceration of thigh	73	196416002	Impacted molars	1095	105	49	4	101	45	945	0.85131	-0.01048	0.83168	2.36006	0.29308	1.0000000000	1.0000000000	4.69863	-0.18869	50	25	0	55	24	4	-1.94591	-2.69124
39	74400008	Appendicitis	73	196416002	Impacted molars	1095	51	49	3	48	46	998	1.31453	0.01505	1.35598	4.51679	0.40708	0.4939703825	1.0000000000	2.28219	0.28534	27	25	2	24	24	1	-0.61619	-0.54473
38	398254007	Preeclampsia	73	196416002	Impacted molars	1095	101	49	3	98	46	948	0.66377	-0.02320	0.63088	2.06604	0.19264	0.6147557990	1.0000000000	4.51963	-0.46457	101	25	3	0	24	0	2.23359	3.54578
35	19169002	Miscarriage in first trimester	73	196416002	Impacted molars	1095	174	49	14	160	35	886	1.79803	0.07508	2.21500	4.21019	1.16532	0.0251574094	0.2905941929	7.78630	0.77163	174	25	14	0	24	0	1.02450	2.59738
33	429007001	History of cardiac arrest (situation)	73	196416002	Impacted molars	1095	42	49	1	41	48	1005	0.53207	-0.02023	0.51067	3.79133	0.06878	1.0000000000	1.0000000000	1.87945	-0.52579	24	25	0	18	24	1	-3.21888	-2.94444
32	410429000	Cardiac Arrest	73	196416002	Impacted molars	1095	42	49	1	41	48	1005	0.53207	-0.02023	0.51067	3.79133	0.06878	1.0000000000	1.0000000000	1.87945	-0.52579	24	25	0	18	24	1	-3.21888	-2.94444
30	399211009	History of myocardial infarction (situation)	73	196416002	Impacted molars	1095	31	49	1	30	48	1016	0.72087	-0.01031	0.70556	5.28313	0.09423	1.0000000000	1.0000000000	1.38721	-0.25533	2	25	0	29	24	1	-3.21888	-3.40120
29	22298006	Myocardial Infarction	73	196416002	Impacted molars	1095	31	49	1	30	48	1016	0.72087	-0.01031	0.70556	5.28313	0.09423	1.0000000000	1.0000000000	1.38721	-0.25533	2	25	0	29	24	1	-3.21888	-3.40120
27	408512008	Body mass index 40+ - severely obese (finding)	73	196416002	Impacted molars	1095	97	49	5	92	44	954	1.15190	0.01025	1.17836	3.04510	0.45599	0.6143580848	1.0000000000	4.34064	0.16795	67	25	2	30	24	3	0.40547	1.14306
24	162864005	Body mass index 30+ - obesity (finding)	73	196416002	Impacted molars	1095	439	49	20	419	29	627	1.01808	0.00320	1.03201	1.84867	0.57612	1.0000000000	1.0000000000	19.64475	0.02461	226	25	9	213	24	11	0.17168	0.24861
23	36971009	Sinusitis (disorder)	73	196416002	Impacted molars	1095	190	49	11	179	38	867	1.29377	0.02913	1.40209	2.79558	0.70320	0.3352691540	1.0000000000	8.50228	0.33669	84	25	4	106	24	7	0.49292	0.30956
21	15777000	Prediabetes	73	196416002	Impacted molars	1095	333	49	21	312	28	734	1.40927	0.05856	1.76442	3.15477	0.98682	0.0575346976	0.4684968231	14.90137	0.46835	159	25	11	174	24	10	-0.03815	-0.17445
20	80394007	Hyperglycemia (disorder)	73	196416002	Impacted molars	1095	55	49	4	51	45	995	1.62523	0.03112	1.73420	5.00867	0.60045	0.3036362918	0.9949586182	2.46119	0.53066	23	25	2	32	24	2	0.03774	-0.30748
19	237602007	Metabolic syndrome X (disorder)	73	196416002	Impacted molars	1095	64	49	4	60	45	986	1.39668	0.02139	1.46074	4.19646	0.50847	0.5247715374	1.0000000000	2.86393	0.37186	28	25	2	36	24	2	0.03774	-0.23639
18	302870006	Hypertriglyceridemia (disorder)	73	196416002	Impacted molars	1095	64	49	4	60	45	986	1.39668	0.02139	1.46074	4.19646	0.50847	0.5247715374	1.0000000000	2.86393	0.37186	28	25	2	36	24	2	0.03774	-0.23639
17	368581000119106	Neuropathy due to type 2 diabetes mellitus (disorder)	73	196416002	Impacted molars	1095	28	49	0	28	49	1018	0.00000	-0.03506	0.00000	0.00000	0.00000	0.6324419072	1.0000000000	1.25297	-1.17183	7	25	0	21	24	0	0.00000	0.00000
15	40055000	Chronic sinusitis (disorder)	73	196416002	Impacted molars	1095	216	49	8	208	41	838	0.82766	-0.01849	0.78612	1.70227	0.36303	0.7130633088	1.0000000000	9.66575	-0.24499	104	25	4	112	24	4	0.03509	-0.07146
14	10509002	Acute bronchitis (disorder)	73	196416002	Impacted molars	1095	863	49	43	820	6	226	1.11346	0.04736	1.97520	4.69936	0.83020	0.1512261218	0.7646675673	38.61826	0.15134	418	25	21	445	24	22	0.04652	-0.01531
13	370247008	Facial laceration	73	196416002	Impacted molars	1095	109	49	5	104	44	942	1.02509	0.00181	1.02928	2.65318	0.39930	1.0000000000	1.0000000000	4.87763	0.02973	55	25	3	54	24	2	-0.33136	-0.37037
125	1734006	Fracture of the vertebral column with spinal cord injury	47	359817006	Closed fracture of hip	1095	5	29	1	4	28	1062	7.55172	0.07319	9.48214	87.58563	1.02655	0.1258071912	0.6946053535	0.13242	0.82059	3	11	1	2	18	0	2.48491	1.38629
10	62106007	Concussion with no loss of consciousness	73	196416002	Impacted molars	1095	206	49	11	195	38	851	1.19328	0.02014	1.26329	2.51578	0.63436	0.4603111193	1.0000000000	9.21826	0.23188	96	25	4	110	24	7	0.49292	0.40261
8	233678006	Childhood asthma	73	196416002	Impacted molars	1095	45	49	4	41	45	1005	1.98639	0.04420	2.17886	6.34731	0.74794	0.1371870050	0.7296699408	2.01370	0.73039	25	25	1	20	24	3	1.06087	1.22121
7	75498004	Acute bacterial sinusitis (disorder)	73	196416002	Impacted molars	1095	187	49	2	185	47	861	0.23900	-0.07475	0.19804	0.82260	0.04768	0.0103588839	0.1588603827	8.36804	-1.64278	89	25	1	98	24	1	0.03922	-0.09531
6	39848009	Whiplash injury to neck	73	196416002	Impacted molars	1095	182	49	6	176	43	870	0.73671	-0.02544	0.68975	1.64534	0.28915	0.5549408609	1.0000000000	8.14429	-0.38552	92	25	4	90	24	2	-0.58395	-0.65059
5	284549007	Laceration of hand	73	196416002	Impacted molars	1095	104	49	7	97	42	949	1.50412	0.03535	1.63058	3.72817	0.71317	0.2181568394	0.8740213312	4.65388	0.50076	54	25	4	50	24	3	-0.21622	-0.19753
1	444814009	Viral sinusitis (disorder)	73	196416002	Impacted molars	1095	993	49	48	945	1	101	1.08021	0.05417	5.13016	37.56284	0.70065	0.0785597108	0.5538932862	44.43562	0.10896	478	25	24	515	24	24	0.02062	-0.07112
96	283371005	Laceration of forearm	47	359817006	Closed fracture of hip	1095	75	29	3	72	26	994	1.51034	0.02283	1.59295	5.38911	0.47085	0.4433036749	1.0000000000	1.98630	0.42164	39	11	2	36	18	1	-1.07264	-0.59049
94	703151001	History of single seizure (situation)	47	359817006	Closed fracture of hip	1095	39	29	1	38	28	1028	0.96817	-0.00101	0.96617	7.28884	0.12807	1.0000000000	1.0000000000	1.03288	-0.02352	14	11	1	25	18	0	2.48491	2.70805
86	713197008	Recurrent rectal polyp	47	359817006	Closed fracture of hip	1095	22	29	1	21	28	1045	1.71630	0.01692	1.77721	13.68012	0.23088	0.4491645519	1.0000000000	0.58265	0.33766	12	11	1	10	18	0	2.48491	2.56495
75	431855005	Chronic kidney disease stage 1 (disorder)	47	359817006	Closed fracture of hip	1095	28	29	0	28	29	1038	0.00000	-0.02672	0.00000	0.00000	0.00000	1.0000000000	1.0000000000	0.74155	-0.80037	10	11	0	18	18	0	0.00000	0.00000
64	444448004	Injury of medial collateral ligament of knee	47	359817006	Closed fracture of hip	1095	32	29	2	30	27	1036	2.35991	0.03892	2.55802	11.25385	0.58144	0.2065846205	0.8561849853	0.84749	0.69940	17	11	1	15	18	1	-0.45953	0.11778
44	58150001	Fracture of clavicle	47	359817006	Closed fracture of hip	1095	112	29	1	111	28	955	0.33713	-0.03690	0.30727	2.28027	0.04141	0.3512974432	1.0000000000	2.96621	-0.98776	55	11	0	57	18	1	-2.94444	-4.06044
43	307731004	Injury of tendon of the rotator cuff of shoulder	47	359817006	Closed fracture of hip	1095	51	29	0	51	29	1015	0.00000	-0.03645	0.00000	0.00000	0.00000	0.3949100848	1.0000000000	1.35068	-1.23308	26	11	0	25	18	0	0.00000	0.00000
42	16114001	Fracture of ankle	47	359817006	Closed fracture of hip	1095	108	29	4	104	25	962	1.39847	0.02174	1.48000	4.33504	0.50528	0.5203461212	1.0000000000	2.86027	0.37322	48	11	1	60	18	3	0.53900	0.84730
41	283385000	Laceration of thigh	47	359817006	Closed fracture of hip	1095	105	29	6	99	23	967	2.15764	0.06218	2.54809	6.40655	1.01346	0.0514278605	0.4391378983	2.78082	0.88866	50	11	3	55	18	3	-0.40547	-0.09015
38	398254007	Preeclampsia	47	359817006	Closed fracture of hip	1095	101	29	1	100	28	966	0.37385	-0.03292	0.34500	2.56266	0.04645	0.5097956746	1.0000000000	2.67489	-0.87770	101	11	1	0	18	0	2.48491	4.62497
35	19169002	Miscarriage in first trimester	47	359817006	Closed fracture of hip	1095	174	29	5	169	24	897	1.08502	0.00610	1.10577	2.93871	0.41608	0.7977030439	1.0000000000	4.60822	0.09742	174	11	5	0	18	0	1.16315	3.57795
33	429007001	History of cardiac arrest (situation)	47	359817006	Closed fracture of hip	1095	42	29	2	40	27	1026	1.79803	0.02629	1.90000	8.26886	0.43658	0.3066060542	0.9977249576	1.11233	0.50613	24	11	1	18	18	1	-0.45953	0.27444
32	410429000	Cardiac Arrest	47	359817006	Closed fracture of hip	1095	42	29	2	40	27	1026	1.79803	0.02629	1.90000	8.26886	0.43658	0.3066060542	0.9977249576	1.11233	0.50613	24	11	1	18	18	1	-0.45953	0.27444
27	408512008	Body mass index 40+ - severely obese (finding)	47	359817006	Closed fracture of hip	1095	97	29	4	93	25	973	1.55706	0.02864	1.67398	4.91308	0.57036	0.3165028926	1.0000000000	2.56895	0.48643	67	11	2	30	18	2	-0.43078	0.76837
21	15777000	Prediabetes	47	359817006	Closed fracture of hip	1095	333	29	8	325	21	741	0.90711	-0.01013	0.86857	1.98136	0.38076	0.8398226684	1.0000000000	8.81918	-0.12568	159	11	3	174	18	5	0.01439	0.41104
15	40055000	Chronic sinusitis (disorder)	47	359817006	Closed fracture of hip	1095	216	29	6	210	23	856	1.04885	0.00399	1.06335	2.64454	0.42757	0.8162441271	1.0000000000	5.72055	0.05878	104	11	3	112	18	3	-0.40547	-0.07210
14	10509002	Acute bronchitis (disorder)	47	359817006	Closed fracture of hip	1095	863	29	23	840	6	226	1.00631	0.00201	1.03135	2.56324	0.41498	1.0000000000	1.0000000000	22.85571	0.00870	418	11	9	445	18	14	-0.02817	0.36957
125	1734006	Fracture of the vertebral column with spinal cord injury	21	15777000	Prediabetes	1095	5	333	1	4	332	758	0.65766	-0.01533	0.57078	5.12616	0.06356	1.0000000000	1.0000000000	1.52055	-0.33374	3	159	1	2	174	0	5.07517	1.38629
118	48333001	Burn injury(morphologic abnormality)	21	15777000	Prediabetes	1095	1	333	0	1	333	761	0.00000	-0.01999	0.00000	0.00000	0.00000	1.0000000000	1.0000000000	0.30411	-0.38307	0	159	0	1	174	0	0.00000	0.00000
120	162573006	Suspected lung cancer (situation)	84	232353008	Perennial allergic rhinitis with seasonal variation	1095	8	29	0	8	29	1058	0.00000	-0.01415	0.00000	0.00000	0.00000	1.0000000000	1.0000000000	0.21187	-0.27724	0	14	0	8	15	0	0.00000	0.00000
96	283371005	Laceration of forearm	21	15777000	Prediabetes	1095	75	333	35	40	298	722	1.53453	0.09582	2.11997	3.40312	1.32063	0.0025370751	0.0525246358	22.80822	0.59654	39	159	18	36	174	17	-0.13328	0.01560
94	703151001	History of single seizure (situation)	21	15777000	Prediabetes	1095	39	333	6	33	327	729	0.50589	-0.06277	0.40534	0.97682	0.16820	0.0494438214	0.4284480396	11.86027	-0.87749	14	159	3	25	174	3	-0.08855	-0.49899
75	431855005	Chronic kidney disease stage 1 (disorder)	21	15777000	Prediabetes	1095	28	333	17	11	316	751	1.99646	0.10671	3.67290	7.93036	1.70108	0.0012044331	0.0286219356	8.51507	0.91971	10	159	7	18	174	10	0.25373	-0.14232
118	48333001	Burn injury(morphologic abnormality)	35	19169002	Miscarriage in first trimester	1095	1	174	0	1	174	920	0.00000	-0.01314	0.00000	0.00000	0.00000	1.0000000000	1.0000000000	0.15890	-0.21276	0	174	0	1	0	0	0.00000	0.00000
44	58150001	Fracture of clavicle	21	15777000	Prediabetes	1095	112	333	38	74	295	688	1.11567	0.02581	1.19762	1.81229	0.79142	0.3879187555	1.0000000000	34.06027	0.15364	55	159	16	57	174	22	0.20513	0.21169
42	16114001	Fracture of ankle	21	15777000	Prediabetes	1095	108	333	36	72	297	690	1.09610	0.02101	1.16162	1.77248	0.76128	0.5090732342	1.0000000000	32.84384	0.12863	48	159	18	60	174	18	-0.08135	-0.16705
41	283385000	Laceration of thigh	21	15777000	Prediabetes	1095	105	333	43	62	290	700	1.34663	0.07463	1.67408	2.52846	1.10840	0.0186803645	0.2375451204	31.93151	0.41803	50	159	19	55	174	24	0.12713	0.09827
33	429007001	History of cardiac arrest (situation)	21	15777000	Prediabetes	1095	42	333	18	24	315	738	1.40927	0.05403	1.75714	3.28344	0.94034	0.0867771639	0.5823623432	12.77260	0.46420	24	159	9	18	174	9	-0.08552	0.20067
15	40055000	Chronic sinusitis (disorder)	21	15777000	Prediabetes	1095	216	333	91	125	242	637	1.38534	0.12628	1.91626	2.60740	1.40832	0.0000484017	0.0017926997	65.68767	0.46421	104	159	44	112	174	47	-0.01900	-0.00573
117	230265002	Familial Alzheimer's disease of early onset (disorder)	106	24079001	Atopic dermatitis	1095	6	20	0	6	20	1069	0.00000	-0.01012	0.00000	0.00000	0.00000	1.0000000000	1.0000000000	0.10959	-0.15003	2	13	0	4	7	0	0.00000	0.00000
118	48333001	Burn injury(morphologic abnormality)	106	24079001	Atopic dermatitis	1095	1	20	0	1	20	1074	0.00000	-0.00412	0.00000	0.00000	0.00000	1.0000000000	1.0000000000	0.01826	-0.02611	0	13	0	1	7	0	0.00000	0.00000
130	314994000	Metastasis from malignant tumor of prostate (disorder)	106	24079001	Atopic dermatitis	1095	1	20	0	1	20	1074	0.00000	-0.00412	0.00000	0.00000	0.00000	1.0000000000	1.0000000000	0.01826	-0.02611	0	13	0	1	7	0	0.00000	0.00000
116	370143000	Major depression disorder	51	403190006	First degree burn	1095	8	79	0	8	79	1008	0.00000	-0.02392	0.00000	0.00000	0.00000	1.0000000000	1.0000000000	0.57717	-0.65734	3	43	0	5	36	0	0.00000	0.00000
117	230265002	Familial Alzheimer's disease of early onset (disorder)	51	403190006	First degree burn	1095	6	79	0	6	79	1010	0.00000	-0.02070	0.00000	0.00000	0.00000	1.0000000000	1.0000000000	0.43288	-0.51891	2	43	0	4	36	0	0.00000	0.00000
118	48333001	Burn injury(morphologic abnormality)	51	403190006	First degree burn	1095	1	79	0	1	79	1015	0.00000	-0.00843	0.00000	0.00000	0.00000	1.0000000000	1.0000000000	0.07215	-0.10050	0	43	0	1	36	0	0.00000	0.00000
119	275272006	Brain damage - traumatic	51	403190006	First degree burn	1095	4	79	0	4	79	1012	0.00000	-0.01688	0.00000	0.00000	0.00000	1.0000000000	1.0000000000	0.28858	-0.36579	0	43	0	4	36	0	0.00000	0.00000
120	162573006	Suspected lung cancer (situation)	51	403190006	First degree burn	1095	8	79	0	8	79	1008	0.00000	-0.02392	0.00000	0.00000	0.00000	1.0000000000	1.0000000000	0.57717	-0.65734	0	43	0	8	36	0	0.00000	0.00000
121	254637007	Non-small cell lung cancer (disorder)	51	403190006	First degree burn	1095	8	79	0	8	79	1008	0.00000	-0.02392	0.00000	0.00000	0.00000	1.0000000000	1.0000000000	0.57717	-0.65734	0	43	0	8	36	0	0.00000	0.00000
123	195967001	Asthma	51	403190006	First degree burn	1095	2	79	2	0	77	1016	13.86076	0.15340	0.00000	0.00000	0.00000	0.0051438732	0.0930988016	0.14429	1.39051	1	43	1	1	36	1	0.17327	0.00000
124	1501000119109	Proliferative diabetic retinopathy due to type II diabetes mellitus (disorder)	51	403190006	First degree burn	1095	1	79	0	1	79	1015	0.00000	-0.00843	0.00000	0.00000	0.00000	1.0000000000	1.0000000000	0.07215	-0.10050	1	43	0	0	36	0	0.00000	0.00000
125	1734006	Fracture of the vertebral column with spinal cord injury	51	403190006	First degree burn	1095	5	79	1	4	78	1012	2.77215	0.03347	3.24359	29.37253	0.35819	0.3127912652	1.0000000000	0.36073	0.55562	3	43	1	2	36	0	3.78419	1.38629
126	698754002	Chronic paralysis due to lesion of spinal cord	51	403190006	First degree burn	1095	2	79	0	2	79	1014	0.00000	-0.01193	0.00000	0.00000	0.00000	1.0000000000	1.0000000000	0.14429	-0.19446	2	43	0	0	36	0	0.00000	0.00000
127	431856006	Chronic kidney disease stage 2 (disorder)	51	403190006	First degree burn	1095	5	79	0	5	79	1011	0.00000	-0.01889	0.00000	0.00000	0.00000	1.0000000000	1.0000000000	0.36073	-0.44438	3	43	0	2	36	0	0.00000	0.00000
128	86849004	Suicidal deliberate poisoning	51	403190006	First degree burn	1095	1	79	0	1	79	1015	0.00000	-0.00843	0.00000	0.00000	0.00000	1.0000000000	1.0000000000	0.07215	-0.10050	0	43	0	1	36	0	0.00000	0.00000
130	314994000	Metastasis from malignant tumor of prostate (disorder)	51	403190006	First degree burn	1095	1	79	0	1	79	1015	0.00000	-0.00843	0.00000	0.00000	0.00000	1.0000000000	1.0000000000	0.07215	-0.10050	0	43	0	1	36	0	0.00000	0.00000
131	93761005	Primary malignant neoplasm of colon	51	403190006	First degree burn	1095	5	79	0	5	79	1011	0.00000	-0.01889	0.00000	0.00000	0.00000	1.0000000000	1.0000000000	0.36073	-0.44438	3	43	0	2	36	0	0.00000	0.00000
132	69896004	Rheumatoid arthritis	51	403190006	First degree burn	1095	3	79	0	3	79	1013	0.00000	-0.01462	0.00000	0.00000	0.00000	1.0000000000	1.0000000000	0.21644	-0.28266	2	43	0	1	36	0	0.00000	0.00000
130	314994000	Metastasis from malignant tumor of prostate (disorder)	108	40930008	Hypothyroidism (disorder)	1095	1	13	0	1	13	1081	0.00000	-0.00331	0.00000	0.00000	0.00000	1.0000000000	1.0000000000	0.01187	-0.01703	0	11	0	1	2	0	0.00000	0.00000
129	47505003	Posttraumatic stress disorder	108	40930008	Hypothyroidism (disorder)	1095	4	13	0	4	13	1078	0.00000	-0.00664	0.00000	0.00000	0.00000	1.0000000000	1.0000000000	0.04749	-0.06693	1	11	0	3	2	0	0.00000	0.00000
128	86849004	Suicidal deliberate poisoning	108	40930008	Hypothyroidism (disorder)	1095	1	13	0	1	13	1081	0.00000	-0.00331	0.00000	0.00000	0.00000	1.0000000000	1.0000000000	0.01187	-0.01703	0	11	0	1	2	0	0.00000	0.00000
125	1734006	Fracture of the vertebral column with spinal cord injury	108	40930008	Hypothyroidism (disorder)	1095	5	13	0	5	13	1077	0.00000	-0.00742	0.00000	0.00000	0.00000	1.0000000000	1.0000000000	0.05936	-0.08319	3	11	0	2	2	0	0.00000	0.00000
124	1501000119109	Proliferative diabetic retinopathy due to type II diabetes mellitus (disorder)	108	40930008	Hypothyroidism (disorder)	1095	1	13	0	1	13	1081	0.00000	-0.00331	0.00000	0.00000	0.00000	1.0000000000	1.0000000000	0.01187	-0.01703	1	11	0	0	2	0	0.00000	0.00000
118	48333001	Burn injury(morphologic abnormality)	108	40930008	Hypothyroidism (disorder)	1095	1	13	0	1	13	1081	0.00000	-0.00331	0.00000	0.00000	0.00000	1.0000000000	1.0000000000	0.01187	-0.01703	0	11	0	1	2	0	0.00000	0.00000
117	230265002	Familial Alzheimer's disease of early onset (disorder)	108	40930008	Hypothyroidism (disorder)	1095	6	13	0	6	13	1076	0.00000	-0.00814	0.00000	0.00000	0.00000	1.0000000000	1.0000000000	0.07123	-0.09927	2	11	0	4	2	0	0.00000	0.00000
115	36923009	Major depression  single episode	108	40930008	Hypothyroidism (disorder)	1095	6	13	0	6	13	1076	0.00000	-0.00814	0.00000	0.00000	0.00000	1.0000000000	1.0000000000	0.07123	-0.09927	3	11	0	3	2	0	0.00000	0.00000
114	449868002	Smokes tobacco daily	108	40930008	Hypothyroidism (disorder)	1095	9	13	1	8	12	1074	9.35897	0.08341	11.18750	96.55421	1.29627	0.1022698176	0.6291042150	0.10685	0.85354	2	11	0	7	2	1	-1.09861	-2.07944
111	235919008	Cholelithiasis	108	40930008	Hypothyroidism (disorder)	1095	9	13	1	8	12	1074	9.35897	0.08341	11.18750	96.55421	1.29627	0.1022698176	0.6291042150	0.10685	0.85354	7	11	0	2	2	1	-1.09861	-1.09861
109	90560007	Gout	108	40930008	Hypothyroidism (disorder)	1095	4	13	0	4	13	1078	0.00000	-0.00664	0.00000	0.00000	0.00000	1.0000000000	1.0000000000	0.04749	-0.06693	0	11	0	4	2	0	0.00000	0.00000
107	40275004	Contact dermatitis	108	40930008	Hypothyroidism (disorder)	1095	18	13	1	17	12	1065	4.67949	0.05214	5.22059	42.44126	0.64217	0.1948078089	0.8340316782	0.21370	0.72059	9	11	1	9	2	0	2.48491	2.30259
106	24079001	Atopic dermatitis	108	40930008	Hypothyroidism (disorder)	1095	20	13	0	20	13	1062	0.00000	-0.01495	0.00000	0.00000	0.00000	1.0000000000	1.0000000000	0.23744	-0.30736	13	11	0	7	2	0	0.00000	0.00000
102	90781000119102	Microalbuminuria due to type 2 diabetes mellitus (disorder)	108	40930008	Hypothyroidism (disorder)	1095	6	13	0	6	13	1076	0.00000	-0.00814	0.00000	0.00000	0.00000	1.0000000000	1.0000000000	0.07123	-0.09927	3	11	0	3	2	0	0.00000	0.00000
101	433144002	Chronic kidney disease stage 3 (disorder)	108	40930008	Hypothyroidism (disorder)	1095	3	13	0	3	13	1079	0.00000	-0.00575	0.00000	0.00000	0.00000	1.0000000000	1.0000000000	0.03562	-0.05049	1	11	0	2	2	0	0.00000	0.00000
100	161622006	History of lower limb amputation (situation)	108	40930008	Hypothyroidism (disorder)	1095	1	13	0	1	13	1081	0.00000	-0.00331	0.00000	0.00000	0.00000	1.0000000000	1.0000000000	0.01187	-0.01703	0	11	0	1	2	0	0.00000	0.00000
98	1551000119108	Nonproliferative diabetic retinopathy due to type 2 diabetes mellitus (disorder)	108	40930008	Hypothyroidism (disorder)	1095	12	13	0	12	13	1070	0.00000	-0.01154	0.00000	0.00000	0.00000	1.0000000000	1.0000000000	0.14247	-0.19215	7	11	0	5	2	0	0.00000	0.00000
97	403192003	Third degree burn	108	40930008	Hypothyroidism (disorder)	1095	8	13	1	7	12	1075	10.52885	0.08960	12.79762	112.21552	1.45950	0.0914034373	0.5996557347	0.09498	0.86910	3	11	1	5	2	0	2.48491	1.38629
96	283371005	Laceration of forearm	108	40930008	Hypothyroidism (disorder)	1095	75	13	2	73	11	1009	2.24615	0.03704	2.51308	11.55084	0.54676	0.2219848605	0.8794911525	0.89041	0.66626	39	11	2	36	2	0	1.87180	3.02042
94	703151001	History of single seizure (situation)	108	40930008	Hypothyroidism (disorder)	1095	39	13	0	39	13	1043	0.00000	-0.02106	0.00000	0.00000	0.00000	1.0000000000	1.0000000000	0.46301	-0.54894	14	11	0	25	2	0	0.00000	0.00000
93	128613002	Seizure disorder	108	40930008	Hypothyroidism (disorder)	1095	39	13	0	39	13	1043	0.00000	-0.02106	0.00000	0.00000	0.00000	1.0000000000	1.0000000000	0.46301	-0.54894	14	11	0	25	2	0	0.00000	0.00000
89	47693006	Rupture of appendix	108	40930008	Hypothyroidism (disorder)	1095	20	13	0	20	13	1062	0.00000	-0.01495	0.00000	0.00000	0.00000	1.0000000000	1.0000000000	0.23744	-0.30736	10	11	0	10	2	0	0.00000	0.00000
86	713197008	Recurrent rectal polyp	108	40930008	Hypothyroidism (disorder)	1095	22	13	1	21	12	1061	3.82867	0.04440	4.21032	33.87770	0.52326	0.2330383878	0.8937472100	0.26119	0.66522	12	11	1	10	2	0	2.48491	2.56495
82	94260004	Secondary malignant neoplasm of colon	108	40930008	Hypothyroidism (disorder)	1095	4	13	0	4	13	1078	0.00000	-0.00664	0.00000	0.00000	0.00000	1.0000000000	1.0000000000	0.04749	-0.06693	2	11	0	2	2	0	0.00000	0.00000
78	239872002	Osteoarthritis of hip	108	40930008	Hypothyroidism (disorder)	1095	21	13	0	21	13	1061	0.00000	-0.01533	0.00000	0.00000	0.00000	1.0000000000	1.0000000000	0.24932	-0.32114	13	11	0	8	2	0	0.00000	0.00000
76	127013003	Diabetic renal disease (disorder)	108	40930008	Hypothyroidism (disorder)	1095	28	13	0	28	13	1054	0.00000	-0.01776	0.00000	0.00000	0.00000	1.0000000000	1.0000000000	0.33242	-0.41405	10	11	0	18	2	0	0.00000	0.00000
75	431855005	Chronic kidney disease stage 1 (disorder)	108	40930008	Hypothyroidism (disorder)	1095	28	13	0	28	13	1054	0.00000	-0.01776	0.00000	0.00000	0.00000	1.0000000000	1.0000000000	0.33242	-0.41405	10	11	0	18	2	0	0.00000	0.00000
72	35999006	Blighted ovum	108	40930008	Hypothyroidism (disorder)	1095	53	13	1	52	12	1030	1.58926	0.01457	1.65064	12.93703	0.21061	0.4772297237	1.0000000000	0.62922	0.29582	53	11	1	0	2	0	2.48491	3.98898
71	201834006	Localized  primary osteoarthritis of the hand	108	40930008	Hypothyroidism (disorder)	1095	28	13	2	26	11	1056	6.01648	0.08907	7.38462	35.00413	1.55789	0.0413375703	0.3885023469	0.33242	1.17091	19	11	2	9	2	0	1.87180	2.35138
70	87433001	Pulmonary emphysema (disorder)	108	40930008	Hypothyroidism (disorder)	1095	17	13	0	17	13	1065	0.00000	-0.01376	0.00000	0.00000	0.00000	1.0000000000	1.0000000000	0.20183	-0.26523	9	11	0	8	2	0	0.00000	0.00000
69	233604007	Pneumonia	108	40930008	Hypothyroidism (disorder)	1095	7	13	0	7	13	1075	0.00000	-0.00879	0.00000	0.00000	0.00000	1.0000000000	1.0000000000	0.08311	-0.11517	3	11	0	4	2	0	0.00000	0.00000
67	403191005	Second degree burn	108	40930008	Hypothyroidism (disorder)	1095	49	13	2	47	11	1035	3.43799	0.05784	4.00387	18.57828	0.86289	0.1117736129	0.6583985495	0.58174	0.92345	23	11	1	26	2	1	1.38629	-0.11778
64	444448004	Injury of medial collateral ligament of knee	108	40930008	Hypothyroidism (disorder)	1095	32	13	1	31	12	1051	2.63221	0.03104	2.82527	22.41282	0.35614	0.3214054775	1.0000000000	0.37991	0.53543	17	11	1	15	2	0	2.48491	2.89037
63	68496003	Polyp of colon	108	40930008	Hypothyroidism (disorder)	1095	91	13	6	85	7	997	5.55368	0.15027	10.05378	30.58886	3.30442	0.0002986338	0.0090393376	1.08037	1.75052	43	11	6	48	2	0	1.04145	2.10006
59	262574004	Bullet wound	108	40930008	Hypothyroidism (disorder)	1095	20	13	1	19	12	1063	4.21154	0.04802	4.66228	37.68771	0.57676	0.2141376687	0.8672161313	0.23744	0.69264	9	11	1	11	2	0	2.48491	2.30259
58	239720000	Tear of meniscus of knee	108	40930008	Hypothyroidism (disorder)	1095	20	13	0	20	13	1062	0.00000	-0.01495	0.00000	0.00000	0.00000	1.0000000000	1.0000000000	0.23744	-0.30736	10	11	0	10	2	0	0.00000	0.00000
57	192127007	Child attention deficit disorder	108	40930008	Hypothyroidism (disorder)	1095	76	13	0	76	13	1006	0.00000	-0.02993	0.00000	0.00000	0.00000	1.0000000000	1.0000000000	0.90228	-0.92773	24	11	0	52	2	0	0.00000	0.00000
56	92691004	Carcinoma in situ of prostate (disorder)	108	40930008	Hypothyroidism (disorder)	1095	23	13	1	22	12	1060	3.66221	0.04274	4.01515	32.24297	0.50000	0.2423305602	0.9106068739	0.27306	0.65170	0	11	0	23	2	1	-1.09861	-3.17805
54	5602001	Opioid abuse (disorder)	108	40930008	Hypothyroidism (disorder)	1095	7	13	0	7	13	1075	0.00000	-0.00879	0.00000	0.00000	0.00000	1.0000000000	1.0000000000	0.08311	-0.11517	0	11	0	7	2	0	0.00000	0.00000
52	124171000119105	Chronic intractable migraine without aura	108	40930008	Hypothyroidism (disorder)	1095	51	13	1	50	12	1032	1.65158	0.01579	1.72000	13.49029	0.21930	0.4639567846	1.0000000000	0.60548	0.31700	21	11	1	30	2	0	2.48491	3.09104
50	446096008	Perennial allergic rhinitis	108	40930008	Hypothyroidism (disorder)	1095	26	13	0	26	13	1056	0.00000	-0.01709	0.00000	0.00000	0.00000	1.0000000000	1.0000000000	0.30868	-0.38811	14	11	0	12	2	0	0.00000	0.00000
49	88805009	Chronic congestive heart failure (disorder)	108	40930008	Hypothyroidism (disorder)	1095	10	13	1	9	12	1073	8.42308	0.07811	9.93519	84.68833	1.16554	0.1130161273	0.6626957686	0.11872	0.83815	5	11	1	5	2	0	2.48491	1.79176
47	359817006	Closed fracture of hip	108	40930008	Hypothyroidism (disorder)	1095	29	13	0	29	13	1053	0.00000	-0.01808	0.00000	0.00000	0.00000	1.0000000000	1.0000000000	0.34429	-0.42685	11	11	0	18	2	0	0.00000	0.00000
45	263102004	Fracture subluxation of wrist	108	40930008	Hypothyroidism (disorder)	1095	109	13	1	108	12	974	0.77276	-0.00828	0.75154	5.83593	0.09678	1.0000000000	1.0000000000	1.29406	-0.19791	51	11	1	58	2	0	2.48491	3.95124
44	58150001	Fracture of clavicle	108	40930008	Hypothyroidism (disorder)	1095	112	13	1	111	12	971	0.75206	-0.00917	0.72898	5.65940	0.09390	1.0000000000	1.0000000000	1.32968	-0.22013	55	11	1	57	2	0	2.48491	4.02535
43	307731004	Injury of tendon of the rotator cuff of shoulder	108	40930008	Hypothyroidism (disorder)	1095	51	13	1	50	12	1032	1.65158	0.01579	1.72000	13.49029	0.21930	0.4639567846	1.0000000000	0.60548	0.31700	26	11	1	25	2	0	2.48491	3.29584
42	16114001	Fracture of ankle	108	40930008	Hypothyroidism (disorder)	1095	108	13	3	105	10	977	2.33974	0.04858	2.79143	10.30232	0.75634	0.1286965381	0.7047399945	1.28219	0.80958	48	11	3	60	2	0	1.54045	2.83321
41	283385000	Laceration of thigh	108	40930008	Hypothyroidism (disorder)	1095	105	13	4	101	9	981	3.20879	0.07885	4.31683	14.26760	1.30611	0.0289311430	0.3121289194	1.24658	1.15420	50	11	4	55	2	0	1.32176	2.60269
39	74400008	Appendicitis	108	40930008	Hypothyroidism (disorder)	1095	51	13	0	51	13	1031	0.00000	-0.02423	0.00000	0.00000	0.00000	1.0000000000	1.0000000000	0.60548	-0.68300	27	11	0	24	2	0	0.00000	0.00000
38	398254007	Preeclampsia	108	40930008	Hypothyroidism (disorder)	1095	101	13	1	100	12	982	0.83397	-0.00580	0.81833	6.35893	0.10531	1.0000000000	1.0000000000	1.19909	-0.13690	101	11	1	0	2	0	2.48491	4.62497
35	19169002	Miscarriage in first trimester	108	40930008	Hypothyroidism (disorder)	1095	174	13	6	168	7	914	2.90451	0.09074	4.66327	14.04804	1.54798	0.0095903120	0.1500601755	2.06575	1.19111	174	11	6	0	2	0	1.04145	3.40120
33	429007001	History of cardiac arrest (situation)	108	40930008	Hypothyroidism (disorder)	1095	42	13	1	41	12	1041	2.00549	0.02201	2.11585	16.66293	0.26867	0.4002894379	1.0000000000	0.49863	0.41636	24	11	1	18	2	0	2.48491	3.21888
32	410429000	Cardiac Arrest	108	40930008	Hypothyroidism (disorder)	1095	42	13	1	41	12	1041	2.00549	0.02201	2.11585	16.66293	0.26867	0.4002894379	1.0000000000	0.49863	0.41636	24	11	1	18	2	0	2.48491	3.21888
30	399211009	History of myocardial infarction (situation)	108	40930008	Hypothyroidism (disorder)	1095	31	13	0	31	13	1051	0.00000	-0.01871	0.00000	0.00000	0.00000	1.0000000000	1.0000000000	0.36804	-0.45211	2	11	0	29	2	0	0.00000	0.00000
29	22298006	Myocardial Infarction	108	40930008	Hypothyroidism (disorder)	1095	31	13	0	31	13	1051	0.00000	-0.01871	0.00000	0.00000	0.00000	1.0000000000	1.0000000000	0.36804	-0.45211	2	11	0	29	2	0	0.00000	0.00000
27	408512008	Body mass index 40+ - severely obese (finding)	108	40930008	Hypothyroidism (disorder)	1095	97	13	3	94	10	988	2.60508	0.05485	3.15319	11.65636	0.85298	0.1004099512	0.6275578005	1.15160	0.89459	67	11	3	30	2	0	1.54045	3.14988
24	162864005	Body mass index 30+ - obesity (finding)	108	40930008	Hypothyroidism (disorder)	1095	439	13	8	431	5	651	1.53496	0.04797	2.41671	7.43625	0.78540	0.1536390980	0.7717368396	5.21187	0.53490	226	11	8	213	2	0	0.86500	3.37588
23	36971009	Sinusitis (disorder)	108	40930008	Hypothyroidism (disorder)	1095	190	13	4	186	9	896	1.77328	0.03884	2.14098	7.02586	0.65242	0.2576385651	0.9227055586	2.25571	0.61896	84	11	3	106	2	1	0.44183	-1.30553
21	15777000	Prediabetes	108	40930008	Hypothyroidism (disorder)	1095	333	13	8	325	5	757	2.02356	0.07417	3.72677	11.47796	1.21004	0.0279111658	0.3078193827	3.95342	0.86150	159	11	7	174	2	1	-0.15415	-1.99871
20	80394007	Hyperglycemia (disorder)	108	40930008	Hypothyroidism (disorder)	1095	55	13	0	55	13	1027	0.00000	-0.02521	0.00000	0.00000	0.00000	1.0000000000	1.0000000000	0.65297	-0.72506	23	11	0	32	2	0	0.00000	0.00000
19	237602007	Metabolic syndrome X (disorder)	108	40930008	Hypothyroidism (disorder)	1095	64	13	0	64	13	1018	0.00000	-0.02731	0.00000	0.00000	0.00000	1.0000000000	1.0000000000	0.75982	-0.81543	28	11	0	36	2	0	0.00000	0.00000
18	302870006	Hypertriglyceridemia (disorder)	108	40930008	Hypothyroidism (disorder)	1095	64	13	0	64	13	1018	0.00000	-0.02731	0.00000	0.00000	0.00000	1.0000000000	1.0000000000	0.75982	-0.81543	28	11	0	36	2	0	0.00000	0.00000
17	368581000119106	Neuropathy due to type 2 diabetes mellitus (disorder)	108	40930008	Hypothyroidism (disorder)	1095	28	13	0	28	13	1054	0.00000	-0.01776	0.00000	0.00000	0.00000	1.0000000000	1.0000000000	0.33242	-0.41405	7	11	0	21	2	0	0.00000	0.00000
129	47505003	Posttraumatic stress disorder	82	94260004	Secondary malignant neoplasm of colon	1095	4	4	0	4	4	1087	0.00000	-0.00367	0.00000	0.00000	0.00000	1.0000000000	1.0000000000	0.01461	-0.02093	1	2	0	3	2	0	0.00000	0.00000
15	40055000	Chronic sinusitis (disorder)	108	40930008	Hypothyroidism (disorder)	1095	216	13	3	213	10	869	1.16987	0.00923	1.22394	4.48599	0.33394	0.7281982860	1.0000000000	2.56438	0.16635	104	11	3	112	2	0	1.54045	3.57422
14	10509002	Acute bronchitis (disorder)	108	40930008	Hypothyroidism (disorder)	1095	863	13	12	851	1	231	1.17123	0.03620	3.25734	25.18090	0.42136	0.3213031803	1.0000000000	10.24566	0.20914	418	11	11	445	2	1	-0.40547	-2.43676
13	370247008	Facial laceration	108	40930008	Hypothyroidism (disorder)	1095	109	13	1	108	12	974	0.77276	-0.00828	0.75154	5.83593	0.09678	1.0000000000	1.0000000000	1.29406	-0.19791	55	11	1	54	2	0	2.48491	4.02535
125	1734006	Fracture of the vertebral column with spinal cord injury	82	94260004	Secondary malignant neoplasm of colon	1095	5	4	0	5	4	1086	0.00000	-0.00410	0.00000	0.00000	0.00000	1.0000000000	1.0000000000	0.01826	-0.02611	3	2	0	2	2	0	0.00000	0.00000
10	62106007	Concussion with no loss of consciousness	108	40930008	Hypothyroidism (disorder)	1095	206	13	3	203	10	879	1.22666	0.01196	1.29901	4.76268	0.35430	0.7198885116	1.0000000000	2.44566	0.21522	96	11	3	110	2	0	1.54045	3.49651
8	233678006	Childhood asthma	108	40930008	Hypothyroidism (disorder)	1095	45	13	0	45	13	1037	0.00000	-0.02269	0.00000	0.00000	0.00000	1.0000000000	1.0000000000	0.53425	-0.61753	25	11	0	20	2	0	0.00000	0.00000
7	75498004	Acute bacterial sinusitis (disorder)	108	40930008	Hypothyroidism (disorder)	1095	187	13	4	183	9	899	1.80173	0.03988	2.18336	7.16592	0.66524	0.2539790458	0.9133257124	2.22009	0.63483	89	11	3	98	2	1	0.44183	-1.17194
6	39848009	Whiplash injury to neck	108	40930008	Hypothyroidism (disorder)	1095	182	13	2	180	11	902	0.92561	-0.00364	0.91111	4.14548	0.20025	1.0000000000	1.0000000000	2.16073	-0.07530	92	11	1	90	2	1	1.38629	0.02174
5	284549007	Laceration of hand	108	40930008	Hypothyroidism (disorder)	1095	104	13	0	104	13	978	0.00000	-0.03551	0.00000	0.00000	0.00000	0.6254626351	1.0000000000	1.23470	-1.16008	54	11	0	50	2	0	0.00000	0.00000
117	230265002	Familial Alzheimer's disease of early onset (disorder)	82	94260004	Secondary malignant neoplasm of colon	1095	6	4	0	6	4	1085	0.00000	-0.00449	0.00000	0.00000	0.00000	1.0000000000	1.0000000000	0.02192	-0.03128	2	2	0	4	2	0	0.00000	0.00000
1	444814009	Viral sinusitis (disorder)	108	40930008	Hypothyroidism (disorder)	1095	993	13	13	980	0	102	1.10272	0.03513	0.00000	0.00000	0.00000	0.6236188883	1.0000000000	11.78904	0.13052	478	11	11	515	2	2	0.00000	-1.76043
109	90560007	Gout	82	94260004	Secondary malignant neoplasm of colon	1095	4	4	0	4	4	1087	0.00000	-0.00367	0.00000	0.00000	0.00000	1.0000000000	1.0000000000	0.01461	-0.02093	0	2	0	4	2	0	0.00000	0.00000
106	24079001	Atopic dermatitis	82	94260004	Secondary malignant neoplasm of colon	1095	20	4	0	20	4	1071	0.00000	-0.00826	0.00000	0.00000	0.00000	1.0000000000	1.0000000000	0.07306	-0.10173	13	2	0	7	2	0	0.00000	0.00000
102	90781000119102	Microalbuminuria due to type 2 diabetes mellitus (disorder)	82	94260004	Secondary malignant neoplasm of colon	1095	6	4	0	6	4	1085	0.00000	-0.00449	0.00000	0.00000	0.00000	1.0000000000	1.0000000000	0.02192	-0.03128	3	2	0	3	2	0	0.00000	0.00000
98	1551000119108	Nonproliferative diabetic retinopathy due to type 2 diabetes mellitus (disorder)	82	94260004	Secondary malignant neoplasm of colon	1095	12	4	1	11	3	1080	22.81250	0.13903	32.72727	339.68704	3.15312	0.0431785002	0.3985498161	0.04384	0.93811	7	2	0	5	2	1	-1.09861	-1.79176
97	403192003	Third degree burn	82	94260004	Secondary malignant neoplasm of colon	1095	8	4	0	8	4	1083	0.00000	-0.00519	0.00000	0.00000	0.00000	1.0000000000	1.0000000000	0.02922	-0.04156	3	2	0	5	2	0	0.00000	0.00000
96	283371005	Laceration of forearm	82	94260004	Secondary malignant neoplasm of colon	1095	75	4	0	75	4	1016	0.00000	-0.01642	0.00000	0.00000	0.00000	1.0000000000	1.0000000000	0.27397	-0.34933	39	2	0	36	2	0	0.00000	0.00000
94	703151001	History of single seizure (situation)	82	94260004	Secondary malignant neoplasm of colon	1095	39	4	0	39	4	1052	0.00000	-0.01164	0.00000	0.00000	0.00000	1.0000000000	1.0000000000	0.14247	-0.19215	14	2	0	25	2	0	0.00000	0.00000
93	128613002	Seizure disorder	82	94260004	Secondary malignant neoplasm of colon	1095	39	4	0	39	4	1052	0.00000	-0.01164	0.00000	0.00000	0.00000	1.0000000000	1.0000000000	0.14247	-0.19215	14	2	0	25	2	0	0.00000	0.00000
89	47693006	Rupture of appendix	82	94260004	Secondary malignant neoplasm of colon	1095	20	4	0	20	4	1071	0.00000	-0.00826	0.00000	0.00000	0.00000	1.0000000000	1.0000000000	0.07306	-0.10173	10	2	0	10	2	0	0.00000	0.00000
86	713197008	Recurrent rectal polyp	82	94260004	Secondary malignant neoplasm of colon	1095	22	4	0	22	4	1069	0.00000	-0.00867	0.00000	0.00000	0.00000	1.0000000000	1.0000000000	0.08037	-0.11152	12	2	0	10	2	0	0.00000	0.00000
76	127013003	Diabetic renal disease (disorder)	82	94260004	Secondary malignant neoplasm of colon	1095	28	4	1	27	3	1064	9.77679	0.08609	13.13580	130.38871	1.32335	0.0985562783	0.6237397336	0.10228	0.85951	10	2	0	18	2	1	-1.09861	-2.94444
75	431855005	Chronic kidney disease stage 1 (disorder)	82	94260004	Secondary malignant neoplasm of colon	1095	28	4	1	27	3	1064	9.77679	0.08609	13.13580	130.38871	1.32335	0.0985562783	0.6237397336	0.10228	0.85951	10	2	0	18	2	1	-1.09861	-2.94444
72	35999006	Blighted ovum	82	94260004	Secondary malignant neoplasm of colon	1095	53	4	1	52	3	1039	5.16509	0.05688	6.66026	65.13132	0.68107	0.1802279749	0.8113031609	0.19361	0.74467	53	2	1	0	2	0	1.09861	3.98898
69	233604007	Pneumonia	82	94260004	Secondary malignant neoplasm of colon	1095	7	4	0	7	4	1084	0.00000	-0.00486	0.00000	0.00000	0.00000	1.0000000000	1.0000000000	0.02557	-0.03643	3	2	0	4	2	0	0.00000	0.00000
67	403191005	Second degree burn	82	94260004	Secondary malignant neoplasm of colon	1095	49	4	1	48	3	1043	5.58673	0.06011	7.24306	70.92601	0.73967	0.1675492660	0.7942848378	0.17900	0.76244	23	2	0	26	2	1	-1.09861	-3.29584
64	444448004	Injury of medial collateral ligament of knee	82	94260004	Secondary malignant neoplasm of colon	1095	32	4	0	32	4	1059	0.00000	-0.01051	0.00000	0.00000	0.00000	1.0000000000	1.0000000000	0.11689	-0.15949	17	2	0	15	2	0	0.00000	0.00000
63	68496003	Polyp of colon	82	94260004	Secondary malignant neoplasm of colon	1095	91	4	0	91	4	1000	0.00000	-0.01823	0.00000	0.00000	0.00000	1.0000000000	1.0000000000	0.33242	-0.41405	43	2	0	48	2	0	0.00000	0.00000
58	239720000	Tear of meniscus of knee	82	94260004	Secondary malignant neoplasm of colon	1095	20	4	0	20	4	1071	0.00000	-0.00826	0.00000	0.00000	0.00000	1.0000000000	1.0000000000	0.07306	-0.10173	10	2	0	10	2	0	0.00000	0.00000
57	192127007	Child attention deficit disorder	82	94260004	Secondary malignant neoplasm of colon	1095	76	4	1	75	3	1016	3.60197	0.04303	4.51556	43.93983	0.46405	0.2503433784	0.9133257124	0.27763	0.64653	24	2	0	52	2	1	-1.09861	-3.97029
54	5602001	Opioid abuse (disorder)	82	94260004	Secondary malignant neoplasm of colon	1095	7	4	0	7	4	1084	0.00000	-0.00486	0.00000	0.00000	0.00000	1.0000000000	1.0000000000	0.02557	-0.03643	0	2	0	7	2	0	0.00000	0.00000
50	446096008	Perennial allergic rhinitis	82	94260004	Secondary malignant neoplasm of colon	1095	26	4	0	26	4	1065	0.00000	-0.00944	0.00000	0.00000	0.00000	1.0000000000	1.0000000000	0.09498	-0.13090	14	2	0	12	2	0	0.00000	0.00000
49	88805009	Chronic congestive heart failure (disorder)	82	94260004	Secondary malignant neoplasm of colon	1095	10	4	0	10	4	1081	0.00000	-0.00581	0.00000	0.00000	0.00000	1.0000000000	1.0000000000	0.03653	-0.05176	5	2	0	5	2	0	0.00000	0.00000
47	359817006	Closed fracture of hip	82	94260004	Secondary malignant neoplasm of colon	1095	29	4	0	29	4	1062	0.00000	-0.00999	0.00000	0.00000	0.00000	1.0000000000	1.0000000000	0.10594	-0.14527	11	2	0	18	2	0	0.00000	0.00000
44	58150001	Fracture of clavicle	82	94260004	Secondary malignant neoplasm of colon	1095	112	4	0	112	4	979	0.00000	-0.02044	0.00000	0.00000	0.00000	1.0000000000	1.0000000000	0.40913	-0.49481	55	2	0	57	2	0	0.00000	0.00000
43	307731004	Injury of tendon of the rotator cuff of shoulder	82	94260004	Secondary malignant neoplasm of colon	1095	51	4	1	50	3	1041	5.36765	0.05845	6.94000	67.91084	0.70922	0.1739068632	0.7996618359	0.18630	0.75353	26	2	1	25	2	0	1.09861	3.29584
42	16114001	Fracture of ankle	82	94260004	Secondary malignant neoplasm of colon	1095	108	4	1	107	3	984	2.53472	0.03074	3.06542	29.72939	0.31608	0.3402929047	1.0000000000	0.39452	0.52023	48	2	1	60	2	0	1.09861	3.89182
41	283385000	Laceration of thigh	82	94260004	Secondary malignant neoplasm of colon	1095	105	4	0	105	4	986	0.00000	-0.01972	0.00000	0.00000	0.00000	1.0000000000	1.0000000000	0.38356	-0.46839	50	2	0	55	2	0	0.00000	0.00000
39	74400008	Appendicitis	82	94260004	Secondary malignant neoplasm of colon	1095	51	4	0	51	4	1040	0.00000	-0.01338	0.00000	0.00000	0.00000	1.0000000000	1.0000000000	0.18630	-0.24647	27	2	0	24	2	0	0.00000	0.00000
38	398254007	Preeclampsia	82	94260004	Secondary malignant neoplasm of colon	1095	101	4	0	101	4	990	0.00000	-0.01930	0.00000	0.00000	0.00000	1.0000000000	1.0000000000	0.36895	-0.45307	101	2	0	0	2	0	0.00000	0.00000
35	19169002	Miscarriage in first trimester	82	94260004	Secondary malignant neoplasm of colon	1095	174	4	2	172	2	919	3.14655	0.05649	5.34302	38.18758	0.74757	0.1209931534	0.6887664724	0.63562	0.87513	174	2	2	0	2	0	0.69315	4.47734
33	429007001	History of cardiac arrest (situation)	82	94260004	Secondary malignant neoplasm of colon	1095	42	4	0	42	4	1049	0.00000	-0.01209	0.00000	0.00000	0.00000	1.0000000000	1.0000000000	0.15342	-0.20592	24	2	0	18	2	0	0.00000	0.00000
32	410429000	Cardiac Arrest	82	94260004	Secondary malignant neoplasm of colon	1095	42	4	0	42	4	1049	0.00000	-0.01209	0.00000	0.00000	0.00000	1.0000000000	1.0000000000	0.15342	-0.20592	24	2	0	18	2	0	0.00000	0.00000
30	399211009	History of myocardial infarction (situation)	82	94260004	Secondary malignant neoplasm of colon	1095	31	4	0	31	4	1060	0.00000	-0.01034	0.00000	0.00000	0.00000	1.0000000000	1.0000000000	0.11324	-0.15477	2	2	0	29	2	0	0.00000	0.00000
27	408512008	Body mass index 40+ - severely obese (finding)	82	94260004	Secondary malignant neoplasm of colon	1095	97	4	0	97	4	994	0.00000	-0.01888	0.00000	0.00000	0.00000	1.0000000000	1.0000000000	0.35434	-0.43759	67	2	0	30	2	0	0.00000	0.00000
24	162864005	Body mass index 30+ - obesity (finding)	82	94260004	Secondary malignant neoplasm of colon	1095	439	4	4	435	0	656	2.49431	0.07402	0.00000	0.00000	0.00000	0.0256231380	0.2905941929	1.60365	0.94139	226	2	2	213	2	2	0.00000	0.05871
23	36971009	Sinusitis (disorder)	82	94260004	Secondary malignant neoplasm of colon	1095	190	4	0	190	4	901	0.00000	-0.02774	0.00000	0.00000	0.00000	1.0000000000	1.0000000000	0.69406	-0.76049	84	2	0	106	2	0	0.00000	0.00000
21	15777000	Prediabetes	82	94260004	Secondary malignant neoplasm of colon	1095	333	4	1	332	3	759	0.82207	-0.00712	0.76205	7.35294	0.07898	1.0000000000	1.0000000000	1.21644	-0.14824	159	2	1	174	2	0	1.09861	5.07517
20	80394007	Hyperglycemia (disorder)	82	94260004	Secondary malignant neoplasm of colon	1095	55	4	1	54	3	1037	4.97727	0.05538	6.40123	62.56087	0.65497	0.1865127411	0.8181443419	0.20091	0.73587	23	2	0	32	2	1	-1.09861	-3.49651
18	302870006	Hypertriglyceridemia (disorder)	82	94260004	Secondary malignant neoplasm of colon	1095	64	4	1	63	3	1028	4.27734	0.04944	5.43915	53.04017	0.55777	0.2143481492	0.8672161313	0.23379	0.69690	28	2	0	36	2	1	-1.09861	-3.61092
17	368581000119106	Neuropathy due to type 2 diabetes mellitus (disorder)	82	94260004	Secondary malignant neoplasm of colon	1095	28	4	0	28	4	1063	0.00000	-0.00981	0.00000	0.00000	0.00000	1.0000000000	1.0000000000	0.10228	-0.14049	7	2	0	21	2	0	0.00000	0.00000
129	47505003	Posttraumatic stress disorder	56	92691004	Carcinoma in situ of prostate (disorder)	1095	4	23	1	3	22	1069	11.90217	0.09669	16.19697	161.90868	1.62031	0.0815162066	0.5629813232	0.08402	0.88361	1	0	0	3	23	1	-3.17805	-1.38629
15	40055000	Chronic sinusitis (disorder)	82	94260004	Secondary malignant neoplasm of colon	1095	216	4	2	214	2	877	2.53472	0.04607	4.09813	29.25896	0.57400	0.1763210047	0.8029498763	0.78904	0.74578	104	2	1	112	2	1	0.00000	-0.07343
14	10509002	Acute bronchitis (disorder)	82	94260004	Secondary malignant neoplasm of colon	1095	863	4	4	859	0	232	1.26883	0.03139	0.00000	0.00000	0.00000	0.5842857155	1.0000000000	3.15251	0.26794	418	2	2	445	2	2	0.00000	-0.06230
13	370247008	Facial laceration	82	94260004	Secondary malignant neoplasm of colon	1095	109	4	0	109	4	982	0.00000	-0.02013	0.00000	0.00000	0.00000	1.0000000000	1.0000000000	0.39817	-0.48354	55	2	0	54	2	0	0.00000	0.00000
125	1734006	Fracture of the vertebral column with spinal cord injury	56	92691004	Carcinoma in situ of prostate (disorder)	1095	5	23	0	5	23	1067	0.00000	-0.00992	0.00000	0.00000	0.00000	1.0000000000	1.0000000000	0.10502	-0.14408	3	0	0	2	23	0	0.00000	0.00000
124	1501000119109	Proliferative diabetic retinopathy due to type II diabetes mellitus (disorder)	56	92691004	Carcinoma in situ of prostate (disorder)	1095	1	23	0	1	23	1071	0.00000	-0.00443	0.00000	0.00000	0.00000	1.0000000000	1.0000000000	0.02100	-0.02999	1	0	0	0	23	0	0.00000	0.00000
10	62106007	Concussion with no loss of consciousness	82	94260004	Secondary malignant neoplasm of colon	1095	206	4	3	203	1	888	3.98665	0.08705	13.12315	126.80911	1.35808	0.0226490157	0.2721606699	0.75251	1.19058	96	2	1	110	2	2	0.40547	0.54936
7	75498004	Acute bacterial sinusitis (disorder)	82	94260004	Secondary malignant neoplasm of colon	1095	187	4	2	185	2	906	2.92781	0.05297	4.89730	34.98846	0.68547	0.1373791614	0.7296699408	0.68311	0.83384	89	2	1	98	2	1	0.00000	-0.09531
6	39848009	Whiplash injury to neck	82	94260004	Secondary malignant neoplasm of colon	1095	182	4	1	181	3	910	1.50412	0.01363	1.67587	16.20183	0.17335	0.5172179176	1.0000000000	0.66484	0.26462	92	2	1	90	2	0	1.09861	4.53260
5	284549007	Laceration of hand	82	94260004	Secondary malignant neoplasm of colon	1095	104	4	1	103	3	988	2.63221	0.03202	3.19741	31.01888	0.32959	0.3295168874	1.0000000000	0.37991	0.53543	54	2	1	50	2	0	1.09861	4.00733
117	230265002	Familial Alzheimer's disease of early onset (disorder)	56	92691004	Carcinoma in situ of prostate (disorder)	1095	6	23	0	6	23	1066	0.00000	-0.01087	0.00000	0.00000	0.00000	1.0000000000	1.0000000000	0.12603	-0.17124	2	0	0	4	23	0	0.00000	0.00000
115	36923009	Major depression  single episode	56	92691004	Carcinoma in situ of prostate (disorder)	1095	6	23	1	5	22	1067	7.93478	0.07540	9.70000	86.51085	1.08761	0.1198515648	0.6843537581	0.12603	0.82876	3	0	0	3	23	1	-3.17805	-1.38629
114	449868002	Smokes tobacco daily	56	92691004	Carcinoma in situ of prostate (disorder)	1095	9	23	6	3	17	1069	31.73913	0.40989	125.76471	545.00862	29.02112	0.0000000034	0.0000002502	0.18904	2.55756	2	0	0	7	23	6	-1.57554	-0.77319
111	235919008	Cholelithiasis	56	92691004	Carcinoma in situ of prostate (disorder)	1095	9	23	1	8	22	1064	5.28986	0.05720	6.04545	50.43056	0.72471	0.1744981661	0.8000743861	0.18904	0.75020	7	0	0	2	23	1	-3.17805	-1.09861
109	90560007	Gout	56	92691004	Carcinoma in situ of prostate (disorder)	1095	4	23	0	4	23	1068	0.00000	-0.00887	0.00000	0.00000	0.00000	1.0000000000	1.0000000000	0.08402	-0.11639	0	0	0	4	23	0	0.00000	0.00000
107	40275004	Contact dermatitis	56	92691004	Carcinoma in situ of prostate (disorder)	1095	18	23	0	18	23	1054	0.00000	-0.01894	0.00000	0.00000	0.00000	1.0000000000	1.0000000000	0.37808	-0.46266	9	0	0	9	23	0	0.00000	0.00000
106	24079001	Atopic dermatitis	56	92691004	Carcinoma in situ of prostate (disorder)	1095	20	23	0	20	23	1052	0.00000	-0.01998	0.00000	0.00000	0.00000	1.0000000000	1.0000000000	0.42009	-0.50598	13	0	0	7	23	0	0.00000	0.00000
102	90781000119102	Microalbuminuria due to type 2 diabetes mellitus (disorder)	56	92691004	Carcinoma in situ of prostate (disorder)	1095	6	23	1	5	22	1067	7.93478	0.07540	9.70000	86.51085	1.08761	0.1198515648	0.6843537581	0.12603	0.82876	3	0	0	3	23	1	-3.17805	-1.38629
98	1551000119108	Nonproliferative diabetic retinopathy due to type 2 diabetes mellitus (disorder)	56	92691004	Carcinoma in situ of prostate (disorder)	1095	12	23	1	11	22	1061	3.96739	0.04575	4.38430	35.45367	0.54217	0.2258905629	0.8836028956	0.25205	0.67570	7	0	0	5	23	1	-3.17805	-1.79176
97	403192003	Third degree burn	56	92691004	Carcinoma in situ of prostate (disorder)	1095	8	23	1	7	22	1065	5.95109	0.06222	6.91558	58.62581	0.81577	0.1566536716	0.7747075658	0.16804	0.77591	3	0	0	5	23	1	-3.17805	-1.79176
96	283371005	Laceration of forearm	56	92691004	Carcinoma in situ of prostate (disorder)	1095	75	23	2	73	21	999	1.26957	0.01071	1.30333	5.66699	0.29975	0.6677591314	1.0000000000	1.57534	0.22020	39	0	0	36	23	2	-2.52573	-2.94444
94	703151001	History of single seizure (situation)	56	92691004	Carcinoma in situ of prostate (disorder)	1095	39	23	2	37	21	1035	2.44147	0.04058	2.66409	11.78553	0.60221	0.1960135967	0.8340316782	0.81918	0.72168	14	0	0	25	23	2	-2.52573	-2.60269
93	128613002	Seizure disorder	56	92691004	Carcinoma in situ of prostate (disorder)	1095	39	23	2	37	21	1035	2.44147	0.04058	2.66409	11.78553	0.60221	0.1960135967	0.8340316782	0.81918	0.72168	14	0	0	25	23	2	-2.52573	-2.60269
89	47693006	Rupture of appendix	56	92691004	Carcinoma in situ of prostate (disorder)	1095	20	23	0	20	23	1052	0.00000	-0.01998	0.00000	0.00000	0.00000	1.0000000000	1.0000000000	0.42009	-0.50598	10	0	0	10	23	0	0.00000	0.00000
86	713197008	Recurrent rectal polyp	56	92691004	Carcinoma in situ of prostate (disorder)	1095	22	23	3	19	20	1053	6.49209	0.11519	8.31316	30.36734	2.27575	0.0096148733	0.1501767935	0.46210	1.45196	12	0	0	10	23	3	-2.15948	-1.46634
82	94260004	Secondary malignant neoplasm of colon	56	92691004	Carcinoma in situ of prostate (disorder)	1095	4	23	1	3	22	1069	11.90217	0.09669	16.19697	161.90868	1.62031	0.0815162066	0.5629813232	0.08402	0.88361	2	0	0	2	23	1	-3.17805	-1.09861
78	239872002	Osteoarthritis of hip	56	92691004	Carcinoma in situ of prostate (disorder)	1095	21	23	1	20	22	1052	2.26708	0.02595	2.39091	18.61452	0.30710	0.3623474060	1.0000000000	0.44110	0.47283	13	0	0	8	23	1	-3.17805	-2.19722
76	127013003	Diabetic renal disease (disorder)	56	92691004	Carcinoma in situ of prostate (disorder)	1095	28	23	4	24	19	1048	6.80124	0.13765	9.19298	29.08089	2.90606	0.0021719852	0.0462759364	0.58813	1.65460	10	0	0	18	23	4	-1.90954	-1.70475
75	431855005	Chronic kidney disease stage 1 (disorder)	56	92691004	Carcinoma in situ of prostate (disorder)	1095	28	23	4	24	19	1048	6.80124	0.13765	9.19298	29.08089	2.90606	0.0021719852	0.0462759364	0.58813	1.65460	10	0	0	18	23	4	-1.90954	-1.70475
72	35999006	Blighted ovum	56	92691004	Carcinoma in situ of prostate (disorder)	1095	53	23	0	53	23	1019	0.00000	-0.03303	0.00000	0.00000	0.00000	0.6227236154	1.0000000000	1.11324	-1.07946	53	0	0	0	23	0	0.00000	0.00000
71	201834006	Localized  primary osteoarthritis of the hand	56	92691004	Carcinoma in situ of prostate (disorder)	1095	28	23	1	27	22	1045	1.70031	0.01662	1.75926	13.53121	0.22873	0.4522447128	1.0000000000	0.58813	0.33267	19	0	0	9	23	1	-3.17805	-2.30259
69	233604007	Pneumonia	56	92691004	Carcinoma in situ of prostate (disorder)	1095	7	23	1	6	22	1066	6.80124	0.06816	8.07576	69.93411	0.93256	0.1384405584	0.7306035772	0.14703	0.80209	3	0	0	4	23	1	-3.17805	-1.60944
67	403191005	Second degree burn	56	92691004	Carcinoma in situ of prostate (disorder)	1095	49	23	1	48	22	1024	0.97161	-0.00090	0.96970	7.34515	0.12802	1.0000000000	1.0000000000	1.02922	-0.02093	23	0	0	26	23	1	-3.17805	-3.29584
64	444448004	Injury of medial collateral ligament of knee	56	92691004	Carcinoma in situ of prostate (disorder)	1095	32	23	2	30	21	1042	2.97554	0.05021	3.30794	14.75304	0.74171	0.1431324972	0.7404942507	0.67215	0.84326	17	0	0	15	23	2	-2.52573	-2.14007
63	68496003	Polyp of colon	56	92691004	Carcinoma in situ of prostate (disorder)	1095	91	23	7	84	16	988	3.66221	0.11740	5.14583	12.85689	2.05957	0.0017704264	0.0387920165	1.91142	1.45828	43	0	0	48	23	7	-1.45529	-2.06142
59	262574004	Bullet wound	56	92691004	Carcinoma in situ of prostate (disorder)	1095	20	23	0	20	23	1052	0.00000	-0.01998	0.00000	0.00000	0.00000	1.0000000000	1.0000000000	0.42009	-0.50598	9	0	0	11	23	0	0.00000	0.00000
58	239720000	Tear of meniscus of knee	56	92691004	Carcinoma in situ of prostate (disorder)	1095	20	23	0	20	23	1052	0.00000	-0.01998	0.00000	0.00000	0.00000	1.0000000000	1.0000000000	0.42009	-0.50598	10	0	0	10	23	0	0.00000	0.00000
57	192127007	Child attention deficit disorder	56	92691004	Carcinoma in situ of prostate (disorder)	1095	76	23	0	76	23	996	0.00000	-0.04000	0.00000	0.00000	0.00000	0.3982835573	1.0000000000	1.59635	-1.37648	24	0	0	52	23	0	0.00000	0.00000
54	5602001	Opioid abuse (disorder)	56	92691004	Carcinoma in situ of prostate (disorder)	1095	7	23	3	4	20	1068	20.40373	0.22797	40.05000	190.76960	8.40806	0.0002687608	0.0082778311	0.14703	1.80209	0	0	0	7	23	3	-2.15948	-1.20397
52	124171000119105	Chronic intractable migraine without aura	56	92691004	Carcinoma in situ of prostate (disorder)	1095	51	23	4	47	19	1025	3.73402	0.08851	4.59127	14.03155	1.50231	0.0191724220	0.2418752952	1.07123	1.27144	21	0	0	30	23	4	-1.90954	-2.14007
50	446096008	Perennial allergic rhinitis	56	92691004	Carcinoma in situ of prostate (disorder)	1095	26	23	0	26	23	1046	0.00000	-0.02284	0.00000	0.00000	0.00000	1.0000000000	1.0000000000	0.54612	-0.62865	14	0	0	12	23	0	0.00000	0.00000
49	88805009	Chronic congestive heart failure (disorder)	56	92691004	Carcinoma in situ of prostate (disorder)	1095	10	23	0	10	23	1062	0.00000	-0.01406	0.00000	0.00000	0.00000	1.0000000000	1.0000000000	0.21005	-0.27506	5	0	0	5	23	0	0.00000	0.00000
47	359817006	Closed fracture of hip	56	92691004	Carcinoma in situ of prostate (disorder)	1095	29	23	0	29	23	1043	0.00000	-0.02416	0.00000	0.00000	0.00000	1.0000000000	1.0000000000	0.60913	-0.68628	11	0	0	18	23	0	0.00000	0.00000
45	263102004	Fracture subluxation of wrist	56	92691004	Carcinoma in situ of prostate (disorder)	1095	109	23	4	105	19	967	1.74711	0.03639	1.93885	5.80637	0.64741	0.2761296428	0.9505356881	2.28950	0.60406	51	0	0	58	23	4	-1.90954	-2.74084
44	58150001	Fracture of clavicle	56	92691004	Carcinoma in situ of prostate (disorder)	1095	112	23	4	108	19	964	1.70031	0.03462	1.87914	5.62500	0.62776	0.2834569308	0.9659403678	2.35251	0.57669	55	0	0	57	23	4	-1.90954	-2.72458
43	307731004	Injury of tendon of the rotator cuff of shoulder	56	92691004	Carcinoma in situ of prostate (disorder)	1095	51	23	1	50	22	1022	0.93350	-0.00215	0.92909	7.03202	0.12275	1.0000000000	1.0000000000	1.07123	-0.05049	26	0	0	25	23	1	-3.17805	-3.25810
42	16114001	Fracture of ankle	56	92691004	Carcinoma in situ of prostate (disorder)	1095	108	23	2	106	21	966	0.88164	-0.00573	0.86792	3.75297	0.20072	1.0000000000	1.0000000000	2.26849	-0.12366	48	0	0	60	23	2	-2.52573	-3.43399
41	283385000	Laceration of thigh	56	92691004	Carcinoma in situ of prostate (disorder)	1095	105	23	1	104	22	968	0.45342	-0.02607	0.42308	3.17083	0.05645	0.7172320547	1.0000000000	2.20548	-0.68054	50	0	0	55	23	1	-3.17805	-4.02535
39	74400008	Appendicitis	56	92691004	Carcinoma in situ of prostate (disorder)	1095	51	23	1	50	22	1022	0.93350	-0.00215	0.92909	7.03202	0.12275	1.0000000000	1.0000000000	1.07123	-0.05049	27	0	0	24	23	1	-3.17805	-3.21888
38	398254007	Preeclampsia	56	92691004	Carcinoma in situ of prostate (disorder)	1095	101	23	0	101	23	971	0.00000	-0.04669	0.00000	0.00000	0.00000	0.2604084814	0.9271528076	2.12146	-1.64222	101	0	0	0	23	0	0.00000	0.00000
35	19169002	Miscarriage in first trimester	56	92691004	Carcinoma in situ of prostate (disorder)	1095	174	23	0	174	23	898	0.00000	-0.06367	0.00000	0.00000	0.00000	0.0378046384	0.3669636219	3.65479	-2.21872	174	0	0	0	23	0	0.00000	0.00000
33	429007001	History of cardiac arrest (situation)	56	92691004	Carcinoma in situ of prostate (disorder)	1095	42	23	1	41	22	1031	1.13354	0.00391	1.14302	8.68716	0.15039	0.5970337586	1.0000000000	0.88219	0.08759	24	0	0	18	23	1	-3.17805	-2.94444
32	410429000	Cardiac Arrest	56	92691004	Carcinoma in situ of prostate (disorder)	1095	42	23	1	41	22	1031	1.13354	0.00391	1.14302	8.68716	0.15039	0.5970337586	1.0000000000	0.88219	0.08759	24	0	0	18	23	1	-3.17805	-2.94444
30	399211009	History of myocardial infarction (situation)	56	92691004	Carcinoma in situ of prostate (disorder)	1095	31	23	1	30	22	1042	1.53576	0.01340	1.57879	12.10086	0.20598	0.4869403360	1.0000000000	0.65114	0.27654	2	0	0	29	23	1	-3.17805	-3.40120
27	408512008	Body mass index 40+ - severely obese (finding)	56	92691004	Carcinoma in situ of prostate (disorder)	1095	97	23	1	96	22	976	0.49081	-0.02325	0.46212	3.46608	0.06161	0.7139766032	1.0000000000	2.03744	-0.60286	67	0	0	30	23	1	-3.17805	-3.43399
24	162864005	Body mass index 30+ - obesity (finding)	56	92691004	Carcinoma in situ of prostate (disorder)	1095	439	23	13	426	10	646	1.40982	0.04911	1.97136	4.53650	0.85667	0.1317105588	0.7138846116	9.22100	0.45389	226	0	0	213	23	13	-1.01857	-2.85559
23	36971009	Sinusitis (disorder)	56	92691004	Carcinoma in situ of prostate (disorder)	1095	190	23	7	183	16	889	1.75400	0.05060	2.12534	5.23965	0.86209	0.0989815992	0.6250794807	3.99087	0.68071	84	0	0	106	23	7	-1.45529	-2.78148
21	15777000	Prediabetes	56	92691004	Carcinoma in situ of prostate (disorder)	1095	333	23	16	317	7	755	2.28750	0.12467	5.44389	13.36065	2.21815	0.0001058702	0.0036160633	6.99452	1.08845	159	0	0	174	23	16	-0.89097	-2.47444
20	80394007	Hyperglycemia (disorder)	56	92691004	Carcinoma in situ of prostate (disorder)	1095	55	23	4	51	19	1021	3.46245	0.08295	4.21465	12.84371	1.38304	0.0247313913	0.2898426609	1.15525	1.21407	23	0	0	32	23	4	-1.90954	-2.19722
19	237602007	Metabolic syndrome X (disorder)	56	92691004	Carcinoma in situ of prostate (disorder)	1095	64	23	4	60	19	1012	2.97554	0.07210	3.55088	10.76624	1.17114	0.0405847434	0.3849833570	1.34429	1.09278	28	0	0	36	23	4	-1.90954	-2.30259
18	302870006	Hypertriglyceridemia (disorder)	56	92691004	Carcinoma in situ of prostate (disorder)	1095	64	23	4	60	19	1012	2.97554	0.07210	3.55088	10.76624	1.17114	0.0405847434	0.3849833570	1.34429	1.09278	28	0	0	36	23	4	-1.90954	-2.30259
17	368581000119106	Neuropathy due to type 2 diabetes mellitus (disorder)	56	92691004	Carcinoma in situ of prostate (disorder)	1095	28	23	2	26	21	1046	3.40062	0.05696	3.83150	17.20070	0.85348	0.1146806889	0.6697718480	0.58813	0.91764	7	0	0	21	23	2	-2.52573	-2.44235
129	47505003	Posttraumatic stress disorder	30	399211009	History of myocardial infarction (situation)	1095	4	31	0	4	31	1060	0.00000	-0.01034	0.00000	0.00000	0.00000	1.0000000000	1.0000000000	0.11324	-0.15477	1	2	0	3	29	0	0.00000	0.00000
15	40055000	Chronic sinusitis (disorder)	56	92691004	Carcinoma in situ of prostate (disorder)	1095	216	23	12	204	11	868	2.64493	0.11944	4.64171	10.66866	2.01951	0.0004495529	0.0128028349	4.53699	1.23134	104	0	0	112	23	12	-1.07044	-2.33537
14	10509002	Acute bronchitis (disorder)	56	92691004	Carcinoma in situ of prostate (disorder)	1095	863	23	21	842	2	230	1.15850	0.04478	2.86817	12.32201	0.66762	0.1963466663	0.8342357389	18.12694	0.20190	418	0	0	445	23	21	-0.73967	-3.09966
13	370247008	Facial laceration	56	92691004	Carcinoma in situ of prostate (disorder)	1095	109	23	4	105	19	967	1.74711	0.03639	1.93885	5.80637	0.64741	0.2761296428	0.9505356881	2.28950	0.60406	55	0	0	54	23	4	-1.90954	-2.67415
125	1734006	Fracture of the vertebral column with spinal cord injury	30	399211009	History of myocardial infarction (situation)	1095	5	31	0	5	31	1059	0.00000	-0.01156	0.00000	0.00000	0.00000	1.0000000000	1.0000000000	0.14155	-0.19100	3	2	0	2	29	0	0.00000	0.00000
10	62106007	Concussion with no loss of consciousness	56	92691004	Carcinoma in situ of prostate (disorder)	1095	206	23	2	204	21	868	0.46222	-0.03792	0.40523	1.74210	0.09426	0.2851312483	0.9659403678	4.32694	-0.82834	96	0	0	110	23	2	-2.52573	-4.02535
7	75498004	Acute bacterial sinusitis (disorder)	56	92691004	Carcinoma in situ of prostate (disorder)	1095	187	23	7	180	16	892	1.78214	0.05199	2.16806	5.34595	0.87926	0.0940135063	0.6075918218	3.92785	0.69904	89	0	0	98	23	7	-1.45529	-2.70805
6	39848009	Whiplash injury to neck	56	92691004	Carcinoma in situ of prostate (disorder)	1095	182	23	4	178	19	894	1.04634	0.00303	1.05736	3.14536	0.35545	1.0000000000	1.0000000000	3.82283	0.05205	92	0	0	90	23	4	-1.90954	-3.15700
5	284549007	Laceration of hand	56	92691004	Carcinoma in situ of prostate (disorder)	1095	104	23	4	100	19	972	1.83110	0.03944	2.04632	6.13327	0.68274	0.2656141656	0.9344724470	2.18447	0.65087	54	0	0	50	23	4	-1.90954	-2.60269
117	230265002	Familial Alzheimer's disease of early onset (disorder)	30	399211009	History of myocardial infarction (situation)	1095	6	31	0	6	31	1058	0.00000	-0.01267	0.00000	0.00000	0.00000	1.0000000000	1.0000000000	0.16986	-0.22634	2	2	0	4	29	0	0.00000	0.00000
1	444814009	Viral sinusitis (disorder)	56	92691004	Carcinoma in situ of prostate (disorder)	1095	993	23	23	970	0	102	1.10272	0.04695	0.00000	0.00000	0.00000	0.1580460463	0.7763448205	20.85753	0.13490	478	0	0	515	23	23	-0.69315	-3.15236
109	90560007	Gout	30	399211009	History of myocardial infarction (situation)	1095	4	31	0	4	31	1060	0.00000	-0.01034	0.00000	0.00000	0.00000	1.0000000000	1.0000000000	0.11324	-0.15477	0	2	0	4	29	0	0.00000	0.00000
102	90781000119102	Microalbuminuria due to type 2 diabetes mellitus (disorder)	30	399211009	History of myocardial infarction (situation)	1095	6	31	0	6	31	1058	0.00000	-0.01267	0.00000	0.00000	0.00000	1.0000000000	1.0000000000	0.16986	-0.22634	3	2	0	3	29	0	0.00000	0.00000
98	1551000119108	Nonproliferative diabetic retinopathy due to type 2 diabetes mellitus (disorder)	30	399211009	History of myocardial infarction (situation)	1095	12	31	0	12	31	1052	0.00000	-0.01797	0.00000	0.00000	0.00000	1.0000000000	1.0000000000	0.33973	-0.42194	7	2	0	5	29	0	0.00000	0.00000
97	403192003	Third degree burn	30	399211009	History of myocardial infarction (situation)	1095	8	31	0	8	31	1056	0.00000	-0.01464	0.00000	0.00000	0.00000	1.0000000000	1.0000000000	0.22648	-0.29453	3	2	0	5	29	0	0.00000	0.00000
96	283371005	Laceration of forearm	30	399211009	History of myocardial infarction (situation)	1095	75	31	4	71	27	993	1.88387	0.04091	2.07199	6.08501	0.70553	0.1570134909	0.7751768407	2.12329	0.67886	39	2	1	36	29	3	-1.26851	1.12393
94	703151001	History of single seizure (situation)	30	399211009	History of myocardial infarction (situation)	1095	39	31	1	38	30	1026	0.90571	-0.00309	0.90000	6.77434	0.11957	1.0000000000	1.0000000000	1.10411	-0.07321	14	2	0	25	29	1	-3.40120	-3.25810
93	128613002	Seizure disorder	30	399211009	History of myocardial infarction (situation)	1095	39	31	1	38	30	1026	0.90571	-0.00309	0.90000	6.77434	0.11957	1.0000000000	1.0000000000	1.10411	-0.07321	14	2	0	25	29	1	-3.40120	-3.25810
89	47693006	Rupture of appendix	30	399211009	History of myocardial infarction (situation)	1095	20	31	0	20	31	1044	0.00000	-0.02328	0.00000	0.00000	0.00000	1.0000000000	1.0000000000	0.56621	-0.64728	10	2	0	10	29	0	0.00000	0.00000
86	713197008	Recurrent rectal polyp	30	399211009	History of myocardial infarction (situation)	1095	22	31	0	22	31	1042	0.00000	-0.02444	0.00000	0.00000	0.00000	1.0000000000	1.0000000000	0.62283	-0.69851	12	2	0	10	29	0	0.00000	0.00000
75	431855005	Chronic kidney disease stage 1 (disorder)	30	399211009	History of myocardial infarction (situation)	1095	28	31	0	28	31	1036	0.00000	-0.02765	0.00000	0.00000	0.00000	1.0000000000	1.0000000000	0.79269	-0.84213	10	2	0	18	29	0	0.00000	0.00000
72	35999006	Blighted ovum	30	399211009	History of myocardial infarction (situation)	1095	53	31	0	53	31	1011	0.00000	-0.03850	0.00000	0.00000	0.00000	0.3961538006	1.0000000000	1.50046	-1.32219	53	2	0	0	29	0	0.00000	0.00000
69	233604007	Pneumonia	30	399211009	History of myocardial infarction (situation)	1095	7	31	0	7	31	1057	0.00000	-0.01369	0.00000	0.00000	0.00000	1.0000000000	1.0000000000	0.19817	-0.26084	3	2	0	4	29	0	0.00000	0.00000
67	403191005	Second degree burn	30	399211009	History of myocardial infarction (situation)	1095	49	31	3	46	28	1018	2.16261	0.04295	2.37112	8.08599	0.69530	0.1576381908	0.7763448205	1.38721	0.74467	23	2	0	26	29	3	-2.36712	-2.26868
64	444448004	Injury of medial collateral ligament of knee	30	399211009	History of myocardial infarction (situation)	1095	32	31	0	32	31	1032	0.00000	-0.02962	0.00000	0.00000	0.00000	1.0000000000	1.0000000000	0.90594	-0.93050	17	2	0	15	29	0	0.00000	0.00000
63	68496003	Polyp of colon	30	399211009	History of myocardial infarction (situation)	1095	91	31	3	88	28	976	1.16448	0.00845	1.18831	3.98692	0.35418	0.7381617939	1.0000000000	2.57626	0.16155	43	2	0	48	29	3	-2.36712	-2.83321
58	239720000	Tear of meniscus of knee	30	399211009	History of myocardial infarction (situation)	1095	20	31	0	20	31	1044	0.00000	-0.02328	0.00000	0.00000	0.00000	1.0000000000	1.0000000000	0.56621	-0.64728	10	2	0	10	29	0	0.00000	0.00000
50	446096008	Perennial allergic rhinitis	30	399211009	History of myocardial infarction (situation)	1095	26	31	0	26	31	1038	0.00000	-0.02662	0.00000	0.00000	0.00000	1.0000000000	1.0000000000	0.73607	-0.79583	14	2	0	12	29	0	0.00000	0.00000
49	88805009	Chronic congestive heart failure (disorder)	30	399211009	History of myocardial infarction (situation)	1095	10	31	0	10	31	1054	0.00000	-0.01639	0.00000	0.00000	0.00000	1.0000000000	1.0000000000	0.28311	-0.35964	5	2	0	5	29	0	0.00000	0.00000
47	359817006	Closed fracture of hip	30	399211009	History of myocardial infarction (situation)	1095	29	31	1	28	30	1036	1.21802	0.00614	1.23333	9.36648	0.16240	0.5699470383	1.0000000000	0.82100	0.13527	11	2	0	18	29	1	-3.40120	-2.94444
44	58150001	Fracture of clavicle	30	399211009	History of myocardial infarction (situation)	1095	112	31	1	111	30	953	0.31538	-0.03944	0.28619	2.11896	0.03865	0.3592873418	1.0000000000	3.17078	-1.06032	55	2	0	57	29	1	-3.40120	-4.06044
43	307731004	Injury of tendon of the rotator cuff of shoulder	30	399211009	History of myocardial infarction (situation)	1095	51	31	1	50	30	1014	0.69260	-0.01160	0.67600	5.05780	0.09035	1.0000000000	1.0000000000	1.44384	-0.28915	26	2	0	25	29	1	-3.40120	-3.25810
42	16114001	Fracture of ankle	30	399211009	History of myocardial infarction (situation)	1095	108	31	2	106	29	958	0.65412	-0.01953	0.62329	2.64888	0.14666	0.7611328001	1.0000000000	3.05753	-0.43564	48	2	0	60	29	2	-2.74084	-3.43399
41	283385000	Laceration of thigh	30	399211009	History of myocardial infarction (situation)	1095	105	31	2	103	29	961	0.67281	-0.01819	0.64345	2.73555	0.15135	0.7609318498	1.0000000000	2.97260	-0.40512	50	2	0	55	29	2	-2.74084	-3.34990
39	74400008	Appendicitis	30	399211009	History of myocardial infarction (situation)	1095	51	31	0	51	31	1013	0.00000	-0.03773	0.00000	0.00000	0.00000	0.3948460482	1.0000000000	1.44384	-1.28915	27	2	0	24	29	0	0.00000	0.00000
38	398254007	Preeclampsia	30	399211009	History of myocardial infarction (situation)	1095	101	31	1	100	30	964	0.34973	-0.03538	0.32133	2.38143	0.04336	0.3520950881	1.0000000000	2.85936	-0.94836	101	2	1	0	29	0	1.09861	4.62497
35	19169002	Miscarriage in first trimester	30	399211009	History of myocardial infarction (situation)	1095	174	31	2	172	29	892	0.40601	-0.04407	0.35766	1.51284	0.08456	0.2102870816	0.8633769890	4.92603	-0.98210	174	2	2	0	29	0	0.69315	4.47734
33	429007001	History of cardiac arrest (situation)	30	399211009	History of myocardial infarction (situation)	1095	42	31	0	42	31	1022	0.00000	-0.03409	0.00000	0.00000	0.00000	0.6278836387	1.0000000000	1.18904	-1.13030	24	2	0	18	29	0	0.00000	0.00000
32	410429000	Cardiac Arrest	30	399211009	History of myocardial infarction (situation)	1095	42	31	0	42	31	1022	0.00000	-0.03409	0.00000	0.00000	0.00000	0.6278836387	1.0000000000	1.18904	-1.13030	24	2	0	18	29	0	0.00000	0.00000
27	408512008	Body mass index 40+ - severely obese (finding)	30	399211009	History of myocardial infarction (situation)	1095	97	31	1	96	30	968	0.36415	-0.03384	0.33611	2.49193	0.04533	0.5141181051	1.0000000000	2.74612	-0.90540	67	2	0	30	29	1	-3.40120	-3.43399
24	162864005	Body mass index 30+ - obesity (finding)	30	399211009	History of myocardial infarction (situation)	1095	439	31	13	426	18	638	1.04600	0.00642	1.08164	2.23071	0.52447	0.8539488105	1.0000000000	12.42831	0.06015	226	2	2	213	29	11	-0.59784	1.72245
21	15777000	Prediabetes	30	399211009	History of myocardial infarction (situation)	1095	333	31	15	318	16	746	1.59111	0.06670	2.19929	4.50266	1.07423	0.0452311682	0.4084765375	9.42740	0.61769	159	2	1	174	29	14	-0.02353	2.47779
20	80394007	Hyperglycemia (disorder)	30	399211009	History of myocardial infarction (situation)	1095	55	31	1	54	30	1010	0.64223	-0.01404	0.62346	4.65810	0.08345	1.0000000000	1.0000000000	1.55708	-0.35450	23	2	0	32	29	1	-3.40120	-3.49651
18	302870006	Hypertriglyceridemia (disorder)	30	399211009	History of myocardial infarction (situation)	1095	64	31	1	63	30	1001	0.55192	-0.01906	0.52963	3.94712	0.07107	1.0000000000	1.0000000000	1.81187	-0.49153	28	2	0	36	29	1	-3.40120	-3.61092
17	368581000119106	Neuropathy due to type 2 diabetes mellitus (disorder)	30	399211009	History of myocardial infarction (situation)	1095	28	31	1	27	30	1037	1.26152	0.00723	1.28025	9.73495	0.16837	0.5570786582	1.0000000000	0.79269	0.15787	7	2	0	21	29	1	-3.40120	-3.09104
129	47505003	Posttraumatic stress disorder	4	195662009	Acute viral pharyngitis (disorder)	1095	4	890	4	0	886	205	1.23034	0.02906	0.00000	0.00000	0.00000	1.0000000000	1.0000000000	3.25114	0.23408	1	430	1	3	460	3	1.02699	0.00000
15	40055000	Chronic sinusitis (disorder)	30	399211009	History of myocardial infarction (situation)	1095	216	31	11	205	20	859	1.79884	0.06759	2.30463	4.88544	1.08718	0.0366857865	0.3598076353	6.11507	0.75408	104	2	1	112	29	10	-0.26236	2.15252
14	10509002	Acute bronchitis (disorder)	30	399211009	History of myocardial infarction (situation)	1095	863	31	26	837	5	227	1.06418	0.02113	1.41027	3.71381	0.53553	0.6560085655	1.0000000000	24.43196	0.08632	418	2	1	445	29	25	0.32850	3.10401
13	370247008	Facial laceration	30	399211009	History of myocardial infarction (situation)	1095	109	31	1	108	30	956	0.32406	-0.03836	0.29506	2.18519	0.03984	0.3556378871	1.0000000000	3.08584	-1.03063	55	2	0	54	29	1	-3.40120	-4.00733
125	1734006	Fracture of the vertebral column with spinal cord injury	4	195662009	Acute viral pharyngitis (disorder)	1095	5	890	4	1	886	204	0.98427	-0.00222	0.92099	8.28367	0.10240	1.0000000000	1.0000000000	4.06393	-0.01833	3	430	3	2	460	1	-1.16127	-0.40547
124	1501000119109	Proliferative diabetic retinopathy due to type II diabetes mellitus (disorder)	4	195662009	Acute viral pharyngitis (disorder)	1095	1	890	1	0	889	205	1.23034	0.01451	0.00000	0.00000	0.00000	1.0000000000	1.0000000000	0.81279	0.14179	1	430	1	0	460	0	6.06611	0.69315
10	62106007	Concussion with no loss of consciousness	30	399211009	History of myocardial infarction (situation)	1095	206	31	9	197	22	867	1.54322	0.04463	1.80042	3.97022	0.81645	0.1594953564	0.7786708778	5.83196	0.54963	96	2	0	110	29	9	-1.44036	-2.58190
121	254637007	Non-small cell lung cancer (disorder)	4	195662009	Acute viral pharyngitis (disorder)	1095	8	890	8	0	882	205	1.23034	0.04117	0.00000	0.00000	0.00000	0.3643124531	1.0000000000	6.50228	0.26260	0	430	0	8	460	8	-4.06903	-0.69315
7	75498004	Acute bacterial sinusitis (disorder)	30	399211009	History of myocardial infarction (situation)	1095	187	31	10	177	21	887	1.88891	0.06886	2.38633	5.15462	1.10475	0.0298744272	0.3180139089	5.29406	0.80544	89	2	2	98	29	8	-0.83833	1.23371
6	39848009	Whiplash injury to neck	30	399211009	History of myocardial infarction (situation)	1095	182	31	4	178	27	886	0.77632	-0.01705	0.73741	2.13342	0.25488	0.8063456354	1.0000000000	5.15251	-0.29925	92	2	0	90	29	4	-2.11021	-3.15700
118	48333001	Burn injury(morphologic abnormality)	4	195662009	Acute viral pharyngitis (disorder)	1095	1	890	0	1	890	204	0.00000	-0.06300	0.00000	0.00000	0.00000	0.1872146119	0.8181443419	0.81279	-0.85821	0	430	0	1	460	0	0.00000	0.00000
117	230265002	Familial Alzheimer's disease of early onset (disorder)	4	195662009	Acute viral pharyngitis (disorder)	1095	6	890	6	0	884	205	1.23034	0.03562	0.00000	0.00000	0.00000	0.6005690654	1.0000000000	4.87671	0.25235	2	430	2	4	460	4	0.62169	0.00000
115	36923009	Major depression  single episode	4	195662009	Acute viral pharyngitis (disorder)	1095	6	890	6	0	884	205	1.23034	0.03562	0.00000	0.00000	0.00000	0.6005690654	1.0000000000	4.87671	0.25235	3	430	3	3	460	3	-0.06699	0.00000
114	449868002	Smokes tobacco daily	4	195662009	Acute viral pharyngitis (disorder)	1095	9	890	9	0	881	205	1.23034	0.04369	0.00000	0.00000	0.00000	0.2225180088	0.8794911525	7.31507	0.26620	2	430	2	7	460	7	1.17486	0.00000
112	49436004	Atrial Fibrillation	4	195662009	Acute viral pharyngitis (disorder)	1095	35	890	31	4	859	201	1.08973	0.03397	1.81345	5.19545	0.63297	0.3771052155	1.0000000000	28.44749	0.11993	9	430	7	26	460	24	1.12999	0.09271
111	235919008	Cholelithiasis	4	195662009	Acute viral pharyngitis (disorder)	1095	9	890	9	0	881	205	1.23034	0.04369	0.00000	0.00000	0.00000	0.2225180088	0.8794911525	7.31507	0.26620	7	430	7	2	460	2	-1.30839	0.00000
110	65275009	Acute Cholecystitis	4	195662009	Acute viral pharyngitis (disorder)	1095	9	890	9	0	881	205	1.23034	0.04369	0.00000	0.00000	0.00000	0.2225180088	0.8794911525	7.31507	0.26620	7	430	7	2	460	2	-1.30839	0.00000
109	90560007	Gout	4	195662009	Acute viral pharyngitis (disorder)	1095	4	890	4	0	886	205	1.23034	0.02906	0.00000	0.00000	0.00000	1.0000000000	1.0000000000	3.25114	0.23408	0	430	0	4	460	4	-4.75359	-0.69315
108	40930008	Hypothyroidism (disorder)	4	195662009	Acute viral pharyngitis (disorder)	1095	13	890	12	1	878	204	1.13570	0.03099	2.78815	21.56470	0.36049	0.4815731522	1.0000000000	10.56621	0.16860	11	430	10	2	460	2	-1.65823	0.04879
107	40275004	Contact dermatitis	4	195662009	Acute viral pharyngitis (disorder)	1095	18	890	16	2	874	203	1.09363	0.02522	1.85812	8.14539	0.42387	0.5511804136	1.0000000000	14.63014	0.12120	9	430	8	9	460	8	-0.06625	0.00000
106	24079001	Atopic dermatitis	4	195662009	Acute viral pharyngitis (disorder)	1095	20	890	14	6	876	199	0.86124	-0.03944	0.53006	1.39641	0.20120	0.2408560958	0.9095097439	16.25571	-0.20211	13	430	9	7	460	5	-0.64532	0.01835
105	363406005	Malignant tumor of colon	4	195662009	Acute viral pharyngitis (disorder)	1095	6	890	6	0	884	205	1.23034	0.03562	0.00000	0.00000	0.00000	0.6005690654	1.0000000000	4.87671	0.25235	4	430	4	2	460	2	-0.75567	0.00000
104	367498001	Seasonal allergic rhinitis	4	195662009	Acute viral pharyngitis (disorder)	1095	20	890	13	7	877	198	0.79972	-0.05692	0.41929	1.06449	0.16515	0.0778398910	0.5519212949	16.25571	-0.30165	9	430	6	11	460	7	0.08546	-0.02817
102	90781000119102	Microalbuminuria due to type 2 diabetes mellitus (disorder)	4	195662009	Acute viral pharyngitis (disorder)	1095	6	890	6	0	884	205	1.23034	0.03562	0.00000	0.00000	0.00000	0.6005690654	1.0000000000	4.87671	0.25235	3	430	3	3	460	3	-0.06699	0.00000
101	433144002	Chronic kidney disease stage 3 (disorder)	4	195662009	Acute viral pharyngitis (disorder)	1095	3	890	3	0	887	205	1.23034	0.02516	0.00000	0.00000	0.00000	1.0000000000	1.0000000000	2.43836	0.21828	1	430	1	2	460	2	0.62369	0.00000
100	161622006	History of lower limb amputation (situation)	4	195662009	Acute viral pharyngitis (disorder)	1095	1	890	1	0	889	205	1.23034	0.01451	0.00000	0.00000	0.00000	1.0000000000	1.0000000000	0.81279	0.14179	0	430	0	1	460	1	-6.13340	-0.69315
99	30832001	Rupture of patellar tendon	4	195662009	Acute viral pharyngitis (disorder)	1095	23	890	19	4	871	201	1.01637	0.00499	1.09615	3.25723	0.36889	1.0000000000	1.0000000000	18.69406	0.02224	14	430	12	9	460	7	-0.59402	-0.05349
98	1551000119108	Nonproliferative diabetic retinopathy due to type 2 diabetes mellitus (disorder)	4	195662009	Acute viral pharyngitis (disorder)	1095	12	890	12	0	878	205	1.23034	0.05052	0.00000	0.00000	0.00000	0.1377313422	0.7296699408	9.75342	0.27372	7	430	7	5	460	5	-0.39858	0.00000
97	403192003	Third degree burn	4	195662009	Acute viral pharyngitis (disorder)	1095	8	890	6	2	884	203	0.92275	-0.01381	0.68891	3.43811	0.13804	0.6483430592	1.0000000000	6.50228	-0.09997	3	430	2	5	460	4	0.62169	0.10536
96	283371005	Laceration of forearm	4	195662009	Acute viral pharyngitis (disorder)	1095	75	890	70	5	820	200	1.14831	0.08380	3.41463	8.57140	1.36031	0.0033861160	0.0664951367	60.95890	0.19651	39	430	38	36	460	32	-0.22186	-0.04755
95	84757009	Epilepsy	4	195662009	Acute viral pharyngitis (disorder)	1095	30	890	24	6	866	199	0.98427	-0.00550	0.91917	2.27842	0.37081	0.8138203362	1.0000000000	24.38356	-0.02197	13	430	10	17	460	14	0.26204	0.03798
94	703151001	History of single seizure (situation)	4	195662009	Acute viral pharyngitis (disorder)	1095	39	890	31	8	859	197	0.97796	-0.00883	0.88868	1.96303	0.40231	0.8340104477	1.0000000000	31.69863	-0.03116	14	430	11	25	460	20	0.51310	0.01005
93	128613002	Seizure disorder	4	195662009	Acute viral pharyngitis (disorder)	1095	39	890	31	8	859	197	0.97796	-0.00883	0.88868	1.96303	0.40231	0.8340104477	1.0000000000	31.69863	-0.03116	14	430	11	25	460	20	0.51310	0.01005
91	64859006	Osteoporosis (disorder)	4	195662009	Acute viral pharyngitis (disorder)	1095	37	890	34	3	856	202	1.13058	0.05088	2.67445	8.79440	0.81333	0.1302232193	0.7099996392	30.07306	0.17169	24	430	21	13	460	13	-0.52720	0.06899
89	47693006	Rupture of appendix	4	195662009	Acute viral pharyngitis (disorder)	1095	20	890	20	0	870	205	1.23034	0.06546	0.00000	0.00000	0.00000	0.0211278286	0.2593847263	16.25571	0.28332	10	430	10	10	460	10	-0.06596	0.00000
86	713197008	Recurrent rectal polyp	4	195662009	Acute viral pharyngitis (disorder)	1095	22	890	21	1	869	204	1.17441	0.05204	4.92980	36.86180	0.65930	0.0997633173	0.6255159994	17.88128	0.22055	12	430	12	10	460	9	-0.34697	-0.05407
85	241929008	Acute allergic reaction	4	195662009	Acute viral pharyngitis (disorder)	1095	47	890	33	14	857	191	0.86385	-0.06007	0.52534	1.00080	0.27576	0.0555336248	0.4577222146	38.20091	-0.20535	25	430	18	22	460	15	-0.24084	-0.03204
83	110030002	Concussion injury of brain	4	195662009	Acute viral pharyngitis (disorder)	1095	7	890	6	1	884	204	1.05457	0.00912	1.38462	11.56398	0.16579	1.0000000000	1.0000000000	5.68950	0.06546	1	430	1	6	460	5	1.53351	-0.09531
82	94260004	Secondary malignant neoplasm of colon	4	195662009	Acute viral pharyngitis (disorder)	1095	4	890	4	0	886	205	1.23034	0.02906	0.00000	0.00000	0.00000	1.0000000000	1.0000000000	3.25114	0.23408	2	430	2	2	460	2	-0.06714	0.00000
81	236077008	Protracted diarrhea	4	195662009	Acute viral pharyngitis (disorder)	1095	4	890	4	0	886	205	1.23034	0.02906	0.00000	0.00000	0.00000	1.0000000000	1.0000000000	3.25114	0.23408	2	430	2	2	460	2	-0.06714	0.00000
80	6072007	Bleeding from anus	4	195662009	Acute viral pharyngitis (disorder)	1095	4	890	4	0	886	205	1.23034	0.02906	0.00000	0.00000	0.00000	1.0000000000	1.0000000000	3.25114	0.23408	2	430	2	2	460	2	-0.06714	0.00000
79	45816000	Pyelonephritis	4	195662009	Acute viral pharyngitis (disorder)	1095	1	890	1	0	889	205	1.23034	0.01451	0.00000	0.00000	0.00000	1.0000000000	1.0000000000	0.81279	0.14179	1	430	1	0	460	0	6.06611	0.69315
78	239872002	Osteoarthritis of hip	4	195662009	Acute viral pharyngitis (disorder)	1095	21	890	20	1	870	204	1.17175	0.05004	4.68966	35.14583	0.62576	0.1527524630	0.7701672144	17.06849	0.21691	13	430	12	8	460	8	-0.46262	0.04082
76	127013003	Diabetic renal disease (disorder)	4	195662009	Acute viral pharyngitis (disorder)	1095	28	890	28	0	862	205	1.23034	0.07775	0.00000	0.00000	0.00000	0.0052424406	0.0931740363	22.75799	0.28764	10	430	10	18	460	18	0.50495	0.00000
75	431855005	Chronic kidney disease stage 1 (disorder)	4	195662009	Acute viral pharyngitis (disorder)	1095	28	890	28	0	862	205	1.23034	0.07775	0.00000	0.00000	0.00000	0.0052424406	0.0931740363	22.75799	0.28764	10	430	10	18	460	18	0.50495	0.00000
73	196416002	Impacted molars	4	195662009	Acute viral pharyngitis (disorder)	1095	49	890	46	3	844	202	1.15501	0.06991	3.66983	11.91854	1.12997	0.0225716432	0.2721606699	39.82648	0.20316	25	430	23	24	460	23	-0.06412	0.02105
72	35999006	Blighted ovum	4	195662009	Acute viral pharyngitis (disorder)	1095	53	890	47	6	843	199	1.09105	0.04279	1.84915	4.38568	0.77966	0.2053522021	0.8543040902	43.07763	0.12299	53	430	47	0	460	0	2.31737	0.75502
71	201834006	Localized  primary osteoarthritis of the hand	4	195662009	Acute viral pharyngitis (disorder)	1095	28	890	28	0	862	205	1.23034	0.07775	0.00000	0.00000	0.00000	0.0052424406	0.0931740363	22.75799	0.28764	19	430	19	9	460	9	-0.79079	0.00000
70	87433001	Pulmonary emphysema (disorder)	4	195662009	Acute viral pharyngitis (disorder)	1095	17	890	17	0	873	205	1.23034	0.06027	0.00000	0.00000	0.00000	0.0546248892	0.4520620234	13.81735	0.28071	9	430	9	8	460	8	-0.18175	0.00000
69	233604007	Pneumonia	4	195662009	Acute viral pharyngitis (disorder)	1095	7	890	6	1	884	204	1.05457	0.00912	1.38462	11.56398	0.16579	1.0000000000	1.0000000000	5.68950	0.06546	3	430	2	4	460	4	0.62169	0.22314
68	26929004	Alzheimer's disease (disorder)	4	195662009	Acute viral pharyngitis (disorder)	1095	23	890	21	2	869	203	1.12335	0.03765	2.45282	10.54513	0.57053	0.2853364518	0.9659403678	18.69406	0.15974	15	430	14	8	460	7	-0.74365	-0.03390
67	403191005	Second degree burn	4	195662009	Acute viral pharyngitis (disorder)	1095	49	890	44	5	846	200	1.10479	0.04726	2.08038	5.31368	0.81450	0.1354802320	0.7251496809	39.82648	0.14042	23	430	20	26	460	24	0.10948	0.03150
65	239873007	Osteoarthritis of knee	4	195662009	Acute viral pharyngitis (disorder)	1095	57	890	50	7	840	198	1.07924	0.03869	1.68367	3.76952	0.75202	0.2264032805	0.8836028956	46.32877	0.10778	30	430	26	27	460	24	-0.13963	0.01348
64	444448004	Injury of medial collateral ligament of knee	4	195662009	Acute viral pharyngitis (disorder)	1095	32	890	27	5	863	200	1.03810	0.01377	1.25145	3.28990	0.47604	0.8192517160	1.0000000000	26.00913	0.05198	17	430	14	15	460	13	-0.13738	0.02767
63	68496003	Polyp of colon	4	195662009	Acute viral pharyngitis (disorder)	1095	91	890	85	6	805	199	1.14922	0.09360	3.50207	8.13098	1.50837	0.0010902559	0.0267325863	73.96347	0.19815	43	430	40	48	460	45	0.04596	0.00402
62	185086009	Chronic obstructive bronchitis (disorder)	4	195662009	Acute viral pharyngitis (disorder)	1095	6	890	6	0	884	205	1.23034	0.03562	0.00000	0.00000	0.00000	0.6005690654	1.0000000000	4.87671	0.25235	4	430	4	2	460	2	-0.75567	0.00000
59	262574004	Bullet wound	4	195662009	Acute viral pharyngitis (disorder)	1095	20	890	17	3	873	202	1.04579	0.01301	1.31119	4.51685	0.38062	1.0000000000	1.0000000000	16.25571	0.06092	9	430	7	11	460	10	0.28388	0.08474
58	239720000	Tear of meniscus of knee	4	195662009	Acute viral pharyngitis (disorder)	1095	20	890	19	1	871	204	1.16882	0.04798	4.45006	33.43391	0.59230	0.1494035668	0.7580719708	16.25571	0.21293	10	430	9	10	460	10	0.03713	0.05407
57	192127007	Child attention deficit disorder	4	195662009	Acute viral pharyngitis (disorder)	1095	76	890	66	10	824	195	1.06845	0.03895	1.56189	3.09276	0.78878	0.2248092708	0.8806400682	61.77169	0.09405	24	430	19	52	460	47	0.78422	0.07179
56	92691004	Carcinoma in situ of prostate (disorder)	4	195662009	Acute viral pharyngitis (disorder)	1095	23	890	22	1	868	204	1.17684	0.05397	5.17051	38.58181	0.69292	0.1011517613	0.6283865258	18.69406	0.22387	0	430	0	23	460	22	-3.08690	-0.71562
117	230265002	Familial Alzheimer's disease of early onset (disorder)	5	284549007	Laceration of hand	1095	6	104	1	5	103	986	1.75481	0.01815	1.91456	16.54521	0.22155	0.4513054294	1.0000000000	0.56986	0.34936	2	54	1	4	50	0	4.00733	1.09861
54	5602001	Opioid abuse (disorder)	4	195662009	Acute viral pharyngitis (disorder)	1095	7	890	7	0	883	205	1.23034	0.03850	0.00000	0.00000	0.00000	0.3594066783	1.0000000000	5.68950	0.25810	0	430	0	7	460	7	-4.20042	-0.69315
53	7200002	Alcoholism	4	195662009	Acute viral pharyngitis (disorder)	1095	5	890	5	0	885	205	1.23034	0.03251	0.00000	0.00000	0.00000	0.5905006408	1.0000000000	4.06393	0.24471	0	430	0	5	460	5	-4.53260	-0.69315
52	124171000119105	Chronic intractable migraine without aura	4	195662009	Acute viral pharyngitis (disorder)	1095	51	890	49	2	841	203	1.18209	0.08386	5.91379	24.51970	1.42632	0.0028487949	0.0575084034	41.45205	0.23609	21	430	20	30	460	29	0.28845	0.00760
50	446096008	Perennial allergic rhinitis	4	195662009	Acute viral pharyngitis (disorder)	1095	26	890	18	8	872	197	0.85177	-0.04817	0.50831	1.18578	0.21790	0.1253281588	0.6945902319	21.13242	-0.22016	14	430	9	12	460	9	-0.06610	0.09097
49	88805009	Chronic congestive heart failure (disorder)	4	195662009	Acute viral pharyngitis (disorder)	1095	10	890	9	1	881	204	1.10730	0.02146	2.08400	16.54159	0.26255	0.6981624812	1.0000000000	8.12785	0.13165	5	430	5	5	460	4	-0.28768	-0.11778
47	359817006	Closed fracture of hip	4	195662009	Acute viral pharyngitis (disorder)	1095	29	890	27	2	863	203	1.14549	0.05000	3.17555	13.46257	0.74905	0.1438899651	0.7404942507	23.57078	0.18848	11	430	10	18	460	17	0.44989	0.01980
46	62564004	Concussion with loss of consciousness	4	195662009	Acute viral pharyngitis (disorder)	1095	67	890	60	7	830	198	1.10179	0.05415	2.04475	4.54167	0.92059	0.0764651842	0.5465890774	54.45662	0.13745	36	430	33	31	460	27	-0.25121	-0.02701
45	263102004	Fracture subluxation of wrist	4	195662009	Acute viral pharyngitis (disorder)	1095	109	890	96	13	794	192	1.08360	0.05792	1.78570	3.25473	0.97972	0.0689879110	0.5158227278	88.59361	0.11459	51	430	48	58	460	48	-0.06087	-0.06832
44	58150001	Fracture of clavicle	4	195662009	Acute viral pharyngitis (disorder)	1095	112	890	93	19	797	186	1.02162	0.01521	1.14231	1.91874	0.68007	0.7018403905	1.0000000000	91.03196	0.03053	55	430	45	57	460	48	-0.00263	0.01575
43	307731004	Injury of tendon of the rotator cuff of shoulder	4	195662009	Acute viral pharyngitis (disorder)	1095	51	890	45	6	845	199	1.08559	0.03942	1.76627	4.19790	0.74316	0.2683148212	0.9388450812	41.45205	0.11580	26	430	22	25	460	23	-0.02188	0.04445
42	16114001	Fracture of ankle	4	195662009	Acute viral pharyngitis (disorder)	1095	108	890	91	17	799	188	1.03667	0.02528	1.25952	2.16498	0.73274	0.4387404304	1.0000000000	87.78082	0.05139	48	430	40	60	460	51	0.15931	0.01075
41	283385000	Laceration of thigh	4	195662009	Acute viral pharyngitis (disorder)	1095	105	890	96	9	794	196	1.12488	0.08474	2.63308	5.30723	1.30635	0.0036187285	0.0705893298	85.34247	0.16791	50	430	44	55	460	52	0.08994	0.03752
40	428251008	History of appendectomy	4	195662009	Acute viral pharyngitis (disorder)	1095	51	890	46	5	844	200	1.10972	0.05053	2.18009	5.55714	0.85526	0.1005894082	0.6275578005	41.45205	0.14683	27	430	24	24	460	22	-0.14686	0.01617
39	74400008	Appendicitis	4	195662009	Acute viral pharyngitis (disorder)	1095	51	890	46	5	844	200	1.10972	0.05053	2.18009	5.55714	0.85526	0.1005894082	0.6275578005	41.45205	0.14683	27	430	24	24	460	22	-0.14686	0.01617
38	398254007	Preeclampsia	4	195662009	Acute viral pharyngitis (disorder)	1095	101	890	92	9	798	196	1.12070	0.08017	2.51072	5.06679	1.24412	0.0069912830	0.1187030605	82.09132	0.16253	101	430	92	0	460	0	1.73588	0.74090
37	38822007	Cystitis	4	195662009	Acute viral pharyngitis (disorder)	1095	71	890	65	6	825	199	1.12636	0.06933	2.61313	6.11670	1.11636	0.0183482335	0.2349246247	57.70776	0.16891	68	430	63	3	460	2	-3.38504	-0.18423
35	19169002	Miscarriage in first trimester	4	195662009	Acute viral pharyngitis (disorder)	1095	174	890	163	11	727	194	1.15256	0.13816	3.95423	7.43027	2.10436	0.0000007647	0.0000394839	141.42466	0.20350	174	430	163	0	460	0	1.29144	0.72633
33	429007001	History of cardiac arrest (situation)	4	195662009	Acute viral pharyngitis (disorder)	1095	42	890	38	4	852	201	1.11316	0.04709	2.24120	6.35144	0.79084	0.1565369867	0.7747075658	34.13699	0.15048	24	430	22	18	460	16	-0.37019	-0.01617
32	410429000	Cardiac Arrest	4	195662009	Acute viral pharyngitis (disorder)	1095	42	890	38	4	852	201	1.11316	0.04709	2.24120	6.35144	0.79084	0.1565369867	0.7747075658	34.13699	0.15048	24	430	22	18	460	16	-0.37019	-0.01617
30	399211009	History of myocardial infarction (situation)	4	195662009	Acute viral pharyngitis (disorder)	1095	31	890	28	3	862	202	1.11127	0.03957	2.18716	7.26514	0.65844	0.2457178668	0.9133257124	25.19635	0.14669	2	430	2	29	460	26	2.44717	-0.05609
29	22298006	Myocardial Infarction	4	195662009	Acute viral pharyngitis (disorder)	1095	31	890	28	3	862	202	1.11127	0.03957	2.18716	7.26514	0.65844	0.2457178668	0.9133257124	25.19635	0.14669	2	430	2	29	460	26	2.44717	-0.05609
28	53741008	Coronary Heart Disease	4	195662009	Acute viral pharyngitis (disorder)	1095	80	890	73	7	817	198	1.12268	0.07177	2.52736	5.57375	1.14601	0.0165617796	0.2190854429	65.02283	0.16456	24	430	21	56	460	52	0.77986	0.03125
27	408512008	Body mass index 40+ - severely obese (finding)	4	195662009	Acute viral pharyngitis (disorder)	1095	97	890	87	10	803	195	1.10350	0.06723	2.11270	4.14068	1.07796	0.0283266625	0.3104262714	78.84018	0.14039	67	430	60	30	460	27	-0.79237	0.00263
26	33737001	Fracture of rib	4	195662009	Acute viral pharyngitis (disorder)	1095	54	890	48	6	842	199	1.09363	0.04443	1.89074	4.47991	0.79798	0.1560375715	0.7747075658	43.89041	0.12637	32	430	29	22	460	19	-0.46551	-0.02556
24	162864005	Body mass index 30+ - obesity (finding)	4	195662009	Acute viral pharyngitis (disorder)	1095	439	890	404	35	486	170	1.13225	0.22541	4.03762	5.94561	2.74193	0.0000000000	0.0000000000	356.81279	0.17872	226	430	211	213	460	193	-0.10772	-0.01559
23	36971009	Sinusitis (disorder)	4	195662009	Acute viral pharyngitis (disorder)	1095	190	890	167	23	723	182	1.08140	0.07771	1.82777	2.91052	1.14782	0.0102954988	0.1582730098	154.42922	0.11220	84	430	74	106	460	93	0.13575	-0.00218
21	15777000	Prediabetes	4	195662009	Acute viral pharyngitis (disorder)	1095	333	890	319	14	571	191	1.17861	0.24602	7.62184	13.33945	4.35494	0.0000000000	0.0000000000	270.65753	0.23628	159	430	151	174	460	168	0.02889	0.00845
20	80394007	Hyperglycemia (disorder)	4	195662009	Acute viral pharyngitis (disorder)	1095	55	890	53	2	837	203	1.18560	0.08893	6.42712	26.59284	1.55335	0.0012446759	0.0293265925	44.70320	0.24066	23	430	22	32	460	31	0.26018	0.00647
19	237602007	Metabolic syndrome X (disorder)	4	195662009	Acute viral pharyngitis (disorder)	1095	64	890	61	3	829	202	1.17267	0.08964	4.95456	15.95139	1.53891	0.0014519331	0.0331902835	52.01826	0.22578	28	430	26	36	460	35	0.21519	0.02356
18	302870006	Hypertriglyceridemia (disorder)	4	195662009	Acute viral pharyngitis (disorder)	1095	64	890	61	3	829	202	1.17267	0.08964	4.95456	15.95139	1.53891	0.0014519331	0.0331902835	52.01826	0.22578	28	430	26	36	460	35	0.21519	0.02356
17	368581000119106	Neuropathy due to type 2 diabetes mellitus (disorder)	4	195662009	Acute viral pharyngitis (disorder)	1095	28	890	27	1	863	204	1.18640	0.06291	6.38239	47.24270	0.86225	0.0453883552	0.4090543962	22.75799	0.23701	7	430	7	21	460	20	0.95597	-0.02469
15	40055000	Chronic sinusitis (disorder)	4	195662009	Acute viral pharyngitis (disorder)	1095	216	890	195	21	695	184	1.11072	0.11436	2.45838	3.96725	1.52338	0.0000882735	0.0030564289	175.56164	0.15068	104	430	94	112	460	101	0.00360	-0.00120
14	10509002	Acute bronchitis (disorder)	4	195662009	Acute viral pharyngitis (disorder)	1095	863	890	749	114	141	91	1.06781	0.27252	4.24033	5.89265	3.05132	0.0000000000	0.0000000000	701.43379	0.09453	418	430	362	445	460	387	-0.00036	0.00224
13	370247008	Facial laceration	4	195662009	Acute viral pharyngitis (disorder)	1095	109	890	95	14	795	191	1.07231	0.05010	1.63028	2.92019	0.91015	0.1196175177	0.6843537581	88.59361	0.09964	55	430	48	54	460	47	-0.07995	-0.00144
10	62106007	Concussion with no loss of consciousness	4	195662009	Acute viral pharyngitis (disorder)	1095	206	890	179	27	711	178	1.06908	0.06929	1.65974	2.56864	1.07245	0.0224593935	0.2721606699	167.43379	0.09582	96	430	85	110	460	94	0.02765	-0.01898
9	44465007	Sprain of ankle	4	195662009	Acute viral pharyngitis (disorder)	1095	362	890	313	49	577	156	1.06380	0.09342	1.72702	2.44884	1.21796	0.0017575996	0.0386671920	294.22831	0.08893	185	430	157	177	460	156	-0.05461	0.02028
8	233678006	Childhood asthma	4	195662009	Acute viral pharyngitis (disorder)	1095	45	890	34	11	856	194	0.92959	-0.03037	0.70051	1.40712	0.34874	0.3287876195	1.0000000000	36.57534	-0.10243	25	430	19	20	460	15	-0.29268	-0.00755
7	75498004	Acute bacterial sinusitis (disorder)	4	195662009	Acute viral pharyngitis (disorder)	1095	187	890	168	19	722	186	1.10533	0.09960	2.27788	3.75943	1.38020	0.0006479879	0.0175016554	151.99087	0.14358	89	430	81	98	460	87	0.00338	-0.01310
6	39848009	Whiplash injury to neck	4	195662009	Acute viral pharyngitis (disorder)	1095	182	890	162	20	728	185	1.09514	0.08850	2.05838	3.36584	1.25880	0.0025342004	0.0525246358	147.92694	0.13027	92	430	81	90	460	81	-0.05705	0.01163
5	284549007	Laceration of hand	4	195662009	Acute viral pharyngitis (disorder)	1095	104	890	99	5	791	200	1.17119	0.11555	5.00632	12.45823	2.01178	0.0000299441	0.0011478136	84.52968	0.22550	54	430	54	50	460	45	-0.22480	-0.05407
3	65363002	Otitis media	4	195662009	Acute viral pharyngitis (disorder)	1095	580	890	453	127	437	78	0.96094	-0.08638	0.63666	0.86897	0.46645	0.0051258354	0.0930988016	471.41553	-0.05736	277	430	214	303	460	239	0.02854	0.01167
1	444814009	Viral sinusitis (disorder)	4	195662009	Acute viral pharyngitis (disorder)	1095	993	890	842	151	48	54	1.04325	0.28115	6.27318	9.60156	4.09858	0.0000000000	0.0000000000	807.09589	0.06101	478	430	404	515	460	438	0.00687	0.00338
128	86849004	Suicidal deliberate poisoning	16	44054006	Diabetes	1095	1	68	1	0	67	1027	16.10294	0.11750	0.00000	0.00000	0.00000	0.0621004566	0.4836892708	0.06210	0.91308	0	29	0	1	39	1	-3.68888	-0.69315
125	1734006	Fracture of the vertebral column with spinal cord injury	117	230265002	Familial Alzheimer's disease of early onset (disorder)	1095	5	6	0	5	6	1084	0.00000	-0.00503	0.00000	0.00000	0.00000	1.0000000000	1.0000000000	0.02740	-0.03899	3	2	0	2	4	0	0.00000	0.00000
118	48333001	Burn injury(morphologic abnormality)	117	230265002	Familial Alzheimer's disease of early onset (disorder)	1095	1	6	0	1	6	1088	0.00000	-0.00224	0.00000	0.00000	0.00000	1.0000000000	1.0000000000	0.00548	-0.00788	0	2	0	1	4	0	0.00000	0.00000
109	90560007	Gout	117	230265002	Familial Alzheimer's disease of early onset (disorder)	1095	4	6	0	4	6	1085	0.00000	-0.00449	0.00000	0.00000	0.00000	1.0000000000	1.0000000000	0.02192	-0.03128	0	2	0	4	4	0	0.00000	0.00000
97	403192003	Third degree burn	117	230265002	Familial Alzheimer's disease of early onset (disorder)	1095	8	6	0	8	6	1081	0.00000	-0.00637	0.00000	0.00000	0.00000	1.0000000000	1.0000000000	0.04384	-0.06189	3	2	0	5	4	0	0.00000	0.00000
96	283371005	Laceration of forearm	117	230265002	Familial Alzheimer's disease of early onset (disorder)	1095	75	6	0	75	6	1014	0.00000	-0.02013	0.00000	0.00000	0.00000	1.0000000000	1.0000000000	0.41096	-0.49668	39	2	0	36	4	0	0.00000	0.00000
94	703151001	History of single seizure (situation)	117	230265002	Familial Alzheimer's disease of early onset (disorder)	1095	39	6	0	39	6	1050	0.00000	-0.01426	0.00000	0.00000	0.00000	1.0000000000	1.0000000000	0.21370	-0.27941	14	2	0	25	4	0	0.00000	0.00000
93	128613002	Seizure disorder	117	230265002	Familial Alzheimer's disease of early onset (disorder)	1095	39	6	0	39	6	1050	0.00000	-0.01426	0.00000	0.00000	0.00000	1.0000000000	1.0000000000	0.21370	-0.27941	14	2	0	25	4	0	0.00000	0.00000
86	713197008	Recurrent rectal polyp	117	230265002	Familial Alzheimer's disease of early onset (disorder)	1095	22	6	0	22	6	1067	0.00000	-0.01063	0.00000	0.00000	0.00000	1.0000000000	1.0000000000	0.12055	-0.16420	12	2	0	10	4	0	0.00000	0.00000
75	431855005	Chronic kidney disease stage 1 (disorder)	117	230265002	Familial Alzheimer's disease of early onset (disorder)	1095	28	6	1	27	5	1062	6.51786	0.06635	7.86667	69.64292	0.88860	0.1442534615	0.7404942507	0.15342	0.79408	10	2	1	18	4	0	1.09861	2.39790
69	233604007	Pneumonia	117	230265002	Familial Alzheimer's disease of early onset (disorder)	1095	7	6	2	5	4	1084	52.14286	0.30450	108.40000	732.96232	16.03160	0.0005195181	0.0144314245	0.03836	1.53066	3	2	0	4	4	2	-1.09861	-1.09861
64	444448004	Injury of medial collateral ligament of knee	117	230265002	Familial Alzheimer's disease of early onset (disorder)	1095	32	6	0	32	6	1057	0.00000	-0.01288	0.00000	0.00000	0.00000	1.0000000000	1.0000000000	0.17534	-0.23308	17	2	0	15	4	0	0.00000	0.00000
49	88805009	Chronic congestive heart failure (disorder)	117	230265002	Familial Alzheimer's disease of early onset (disorder)	1095	10	6	0	10	6	1079	0.00000	-0.00713	0.00000	0.00000	0.00000	1.0000000000	1.0000000000	0.05479	-0.07696	5	2	0	5	4	0	0.00000	0.00000
47	359817006	Closed fracture of hip	117	230265002	Familial Alzheimer's disease of early onset (disorder)	1095	29	6	1	28	5	1061	6.29310	0.06480	7.57857	67.01435	0.85705	0.1490655320	0.7572321990	0.15890	0.78724	11	2	0	18	4	1	-1.60944	-2.94444
44	58150001	Fracture of clavicle	117	230265002	Familial Alzheimer's disease of early onset (disorder)	1095	112	6	0	112	6	977	0.00000	-0.02505	0.00000	0.00000	0.00000	1.0000000000	1.0000000000	0.61370	-0.69037	55	2	0	57	4	0	0.00000	0.00000
43	307731004	Injury of tendon of the rotator cuff of shoulder	117	230265002	Familial Alzheimer's disease of early onset (disorder)	1095	51	6	0	51	6	1038	0.00000	-0.01641	0.00000	0.00000	0.00000	1.0000000000	1.0000000000	0.27945	-0.35553	26	2	0	25	4	0	0.00000	0.00000
42	16114001	Fracture of ankle	117	230265002	Familial Alzheimer's disease of early onset (disorder)	1095	108	6	0	108	6	981	0.00000	-0.02455	0.00000	0.00000	0.00000	1.0000000000	1.0000000000	0.59178	-0.67064	48	2	0	60	4	0	0.00000	0.00000
41	283385000	Laceration of thigh	117	230265002	Familial Alzheimer's disease of early onset (disorder)	1095	105	6	2	103	4	986	3.47619	0.05986	4.78641	26.44988	0.86616	0.1058105635	0.6396729519	0.57534	0.92930	50	2	0	55	4	2	-1.09861	-3.34990
38	398254007	Preeclampsia	117	230265002	Familial Alzheimer's disease of early onset (disorder)	1095	101	6	2	99	4	990	3.61386	0.06185	5.00000	27.64225	0.90441	0.0988619010	0.6247730505	0.55342	0.94951	101	2	2	0	4	0	0.69315	3.94158
35	19169002	Miscarriage in first trimester	117	230265002	Familial Alzheimer's disease of early onset (disorder)	1095	174	6	2	172	4	917	2.09770	0.03542	2.66570	14.66761	0.48447	0.2443763068	0.9133257124	0.95342	0.61896	174	2	2	0	4	0	0.69315	4.47734
33	429007001	History of cardiac arrest (situation)	117	230265002	Familial Alzheimer's disease of early onset (disorder)	1095	42	6	1	41	5	1048	4.34524	0.04959	5.11220	44.75571	0.58394	0.2095991349	0.8621655136	0.23014	0.70118	24	2	0	18	4	1	-1.60944	-2.94444
32	410429000	Cardiac Arrest	117	230265002	Familial Alzheimer's disease of early onset (disorder)	1095	42	6	1	41	5	1048	4.34524	0.04959	5.11220	44.75571	0.58394	0.2095991349	0.8621655136	0.23014	0.70118	24	2	0	18	4	1	-1.60944	-2.94444
27	408512008	Body mass index 40+ - severely obese (finding)	117	230265002	Familial Alzheimer's disease of early onset (disorder)	1095	97	6	2	95	4	994	3.76289	0.06394	5.23158	28.93621	0.94585	0.0920758434	0.6002633183	0.53151	0.97001	67	2	0	30	4	2	-1.09861	-2.77259
21	15777000	Prediabetes	117	230265002	Familial Alzheimer's disease of early onset (disorder)	1095	333	6	4	329	2	760	2.19219	0.05850	4.62006	25.34825	0.84207	0.0732270143	0.5352096013	1.82466	0.82385	159	2	2	174	4	2	-0.40547	-0.08908
131	93761005	Primary malignant neoplasm of colon	91	64859006	Osteoporosis (disorder)	1095	5	37	0	5	37	1053	0.00000	-0.01267	0.00000	0.00000	0.00000	1.0000000000	1.0000000000	0.16895	-0.22521	3	24	0	2	13	0	0.00000	0.00000
130	314994000	Metastasis from malignant tumor of prostate (disorder)	91	64859006	Osteoporosis (disorder)	1095	1	37	0	1	37	1057	0.00000	-0.00565	0.00000	0.00000	0.00000	1.0000000000	1.0000000000	0.03379	-0.04794	0	24	0	1	13	0	0.00000	0.00000
129	47505003	Posttraumatic stress disorder	91	64859006	Osteoporosis (disorder)	1095	4	37	0	4	37	1054	0.00000	-0.01132	0.00000	0.00000	0.00000	1.0000000000	1.0000000000	0.13516	-0.18290	1	24	0	3	13	0	0.00000	0.00000
15	40055000	Chronic sinusitis (disorder)	117	230265002	Familial Alzheimer's disease of early onset (disorder)	1095	216	6	4	212	2	877	3.37963	0.08756	8.27358	45.47049	1.50542	0.0158600283	0.2148446428	1.18356	1.19524	104	2	2	112	4	2	-0.40547	-0.07276
14	10509002	Acute bronchitis (disorder)	117	230265002	Familial Alzheimer's disease of early onset (disorder)	1095	863	6	6	857	0	232	1.26883	0.03849	0.00000	0.00000	0.00000	0.3522028398	1.0000000000	4.72877	0.28913	418	2	2	445	4	4	0.00000	0.62638
126	698754002	Chronic paralysis due to lesion of spinal cord	91	64859006	Osteoporosis (disorder)	1095	2	37	0	2	37	1056	0.00000	-0.00800	0.00000	0.00000	0.00000	1.0000000000	1.0000000000	0.06758	-0.09434	2	24	0	0	13	0	0.00000	0.00000
125	1734006	Fracture of the vertebral column with spinal cord injury	91	64859006	Osteoporosis (disorder)	1095	5	37	0	5	37	1053	0.00000	-0.01267	0.00000	0.00000	0.00000	1.0000000000	1.0000000000	0.16895	-0.22521	3	24	0	2	13	0	0.00000	0.00000
124	1501000119109	Proliferative diabetic retinopathy due to type II diabetes mellitus (disorder)	91	64859006	Osteoporosis (disorder)	1095	1	37	0	1	37	1057	0.00000	-0.00565	0.00000	0.00000	0.00000	1.0000000000	1.0000000000	0.03379	-0.04794	1	24	0	0	13	0	0.00000	0.00000
123	195967001	Asthma	91	64859006	Osteoporosis (disorder)	1095	2	37	0	2	37	1056	0.00000	-0.00800	0.00000	0.00000	0.00000	1.0000000000	1.0000000000	0.06758	-0.09434	1	24	0	1	13	0	0.00000	0.00000
121	254637007	Non-small cell lung cancer (disorder)	91	64859006	Osteoporosis (disorder)	1095	8	37	0	8	37	1050	0.00000	-0.01604	0.00000	0.00000	0.00000	1.0000000000	1.0000000000	0.27032	-0.34519	0	24	0	8	13	0	0.00000	0.00000
120	162573006	Suspected lung cancer (situation)	91	64859006	Osteoporosis (disorder)	1095	8	37	0	8	37	1050	0.00000	-0.01604	0.00000	0.00000	0.00000	1.0000000000	1.0000000000	0.27032	-0.34519	0	24	0	8	13	0	0.00000	0.00000
118	48333001	Burn injury(morphologic abnormality)	91	64859006	Osteoporosis (disorder)	1095	1	37	0	1	37	1057	0.00000	-0.00565	0.00000	0.00000	0.00000	1.0000000000	1.0000000000	0.03379	-0.04794	0	24	0	1	13	0	0.00000	0.00000
117	230265002	Familial Alzheimer's disease of early onset (disorder)	91	64859006	Osteoporosis (disorder)	1095	6	37	0	6	37	1052	0.00000	-0.01388	0.00000	0.00000	0.00000	1.0000000000	1.0000000000	0.20274	-0.26632	2	24	0	4	13	0	0.00000	0.00000
115	36923009	Major depression  single episode	91	64859006	Osteoporosis (disorder)	1095	6	37	1	5	36	1053	4.93243	0.05459	5.85000	51.36848	0.66622	0.1867566421	0.8181443419	0.20274	0.73368	3	24	1	3	13	0	3.21888	1.38629
114	449868002	Smokes tobacco daily	91	64859006	Osteoporosis (disorder)	1095	9	37	2	7	35	1051	6.57658	0.09494	8.57959	42.79986	1.71985	0.0344498367	0.3475869732	0.30411	1.20190	2	24	0	7	13	2	-2.01490	-1.50408
112	49436004	Atrial Fibrillation	91	64859006	Osteoporosis (disorder)	1095	35	37	10	25	27	1033	8.45560	0.25335	15.30370	34.98843	6.69374	0.0000000548	0.0000033187	1.18265	2.33335	9	24	5	26	13	5	0.47692	-0.79493
111	235919008	Cholelithiasis	91	64859006	Osteoporosis (disorder)	1095	9	37	0	9	37	1049	0.00000	-0.01702	0.00000	0.00000	0.00000	1.0000000000	1.0000000000	0.30411	-0.38307	7	24	0	2	13	0	0.00000	0.00000
110	65275009	Acute Cholecystitis	91	64859006	Osteoporosis (disorder)	1095	9	37	0	9	37	1049	0.00000	-0.01702	0.00000	0.00000	0.00000	1.0000000000	1.0000000000	0.30411	-0.38307	7	24	0	2	13	0	0.00000	0.00000
109	90560007	Gout	91	64859006	Osteoporosis (disorder)	1095	4	37	0	4	37	1054	0.00000	-0.01132	0.00000	0.00000	0.00000	1.0000000000	1.0000000000	0.13516	-0.18290	0	24	0	4	13	0	0.00000	0.00000
108	40930008	Hypothyroidism (disorder)	91	64859006	Osteoporosis (disorder)	1095	13	37	2	11	35	1047	4.55301	0.07283	5.43896	25.46765	1.16156	0.0685765926	0.5135368799	0.43927	1.05963	11	24	1	2	13	1	0.57982	1.38629
107	40275004	Contact dermatitis	91	64859006	Osteoporosis (disorder)	1095	18	37	0	18	37	1040	0.00000	-0.02418	0.00000	0.00000	0.00000	1.0000000000	1.0000000000	0.60822	-0.68546	9	24	0	9	13	0	0.00000	0.00000
106	24079001	Atopic dermatitis	91	64859006	Osteoporosis (disorder)	1095	20	37	0	20	37	1038	0.00000	-0.02551	0.00000	0.00000	0.00000	1.0000000000	1.0000000000	0.67580	-0.74485	13	24	0	7	13	0	0.00000	0.00000
105	363406005	Malignant tumor of colon	91	64859006	Osteoporosis (disorder)	1095	6	37	0	6	37	1052	0.00000	-0.01388	0.00000	0.00000	0.00000	1.0000000000	1.0000000000	0.20274	-0.26632	4	24	0	2	13	0	0.00000	0.00000
104	367498001	Seasonal allergic rhinitis	91	64859006	Osteoporosis (disorder)	1095	20	37	0	20	37	1038	0.00000	-0.02551	0.00000	0.00000	0.00000	1.0000000000	1.0000000000	0.67580	-0.74485	9	24	0	11	13	0	0.00000	0.00000
102	90781000119102	Microalbuminuria due to type 2 diabetes mellitus (disorder)	91	64859006	Osteoporosis (disorder)	1095	6	37	0	6	37	1052	0.00000	-0.01388	0.00000	0.00000	0.00000	1.0000000000	1.0000000000	0.20274	-0.26632	3	24	0	3	13	0	0.00000	0.00000
101	433144002	Chronic kidney disease stage 3 (disorder)	91	64859006	Osteoporosis (disorder)	1095	3	37	0	3	37	1055	0.00000	-0.00980	0.00000	0.00000	0.00000	1.0000000000	1.0000000000	0.10137	-0.13930	1	24	0	2	13	0	0.00000	0.00000
100	161622006	History of lower limb amputation (situation)	91	64859006	Osteoporosis (disorder)	1095	1	37	0	1	37	1057	0.00000	-0.00565	0.00000	0.00000	0.00000	1.0000000000	1.0000000000	0.03379	-0.04794	0	24	0	1	13	0	0.00000	0.00000
99	30832001	Rupture of patellar tendon	91	64859006	Osteoporosis (disorder)	1095	23	37	2	21	35	1037	2.57344	0.04310	2.82177	12.50795	0.63659	0.1805944893	0.8125363542	0.77717	0.75538	14	24	2	9	13	0	2.56495	2.07944
98	1551000119108	Nonproliferative diabetic retinopathy due to type 2 diabetes mellitus (disorder)	91	64859006	Osteoporosis (disorder)	1095	12	37	1	11	36	1047	2.46622	0.02886	2.64394	21.03467	0.33233	0.3394030450	1.0000000000	0.40548	0.50894	7	24	1	5	13	0	3.21888	2.07944
97	403192003	Third degree burn	91	64859006	Osteoporosis (disorder)	1095	8	37	1	7	36	1051	3.69932	0.04331	4.17063	34.79706	0.49988	0.2411041016	0.9095097439	0.27032	0.65481	3	24	0	5	13	1	-2.63906	-1.79176
96	283371005	Laceration of forearm	91	64859006	Osteoporosis (disorder)	1095	75	37	9	66	28	992	3.55135	0.12938	4.83117	10.65846	2.18983	0.0005338058	0.0147815372	2.53425	1.50053	39	24	7	36	13	2	-0.52683	-1.06171
95	84757009	Epilepsy	91	64859006	Osteoporosis (disorder)	1095	30	37	1	29	36	1029	0.98649	-0.00042	0.98563	7.43732	0.13062	1.0000000000	1.0000000000	1.01370	-0.00985	13	24	1	17	13	0	3.21888	2.63906
94	703151001	History of single seizure (situation)	91	64859006	Osteoporosis (disorder)	1095	39	37	2	37	35	1021	1.51767	0.01860	1.57683	6.80485	0.36539	0.3832277366	1.0000000000	1.31781	0.37220	14	24	1	25	13	1	0.57982	-0.55005
93	128613002	Seizure disorder	91	64859006	Osteoporosis (disorder)	1095	39	37	2	37	35	1021	1.51767	0.01860	1.57683	6.80485	0.36539	0.3832277366	1.0000000000	1.31781	0.37220	14	24	1	25	13	1	0.57982	-0.55005
89	47693006	Rupture of appendix	91	64859006	Osteoporosis (disorder)	1095	20	37	0	20	37	1038	0.00000	-0.02551	0.00000	0.00000	0.00000	1.0000000000	1.0000000000	0.67580	-0.74485	10	24	0	10	13	0	0.00000	0.00000
86	713197008	Recurrent rectal polyp	91	64859006	Osteoporosis (disorder)	1095	22	37	4	18	33	1040	5.38084	0.11731	7.00337	21.84301	2.24544	0.0052243041	0.0931740363	0.74338	1.52004	12	24	2	10	13	2	0.55005	0.15415
85	241929008	Acute allergic reaction	91	64859006	Osteoporosis (disorder)	1095	47	37	0	47	37	1011	0.00000	-0.03960	0.00000	0.00000	0.00000	0.4009183978	1.0000000000	1.58813	-1.37191	25	24	0	22	13	0	0.00000	0.00000
83	110030002	Concussion injury of brain	91	64859006	Osteoporosis (disorder)	1095	7	37	0	7	37	1051	0.00000	-0.01500	0.00000	0.00000	0.00000	1.0000000000	1.0000000000	0.23653	-0.30630	1	24	0	6	13	0	0.00000	0.00000
82	94260004	Secondary malignant neoplasm of colon	91	64859006	Osteoporosis (disorder)	1095	4	37	0	4	37	1054	0.00000	-0.01132	0.00000	0.00000	0.00000	1.0000000000	1.0000000000	0.13516	-0.18290	2	24	0	2	13	0	0.00000	0.00000
81	236077008	Protracted diarrhea	91	64859006	Osteoporosis (disorder)	1095	4	37	0	4	37	1054	0.00000	-0.01132	0.00000	0.00000	0.00000	1.0000000000	1.0000000000	0.13516	-0.18290	2	24	0	2	13	0	0.00000	0.00000
80	6072007	Bleeding from anus	91	64859006	Osteoporosis (disorder)	1095	4	37	0	4	37	1054	0.00000	-0.01132	0.00000	0.00000	0.00000	1.0000000000	1.0000000000	0.13516	-0.18290	2	24	0	2	13	0	0.00000	0.00000
79	45816000	Pyelonephritis	91	64859006	Osteoporosis (disorder)	1095	1	37	0	1	37	1057	0.00000	-0.00565	0.00000	0.00000	0.00000	1.0000000000	1.0000000000	0.03379	-0.04794	1	24	0	0	13	0	0.00000	0.00000
78	239872002	Osteoarthritis of hip	91	64859006	Osteoporosis (disorder)	1095	21	37	2	19	35	1039	2.81853	0.04755	3.12481	13.94086	0.70042	0.1562155783	0.7747075658	0.70959	0.81131	13	24	2	8	13	0	2.56495	2.01490
76	127013003	Diabetic renal disease (disorder)	91	64859006	Osteoporosis (disorder)	1095	28	37	2	26	35	1032	2.11390	0.03374	2.26813	9.93539	0.51779	0.2436006834	0.9130344998	0.94612	0.62436	10	24	2	18	13	0	2.56495	1.79176
75	431855005	Chronic kidney disease stage 1 (disorder)	91	64859006	Osteoporosis (disorder)	1095	28	37	2	26	35	1032	2.11390	0.03374	2.26813	9.93539	0.51779	0.2436006834	0.9130344998	0.94612	0.62436	10	24	2	18	13	0	2.56495	1.79176
73	196416002	Impacted molars	91	64859006	Osteoporosis (disorder)	1095	49	37	2	47	35	1011	1.20794	0.00842	1.22918	5.26459	0.28699	0.6795475729	1.0000000000	1.65571	0.17587	25	24	1	24	13	1	0.57982	0.03922
72	35999006	Blighted ovum	91	64859006	Osteoporosis (disorder)	1095	53	37	2	51	35	1007	1.11678	0.00493	1.12829	4.82186	0.26401	0.6987596694	1.0000000000	1.79087	0.10425	53	24	2	0	13	0	2.56495	3.31419
71	201834006	Localized  primary osteoarthritis of the hand	91	64859006	Osteoporosis (disorder)	1095	28	37	3	25	34	1033	3.17085	0.06576	3.64588	12.66611	1.04945	0.0650641990	0.4975030828	0.94612	1.03940	19	24	3	9	13	0	2.19722	1.99243
70	87433001	Pulmonary emphysema (disorder)	91	64859006	Osteoporosis (disorder)	1095	17	37	1	16	36	1042	1.74086	0.01740	1.80903	14.01623	0.23349	0.4449776691	1.0000000000	0.57443	0.34517	9	24	1	8	13	0	3.21888	2.30259
69	233604007	Pneumonia	91	64859006	Osteoporosis (disorder)	1095	7	37	2	5	35	1053	8.45560	0.11183	12.03429	64.18736	2.25627	0.0209714948	0.2589138980	0.23653	1.27867	3	24	0	4	13	2	-2.01490	-1.09861
68	26929004	Alzheimer's disease (disorder)	91	64859006	Osteoporosis (disorder)	1095	23	37	6	17	31	1041	7.72033	0.18408	11.85199	32.11754	4.37361	0.0000652405	0.0023567116	0.77717	1.97777	15	24	3	8	13	3	0.52325	0.49248
67	403191005	Second degree burn	91	64859006	Osteoporosis (disorder)	1095	49	37	2	47	35	1011	1.20794	0.00842	1.22918	5.26459	0.28699	0.6795475729	1.0000000000	1.65571	0.17587	23	24	2	26	13	0	2.56495	2.52573
65	239873007	Osteoarthritis of knee	91	64859006	Osteoporosis (disorder)	1095	57	37	6	51	31	1007	3.11522	0.09269	3.82163	9.57343	1.52556	0.0100649486	0.1555459839	1.92603	1.25841	30	24	6	27	13	0	1.60944	1.79176
64	444448004	Injury of medial collateral ligament of knee	91	64859006	Osteoporosis (disorder)	1095	32	37	1	31	36	1027	0.92483	-0.00244	0.92025	6.92931	0.12221	1.0000000000	1.0000000000	1.08128	-0.05747	17	24	1	15	13	0	3.21888	2.89037
63	68496003	Polyp of colon	91	64859006	Osteoporosis (disorder)	1095	91	37	13	78	24	980	4.22780	0.18173	6.80556	13.88753	3.33505	0.0000026378	0.0001258401	3.07489	1.78060	43	24	7	48	13	6	0.33540	-0.23111
62	185086009	Chronic obstructive bronchitis (disorder)	91	64859006	Osteoporosis (disorder)	1095	6	37	1	5	36	1053	4.93243	0.05459	5.85000	51.36848	0.66622	0.1867566421	0.8181443419	0.20274	0.73368	4	24	1	2	13	0	3.21888	1.60944
59	262574004	Bullet wound	91	64859006	Osteoporosis (disorder)	1095	20	37	1	19	36	1039	1.47973	0.01224	1.51901	11.66049	0.19788	0.5002378770	1.0000000000	0.67580	0.25515	9	24	1	11	13	0	3.21888	2.30259
58	239720000	Tear of meniscus of knee	91	64859006	Osteoporosis (disorder)	1095	20	37	0	20	37	1038	0.00000	-0.02551	0.00000	0.00000	0.00000	1.0000000000	1.0000000000	0.67580	-0.74485	10	24	0	10	13	0	0.00000	0.00000
57	192127007	Child attention deficit disorder	91	64859006	Osteoporosis (disorder)	1095	76	37	1	75	36	983	0.38940	-0.03118	0.36407	2.69239	0.04923	0.5089791910	1.0000000000	2.56804	-0.83513	24	24	1	52	13	0	3.21888	3.21888
56	92691004	Carcinoma in situ of prostate (disorder)	91	64859006	Osteoporosis (disorder)	1095	23	37	6	17	31	1041	7.72033	0.18408	11.85199	32.11754	4.37361	0.0000652405	0.0023567116	0.77717	1.97777	0	24	0	23	13	6	-1.15268	-1.57554
54	5602001	Opioid abuse (disorder)	91	64859006	Osteoporosis (disorder)	1095	7	37	0	7	37	1051	0.00000	-0.01500	0.00000	0.00000	0.00000	1.0000000000	1.0000000000	0.23653	-0.30630	0	24	0	7	13	0	0.00000	0.00000
53	7200002	Alcoholism	91	64859006	Osteoporosis (disorder)	1095	5	37	1	4	36	1054	5.91892	0.06230	7.31944	67.14671	0.79787	0.1581811395	0.7765186874	0.16895	0.77479	0	24	0	5	13	1	-2.63906	-1.79176
52	124171000119105	Chronic intractable migraine without aura	91	64859006	Osteoporosis (disorder)	1095	51	37	2	49	35	1009	1.16057	0.00664	1.17668	5.03395	0.27505	0.6890416477	1.0000000000	1.72329	0.13961	21	24	1	30	13	1	0.57982	-0.34294
50	446096008	Perennial allergic rhinitis	91	64859006	Osteoporosis (disorder)	1095	26	37	0	26	37	1032	0.00000	-0.02916	0.00000	0.00000	0.00000	1.0000000000	1.0000000000	0.87854	-0.90961	14	24	0	12	13	0	0.00000	0.00000
49	88805009	Chronic congestive heart failure (disorder)	91	64859006	Osteoporosis (disorder)	1095	10	37	0	10	37	1048	0.00000	-0.01795	0.00000	0.00000	0.00000	1.0000000000	1.0000000000	0.33790	-0.41997	5	24	0	5	13	0	0.00000	0.00000
47	359817006	Closed fracture of hip	91	64859006	Osteoporosis (disorder)	1095	29	37	1	28	36	1030	1.02050	0.00063	1.02183	7.71945	0.13526	1.0000000000	1.0000000000	0.97991	0.01457	11	24	1	18	13	0	3.21888	2.48491
46	62564004	Concussion with loss of consciousness	91	64859006	Osteoporosis (disorder)	1095	67	37	1	66	36	992	0.44171	-0.02665	0.41751	3.09291	0.05636	0.7223909658	1.0000000000	2.26393	-0.70661	36	24	0	31	13	1	-2.63906	-3.46574
45	263102004	Fracture subluxation of wrist	91	64859006	Osteoporosis (disorder)	1095	109	37	7	102	30	956	1.90057	0.05600	2.18693	5.10463	0.93693	0.0856040546	0.5784698933	3.68311	0.77253	51	24	4	58	13	3	0.27193	-0.39122
44	58150001	Fracture of clavicle	91	64859006	Osteoporosis (disorder)	1095	112	37	7	105	30	953	1.84966	0.05363	2.11778	4.94012	0.90787	0.0919782673	0.6002633183	3.78447	0.74164	55	24	4	57	13	3	0.27193	-0.30449
43	307731004	Injury of tendon of the rotator cuff of shoulder	91	64859006	Osteoporosis (disorder)	1095	51	37	1	50	36	1008	0.58029	-0.01735	0.56000	4.16773	0.07524	1.0000000000	1.0000000000	1.72329	-0.44535	26	24	1	25	13	0	3.21888	3.29584
42	16114001	Fracture of ankle	91	64859006	Osteoporosis (disorder)	1095	108	37	4	104	33	954	1.09610	0.00594	1.11189	3.20045	0.38629	0.7789772820	1.0000000000	3.64932	0.10491	48	24	3	60	13	1	-0.44183	-1.27766
41	283385000	Laceration of thigh	91	64859006	Osteoporosis (disorder)	1095	105	37	2	103	35	955	0.56371	-0.02657	0.52982	2.23482	0.12561	0.5703893208	1.0000000000	3.54795	-0.60025	50	24	2	55	13	0	2.56495	3.25810
40	428251008	History of appendectomy	91	64859006	Osteoporosis (disorder)	1095	51	37	4	47	33	1011	2.32114	0.05461	2.60735	7.66327	0.88712	0.0885761964	0.5894782805	1.72329	0.87658	27	24	3	24	13	1	-0.44183	-0.91629
39	74400008	Appendicitis	91	64859006	Osteoporosis (disorder)	1095	51	37	4	47	33	1011	2.32114	0.05461	2.60735	7.66327	0.88712	0.0885761964	0.5894782805	1.72329	0.87658	27	24	3	24	13	1	-0.44183	-0.91629
38	398254007	Preeclampsia	91	64859006	Osteoporosis (disorder)	1095	101	37	4	97	33	961	1.17206	0.01026	1.20087	3.46090	0.41668	0.7696370932	1.0000000000	3.41279	0.18024	101	24	4	0	13	0	1.94591	3.26767
120	162573006	Suspected lung cancer (situation)	34	72892002	Normal pregnancy	1095	8	384	0	8	384	703	0.00000	-0.06305	0.00000	0.00000	0.00000	0.0562985733	0.4605674526	2.80548	-1.92808	0	384	0	8	0	0	0.00000	0.00000
35	19169002	Miscarriage in first trimester	91	64859006	Osteoporosis (disorder)	1095	174	37	14	160	23	898	2.38117	0.11227	3.41630	6.77951	1.72153	0.0008304616	0.0214221006	5.87945	1.12460	174	24	14	0	13	0	0.99853	2.59738
121	254637007	Non-small cell lung cancer (disorder)	34	72892002	Normal pregnancy	1095	8	384	0	8	384	703	0.00000	-0.06305	0.00000	0.00000	0.00000	0.0562985733	0.4605674526	2.80548	-1.92808	0	384	0	8	0	0	0.00000	0.00000
33	429007001	History of cardiac arrest (situation)	91	64859006	Osteoporosis (disorder)	1095	42	37	3	39	34	1019	2.11390	0.04160	2.30543	7.83243	0.67859	0.1656612694	0.7915572889	1.41918	0.72548	24	24	2	18	13	1	-0.07411	-0.37949
32	410429000	Cardiac Arrest	91	64859006	Osteoporosis (disorder)	1095	42	37	3	39	34	1019	2.11390	0.04160	2.30543	7.83243	0.67859	0.1656612694	0.7915572889	1.41918	0.72548	24	24	2	18	13	1	-0.07411	-0.37949
30	399211009	History of myocardial infarction (situation)	91	64859006	Osteoporosis (disorder)	1095	31	37	1	30	36	1028	0.95466	-0.00145	0.95185	7.17459	0.12628	1.0000000000	1.0000000000	1.04749	-0.03386	2	24	0	29	13	1	-2.63906	-3.40120
29	22298006	Myocardial Infarction	91	64859006	Osteoporosis (disorder)	1095	31	37	1	30	36	1028	0.95466	-0.00145	0.95185	7.17459	0.12628	1.0000000000	1.0000000000	1.04749	-0.03386	2	24	0	29	13	1	-2.63906	-3.40120
28	53741008	Coronary Heart Disease	91	64859006	Osteoporosis (disorder)	1095	80	37	5	75	32	983	1.84966	0.04461	2.04792	5.40944	0.77530	0.1840339216	0.8181443419	2.70320	0.69619	24	24	3	56	13	2	0.18232	-1.17007
27	408512008	Body mass index 40+ - severely obese (finding)	91	64859006	Osteoporosis (disorder)	1095	97	37	5	92	32	966	1.52549	0.03064	1.64062	4.31264	0.62413	0.3682704519	1.0000000000	3.27763	0.48815	67	24	4	30	13	1	-0.69315	-0.55760
26	33737001	Fracture of rib	91	64859006	Osteoporosis (disorder)	1095	54	37	2	52	35	1006	1.09610	0.00409	1.10549	4.72209	0.25881	0.7036797936	1.0000000000	1.82466	0.08689	32	24	2	22	13	0	2.56495	2.83321
24	162864005	Body mass index 30+ - obesity (finding)	91	64859006	Osteoporosis (disorder)	1095	439	37	24	415	13	643	1.61793	0.09453	2.86043	5.68091	1.44027	0.0031456506	0.0623307470	14.83379	0.65892	226	24	17	213	13	7	-0.16946	-0.78787
23	36971009	Sinusitis (disorder)	91	64859006	Osteoporosis (disorder)	1095	190	37	11	179	26	879	1.71337	0.06113	2.07757	4.28127	1.00818	0.0729859805	0.5347837537	6.42009	0.69353	84	24	6	106	13	5	0.32850	-0.39204
21	15777000	Prediabetes	91	64859006	Osteoporosis (disorder)	1095	333	37	21	312	16	746	1.86633	0.10710	3.13822	6.09424	1.61602	0.0008131152	0.0210546471	11.25205	0.84448	159	24	13	174	13	8	0.08089	-0.54202
20	80394007	Hyperglycemia (disorder)	91	64859006	Osteoporosis (disorder)	1095	55	37	2	53	35	1005	1.07617	0.00328	1.08356	4.62617	0.25379	0.7086295334	1.0000000000	1.85845	0.06973	23	24	2	32	13	0	2.56495	2.52573
19	237602007	Metabolic syndrome X (disorder)	91	64859006	Osteoporosis (disorder)	1095	64	37	3	61	34	997	1.38725	0.01804	1.44214	4.82861	0.43072	0.4725948206	1.0000000000	2.16256	0.33891	28	24	3	36	13	0	2.19722	2.33537
18	302870006	Hypertriglyceridemia (disorder)	91	64859006	Osteoporosis (disorder)	1095	64	37	3	61	34	997	1.38725	0.01804	1.44214	4.82861	0.43072	0.4725948206	1.0000000000	2.16256	0.33891	28	24	3	36	13	0	2.19722	2.33537
17	368581000119106	Neuropathy due to type 2 diabetes mellitus (disorder)	91	64859006	Osteoporosis (disorder)	1095	28	37	1	27	36	1031	1.05695	0.00173	1.06070	8.02319	0.14023	1.0000000000	1.0000000000	0.94612	0.03940	7	24	1	21	13	0	3.21888	2.07944
129	47505003	Posttraumatic stress disorder	65	239873007	Osteoarthritis of knee	1095	4	57	0	4	57	1034	0.00000	-0.01419	0.00000	0.00000	0.00000	1.0000000000	1.0000000000	0.20822	-0.27288	1	30	0	3	27	0	0.00000	0.00000
15	40055000	Chronic sinusitis (disorder)	91	64859006	Osteoporosis (disorder)	1095	216	37	16	200	21	858	2.19219	0.11052	3.26857	6.37709	1.67530	0.0010157798	0.0252592497	7.29863	1.03459	104	24	11	112	13	5	-0.12348	-0.80570
14	10509002	Acute bronchitis (disorder)	91	64859006	Osteoporosis (disorder)	1095	863	37	36	827	1	231	1.23454	0.08459	10.05562	73.73517	1.37133	0.0031872749	0.0630132855	29.16073	0.29485	418	24	23	445	13	13	0.02151	-0.60837
13	370247008	Facial laceration	91	64859006	Osteoporosis (disorder)	1095	109	37	7	102	30	956	1.90057	0.05600	2.18693	5.10463	0.93693	0.0856040546	0.5784698933	3.68311	0.77253	55	24	3	54	13	4	0.75031	0.28768
125	1734006	Fracture of the vertebral column with spinal cord injury	65	239873007	Osteoarthritis of knee	1095	5	57	0	5	57	1033	0.00000	-0.01587	0.00000	0.00000	0.00000	1.0000000000	1.0000000000	0.26027	-0.33374	3	30	0	2	27	0	0.00000	0.00000
124	1501000119109	Proliferative diabetic retinopathy due to type II diabetes mellitus (disorder)	65	239873007	Osteoarthritis of knee	1095	1	57	0	1	57	1037	0.00000	-0.00708	0.00000	0.00000	0.00000	1.0000000000	1.0000000000	0.05205	-0.07321	1	30	0	0	27	0	0.00000	0.00000
10	62106007	Concussion with no loss of consciousness	91	64859006	Osteoporosis (disorder)	1095	206	37	5	201	32	857	0.71832	-0.02536	0.66620	1.73115	0.25637	0.5225997648	1.0000000000	6.96073	-0.40794	96	24	3	110	13	2	0.18232	-0.52884
9	44465007	Sprain of ankle	91	64859006	Osteoporosis (disorder)	1095	362	37	16	346	21	712	1.30805	0.04048	1.56785	3.04246	0.80795	0.2129247309	0.8671354646	12.23196	0.36151	185	24	12	177	13	4	-0.34831	-1.01391
8	233678006	Childhood asthma	91	64859006	Osteoporosis (disorder)	1095	45	37	0	45	37	1013	0.00000	-0.03871	0.00000	0.00000	0.00000	0.3974878731	1.0000000000	1.52055	-1.33374	25	24	0	20	13	0	0.00000	0.00000
7	75498004	Acute bacterial sinusitis (disorder)	91	64859006	Osteoporosis (disorder)	1095	187	37	8	179	29	879	1.26608	0.02258	1.35465	3.01197	0.60926	0.5028580245	1.0000000000	6.31872	0.29833	89	24	6	98	13	2	-0.40547	-1.14991
6	39848009	Whiplash injury to neck	91	64859006	Osteoporosis (disorder)	1095	182	37	6	176	31	882	0.97565	-0.00203	0.96994	2.35960	0.39871	1.0000000000	1.0000000000	6.14977	-0.03054	92	24	3	90	13	3	0.52325	0.02128
5	284549007	Laceration of hand	91	64859006	Osteoporosis (disorder)	1095	104	37	6	98	31	960	1.70738	0.04285	1.89598	4.65654	0.77198	0.1538485944	0.7717368396	3.51416	0.63290	54	24	4	50	13	2	-0.06899	-0.58395
117	230265002	Familial Alzheimer's disease of early onset (disorder)	65	239873007	Osteoarthritis of knee	1095	6	57	0	6	57	1032	0.00000	-0.01739	0.00000	0.00000	0.00000	1.0000000000	1.0000000000	0.31233	-0.39213	2	30	0	4	27	0	0.00000	0.00000
3	65363002	Otitis media	91	64859006	Osteoporosis (disorder)	1095	580	37	6	574	31	484	0.30615	-0.13770	0.16320	0.39444	0.06752	0.0000051111	0.0002312640	19.59817	-1.55709	277	24	3	303	13	3	0.52325	-0.08880
115	36923009	Major depression  single episode	65	239873007	Osteoarthritis of knee	1095	6	57	0	6	57	1032	0.00000	-0.01739	0.00000	0.00000	0.00000	1.0000000000	1.0000000000	0.31233	-0.39213	3	30	0	3	27	0	0.00000	0.00000
1	444814009	Viral sinusitis (disorder)	91	64859006	Osteoporosis (disorder)	1095	993	37	37	956	0	102	1.10272	0.05994	0.00000	0.00000	0.00000	0.0420632024	0.3927987138	33.55342	0.13717	478	24	24	515	13	13	0.00000	-0.66360
111	235919008	Cholelithiasis	65	239873007	Osteoarthritis of knee	1095	9	57	0	9	57	1029	0.00000	-0.02133	0.00000	0.00000	0.00000	1.0000000000	1.0000000000	0.46849	-0.55434	7	30	0	2	27	0	0.00000	0.00000
109	90560007	Gout	65	239873007	Osteoarthritis of knee	1095	4	57	0	4	57	1034	0.00000	-0.01419	0.00000	0.00000	0.00000	1.0000000000	1.0000000000	0.20822	-0.27288	0	30	0	4	27	0	0.00000	0.00000
108	40930008	Hypothyroidism (disorder)	65	239873007	Osteoarthritis of knee	1095	13	57	2	11	55	1027	2.95547	0.05023	3.39504	15.69245	0.73451	0.1438319172	0.7404942507	0.67671	0.83933	11	30	2	2	27	0	2.77259	1.87180
107	40275004	Contact dermatitis	65	239873007	Osteoarthritis of knee	1095	18	57	3	15	54	1023	3.20175	0.06670	3.78889	13.48414	1.06463	0.0625651361	0.4860148357	0.93699	1.04619	9	30	1	9	27	2	0.75984	0.59784
106	24079001	Atopic dermatitis	65	239873007	Osteoarthritis of knee	1095	20	57	0	20	57	1018	0.00000	-0.03196	0.00000	0.00000	0.00000	0.6196301622	1.0000000000	1.04110	-1.02934	13	30	0	7	27	0	0.00000	0.00000
102	90781000119102	Microalbuminuria due to type 2 diabetes mellitus (disorder)	65	239873007	Osteoarthritis of knee	1095	6	57	1	5	56	1033	3.20175	0.03830	3.68929	32.11245	0.42385	0.2749439423	0.9503524867	0.31233	0.60787	3	30	1	3	27	0	3.43399	1.38629
101	433144002	Chronic kidney disease stage 3 (disorder)	65	239873007	Osteoarthritis of knee	1095	3	57	0	3	57	1035	0.00000	-0.01228	0.00000	0.00000	0.00000	1.0000000000	1.0000000000	0.15616	-0.20935	1	30	0	2	27	0	0.00000	0.00000
100	161622006	History of lower limb amputation (situation)	65	239873007	Osteoarthritis of knee	1095	1	57	0	1	57	1037	0.00000	-0.00708	0.00000	0.00000	0.00000	1.0000000000	1.0000000000	0.05205	-0.07321	0	30	0	1	27	0	0.00000	0.00000
98	1551000119108	Nonproliferative diabetic retinopathy due to type 2 diabetes mellitus (disorder)	65	239873007	Osteoarthritis of knee	1095	12	57	3	9	54	1029	4.80263	0.09380	6.35185	24.13670	1.67156	0.0210488787	0.2591403333	0.62466	1.29986	7	30	0	5	27	3	-2.30259	-0.98083
97	403192003	Third degree burn	65	239873007	Osteoarthritis of knee	1095	8	57	1	7	56	1031	2.40132	0.02817	2.63010	21.74759	0.31808	0.3488917881	1.0000000000	0.41644	0.49773	3	30	0	5	27	1	-3.33220	-1.79176
96	283371005	Laceration of forearm	65	239873007	Osteoarthritis of knee	1095	75	57	9	66	48	972	2.30526	0.08294	2.76136	5.87119	1.29874	0.0124774760	0.1780931457	3.90411	1.02794	39	30	5	36	27	4	-0.10178	-0.12783
115	36923009	Major depression  single episode	133	97331000119101	Macular edema and retinopathy due to type 2 diabetes mellitus (disorder)	1095	6	4	0	6	4	1085	0.00000	-0.00449	0.00000	0.00000	0.00000	1.0000000000	1.0000000000	0.02192	-0.03128	3	2	0	3	2	0	0.00000	0.00000
94	703151001	History of single seizure (situation)	65	239873007	Osteoarthritis of knee	1095	39	57	2	37	55	1001	0.98516	-0.00067	0.98378	4.18782	0.23111	1.0000000000	1.0000000000	2.03014	-0.01442	14	30	0	25	27	2	-2.67415	-2.60269
93	128613002	Seizure disorder	65	239873007	Osteoarthritis of knee	1095	39	57	2	37	55	1001	0.98516	-0.00067	0.98378	4.18782	0.23111	1.0000000000	1.0000000000	2.03014	-0.01442	14	30	0	25	27	2	-2.67415	-2.60269
89	47693006	Rupture of appendix	65	239873007	Osteoarthritis of knee	1095	20	57	2	18	55	1020	1.92105	0.02944	2.06061	9.10527	0.46633	0.2796329125	0.9574808819	1.04110	0.55562	10	30	0	10	27	2	-2.67415	-1.79176
86	713197008	Recurrent rectal polyp	65	239873007	Osteoarthritis of knee	1095	22	57	3	19	54	1019	2.61962	0.05435	2.97953	10.37913	0.85533	0.1020485784	0.6291042150	1.14521	0.89888	12	30	3	10	27	0	2.39790	1.60944
82	94260004	Secondary malignant neoplasm of colon	65	239873007	Osteoarthritis of knee	1095	4	57	2	2	55	1036	9.60526	0.12210	18.83636	136.24169	2.60426	0.0149348054	0.2058049008	0.20822	1.31208	2	30	1	2	27	1	0.10178	0.00000
78	239872002	Osteoarthritis of hip	65	239873007	Osteoarthritis of knee	1095	21	57	0	21	57	1017	0.00000	-0.03277	0.00000	0.00000	0.00000	0.6214170159	1.0000000000	1.09315	-1.06568	13	30	0	8	27	0	0.00000	0.00000
76	127013003	Diabetic renal disease (disorder)	65	239873007	Osteoarthritis of knee	1095	28	57	3	25	54	1013	2.05827	0.04017	2.25111	7.68961	0.65901	0.1749080368	0.8000743861	1.45753	0.70279	10	30	1	18	27	2	0.75984	0.09531
75	431855005	Chronic kidney disease stage 1 (disorder)	65	239873007	Osteoarthritis of knee	1095	28	57	3	25	54	1013	2.05827	0.04017	2.25111	7.68961	0.65901	0.1749080368	0.8000743861	1.45753	0.70279	10	30	1	18	27	2	0.75984	0.09531
72	35999006	Blighted ovum	65	239873007	Osteoarthritis of knee	1095	53	57	2	51	55	987	0.72493	-0.01454	0.70374	2.96636	0.16696	1.0000000000	1.0000000000	2.75890	-0.32535	53	30	2	0	27	0	2.77259	3.31419
71	201834006	Localized  primary osteoarthritis of the hand	65	239873007	Osteoarthritis of knee	1095	28	57	0	28	57	1010	0.00000	-0.03796	0.00000	0.00000	0.00000	0.3944681744	1.0000000000	1.45753	-1.29721	19	30	0	9	27	0	0.00000	0.00000
70	87433001	Pulmonary emphysema (disorder)	65	239873007	Osteoarthritis of knee	1095	17	57	2	15	55	1023	2.26006	0.03708	2.48000	11.11619	0.55328	0.2202733001	0.8777410641	0.88493	0.67045	9	30	1	8	27	1	0.10178	0.10536
69	233604007	Pneumonia	65	239873007	Osteoarthritis of knee	1095	7	57	1	6	56	1032	2.74436	0.03279	3.07143	25.94972	0.36354	0.3128945348	1.0000000000	0.36438	0.55175	3	30	1	4	27	0	3.43399	1.38629
67	403191005	Second degree burn	65	239873007	Osteoarthritis of knee	1095	49	57	4	45	53	993	1.56821	0.02882	1.66541	4.80355	0.57740	0.3165740842	1.0000000000	2.55068	0.49383	23	30	2	26	27	2	0.09844	-0.11333
64	444448004	Injury of medial collateral ligament of knee	65	239873007	Osteoarthritis of knee	1095	32	57	3	29	54	1009	1.80099	0.03257	1.93295	6.54592	0.57078	0.2297515070	0.8880487574	1.66575	0.58546	17	30	3	15	27	0	2.39790	1.89712
63	68496003	Polyp of colon	65	239873007	Osteoarthritis of knee	1095	91	57	16	75	41	963	3.37767	0.16774	5.01073	9.34907	2.68556	0.0000049706	0.0002260743	4.73699	1.56717	43	30	10	48	27	6	-0.31845	-0.52952
59	262574004	Bullet wound	65	239873007	Osteoarthritis of knee	1095	20	57	1	19	56	1019	0.96053	-0.00126	0.95771	7.28330	0.12593	1.0000000000	1.0000000000	1.04110	-0.02934	9	30	1	11	27	0	3.43399	2.30259
58	239720000	Tear of meniscus of knee	65	239873007	Osteoarthritis of knee	1095	20	57	1	19	56	1019	0.96053	-0.00126	0.95771	7.28330	0.12593	1.0000000000	1.0000000000	1.04110	-0.02934	10	30	0	10	27	1	-3.33220	-2.39790
57	192127007	Child attention deficit disorder	65	239873007	Osteoarthritis of knee	1095	76	57	1	75	56	963	0.25277	-0.04782	0.22929	1.67953	0.03130	0.1743393986	0.8000743861	3.95616	-1.30922	24	30	0	52	27	1	-3.33220	-3.97029
56	92691004	Carcinoma in situ of prostate (disorder)	65	239873007	Osteoarthritis of knee	1095	23	57	1	22	56	1016	0.83524	-0.00566	0.82468	6.22908	0.10918	1.0000000000	1.0000000000	1.19726	-0.13571	0	30	0	23	27	1	-3.33220	-3.17805
54	5602001	Opioid abuse (disorder)	65	239873007	Osteoarthritis of knee	1095	7	57	0	7	57	1031	0.00000	-0.01880	0.00000	0.00000	0.00000	1.0000000000	1.0000000000	0.36438	-0.44825	0	30	0	7	27	0	0.00000	0.00000
52	124171000119105	Chronic intractable migraine without aura	65	239873007	Osteoarthritis of knee	1095	51	57	3	48	54	990	1.13003	0.00673	1.14583	3.79723	0.34576	0.7447966887	1.0000000000	2.65479	0.13021	21	30	0	30	27	3	-2.30259	-2.39790
50	446096008	Perennial allergic rhinitis	65	239873007	Osteoarthritis of knee	1095	26	57	0	26	57	1012	0.00000	-0.03655	0.00000	0.00000	0.00000	0.3941258759	1.0000000000	1.35342	-1.23476	14	30	0	12	27	0	0.00000	0.00000
49	88805009	Chronic congestive heart failure (disorder)	65	239873007	Osteoarthritis of knee	1095	10	57	2	8	55	1030	3.84211	0.06394	4.68182	22.57264	0.97106	0.0915950503	0.5998476181	0.52055	0.98037	5	30	1	5	27	1	0.10178	0.00000
47	359817006	Closed fracture of hip	65	239873007	Osteoarthritis of knee	1095	29	57	0	29	57	1009	0.00000	-0.03865	0.00000	0.00000	0.00000	0.3960858219	1.0000000000	1.50959	-1.32745	11	30	0	18	27	0	0.00000	0.00000
45	263102004	Fracture subluxation of wrist	65	239873007	Osteoarthritis of knee	1095	109	57	3	106	54	932	0.52873	-0.03672	0.48847	1.58939	0.15012	0.3592003642	1.0000000000	5.67397	-0.73855	51	30	3	58	27	0	2.39790	2.89037
44	58150001	Fracture of clavicle	65	239873007	Osteoarthritis of knee	1095	112	57	5	107	52	931	0.85761	-0.01126	0.83663	2.14015	0.32705	1.0000000000	1.0000000000	5.83014	-0.18695	55	30	4	57	27	1	-1.19214	-1.36920
43	307731004	Injury of tendon of the rotator cuff of shoulder	65	239873007	Osteoarthritis of knee	1095	51	57	4	47	53	991	1.50671	0.02624	1.59133	4.58202	0.55267	0.3329404031	1.0000000000	2.65479	0.45214	26	30	2	25	27	2	0.09844	0.03637
42	16114001	Fracture of ankle	65	239873007	Osteoarthritis of knee	1095	108	57	7	101	50	937	1.24513	0.01900	1.29881	2.94058	0.57367	0.4943175176	1.0000000000	5.62192	0.27275	48	30	4	60	27	3	-0.16252	-0.47957
41	283385000	Laceration of thigh	65	239873007	Osteoarthritis of knee	1095	105	57	10	95	47	943	1.82957	0.06331	2.11198	4.31477	1.03377	0.0590073580	0.4708787172	5.46575	0.76661	50	30	2	55	27	8	1.29668	1.19440
39	74400008	Appendicitis	65	239873007	Osteoarthritis of knee	1095	51	57	4	47	53	991	1.50671	0.02624	1.59133	4.58202	0.55267	0.3329404031	1.0000000000	2.65479	0.45214	27	30	2	24	27	2	0.09844	0.10920
38	398254007	Preeclampsia	65	239873007	Osteoarthritis of knee	1095	101	57	11	90	46	948	2.09224	0.08159	2.51884	5.03411	1.26031	0.0152095755	0.2090920355	5.25753	0.93937	101	30	11	0	27	0	1.31568	2.32060
35	19169002	Miscarriage in first trimester	65	239873007	Osteoarthritis of knee	1095	174	57	13	161	44	877	1.43527	0.04433	1.60940	3.05564	0.84767	0.1396948875	0.7347164307	9.05753	0.47715	174	30	13	0	27	0	1.19625	2.66616
33	429007001	History of cardiac arrest (situation)	65	239873007	Osteoarthritis of knee	1095	42	57	2	40	55	998	0.91479	-0.00399	0.90727	3.85177	0.21371	1.0000000000	1.0000000000	2.18630	-0.08692	24	30	1	18	27	1	0.10178	0.27444
32	410429000	Cardiac Arrest	65	239873007	Osteoarthritis of knee	1095	42	57	2	40	55	998	0.91479	-0.00399	0.90727	3.85177	0.21371	1.0000000000	1.0000000000	2.18630	-0.08692	24	30	1	18	27	1	0.10178	0.27444
30	399211009	History of myocardial infarction (situation)	65	239873007	Osteoarthritis of knee	1095	31	57	3	28	54	1010	1.85908	0.03436	2.00397	6.79958	0.59061	0.2157058993	0.8677664455	1.61370	0.61391	2	30	0	29	27	3	-2.30259	-2.36712
29	22298006	Myocardial Infarction	65	239873007	Osteoarthritis of knee	1095	31	57	3	28	54	1010	1.85908	0.03436	2.00397	6.79958	0.59061	0.2157058993	0.8677664455	1.61370	0.61391	2	30	0	29	27	3	-2.30259	-2.36712
27	408512008	Body mass index 40+ - severely obese (finding)	65	239873007	Osteoarthritis of knee	1095	97	57	11	86	46	952	2.17851	0.08610	2.64712	5.29800	1.32262	0.0130479734	0.1844365709	5.04932	0.98819	67	30	9	30	27	2	-1.20781	-0.63908
24	162864005	Body mass index 30+ - obesity (finding)	65	239873007	Osteoarthritis of knee	1095	439	57	39	400	18	638	1.70663	0.13546	3.45583	6.12497	1.94985	0.0000110288	0.0004654361	22.85205	0.74589	226	30	22	213	27	17	-0.09078	-0.18248
23	36971009	Sinusitis (disorder)	65	239873007	Osteoarthritis of knee	1095	190	57	9	181	48	857	0.90997	-0.00967	0.88778	1.84179	0.42793	0.8586122510	1.0000000000	9.89041	-0.12306	84	30	5	106	27	4	-0.10178	-0.43499
21	15777000	Prediabetes	65	239873007	Osteoarthritis of knee	1095	333	57	30	303	27	735	1.73068	0.11319	2.69527	4.61065	1.57559	0.0003310317	0.0098836610	17.33425	0.75773	159	30	19	174	27	11	-0.29231	-0.58512
20	80394007	Hyperglycemia (disorder)	65	239873007	Osteoarthritis of knee	1095	55	57	6	49	51	989	2.09569	0.05905	2.37455	5.80101	0.97198	0.0605443741	0.4796557004	2.86301	0.85763	23	30	1	32	27	5	1.57769	1.17657
19	237602007	Metabolic syndrome X (disorder)	65	239873007	Osteoarthritis of knee	1095	64	57	6	58	51	980	1.80099	0.04677	1.98783	4.82327	0.81925	0.1384967364	0.7306035772	3.33151	0.69249	28	30	1	36	27	5	1.57769	1.26316
18	302870006	Hypertriglyceridemia (disorder)	65	239873007	Osteoarthritis of knee	1095	64	57	6	58	51	980	1.80099	0.04677	1.98783	4.82327	0.81925	0.1384967364	0.7306035772	3.33151	0.69249	28	30	1	36	27	5	1.57769	1.26316
17	368581000119106	Neuropathy due to type 2 diabetes mellitus (disorder)	65	239873007	Osteoarthritis of knee	1095	28	57	3	25	54	1013	2.05827	0.04017	2.25111	7.68961	0.65901	0.1749080368	0.8000743861	1.45753	0.70279	7	30	0	21	27	3	-2.30259	-2.07944
15	40055000	Chronic sinusitis (disorder)	65	239873007	Osteoarthritis of knee	1095	216	57	16	200	41	838	1.42300	0.04914	1.63512	2.97337	0.89919	0.1223815486	0.6900579845	11.24384	0.47348	104	30	6	112	27	10	0.48343	0.40728
14	10509002	Acute bronchitis (disorder)	65	239873007	Osteoarthritis of knee	1095	863	57	55	808	2	230	1.22431	0.10138	7.82797	32.33549	1.89504	0.0001895332	0.0061165372	44.92329	0.28620	418	30	28	445	27	27	0.03509	-0.09303
13	370247008	Facial laceration	65	239873007	Osteoarthritis of knee	1095	109	57	5	104	52	934	0.88122	-0.00925	0.86354	2.21019	0.33739	1.0000000000	1.0000000000	5.67397	-0.15358	55	30	4	54	27	1	-1.19214	-1.31609
125	1734006	Fracture of the vertebral column with spinal cord injury	39	74400008	Appendicitis	1095	5	51	1	4	50	1040	4.29412	0.04931	5.20000	47.38305	0.57067	0.2125234992	0.8671354646	0.23288	0.69797	3	27	1	2	24	0	3.33220	1.38629
10	62106007	Concussion with no loss of consciousness	65	239873007	Osteoarthritis of knee	1095	206	57	16	190	41	848	1.49208	0.05551	1.74172	3.16974	0.95705	0.0802729927	0.5609996513	10.72329	0.53616	96	30	9	110	27	7	-0.11411	-0.35953
8	233678006	Childhood asthma	65	239873007	Osteoarthritis of knee	1095	45	57	1	44	56	994	0.42690	-0.02780	0.40341	2.98173	0.05458	0.7261247376	1.0000000000	2.34247	-0.74091	25	30	0	20	27	1	-3.33220	-3.04452
7	75498004	Acute bacterial sinusitis (disorder)	65	239873007	Osteoarthritis of knee	1095	187	57	21	166	36	872	2.15733	0.12308	3.06426	5.38164	1.74476	0.0002032132	0.0064865656	9.73425	1.03528	89	30	8	98	27	13	0.43421	0.35069
6	39848009	Whiplash injury to neck	65	239873007	Osteoarthritis of knee	1095	182	57	13	169	44	869	1.37218	0.03894	1.51923	2.88199	0.80086	0.2015060705	0.8487621338	9.47397	0.41862	92	30	8	90	27	5	-0.29815	-0.41871
5	284549007	Laceration of hand	65	239873007	Osteoarthritis of knee	1095	104	57	8	96	49	942	1.47773	0.03627	1.60204	3.48197	0.73709	0.2422706423	0.9106068739	5.41370	0.48877	54	30	5	50	27	3	-0.35667	-0.40358
117	230265002	Familial Alzheimer's disease of early onset (disorder)	39	74400008	Appendicitis	1095	6	51	1	5	50	1039	3.57843	0.04230	4.15600	36.24351	0.47656	0.2493687300	0.9133257124	0.27945	0.64447	2	27	0	4	24	1	-3.21888	-1.60944
1	444814009	Viral sinusitis (disorder)	65	239873007	Osteoarthritis of knee	1095	993	57	56	937	1	101	1.08337	0.06096	6.03629	44.07104	0.82677	0.0559021025	0.4594650332	51.69041	0.11342	478	30	30	515	27	26	-0.01905	-0.20604
109	90560007	Gout	39	74400008	Appendicitis	1095	4	51	0	4	51	1040	0.00000	-0.01338	0.00000	0.00000	0.00000	1.0000000000	1.0000000000	0.18630	-0.24647	0	27	0	4	24	0	0.00000	0.00000
118	48333001	Burn injury(morphologic abnormality)	78	239872002	Osteoarthritis of hip	1095	1	21	0	1	21	1073	0.00000	-0.00423	0.00000	0.00000	0.00000	1.0000000000	1.0000000000	0.01918	-0.02741	0	13	0	1	8	0	0.00000	0.00000
97	403192003	Third degree burn	39	74400008	Appendicitis	1095	8	51	0	8	51	1036	0.00000	-0.01896	0.00000	0.00000	0.00000	1.0000000000	1.0000000000	0.37260	-0.45691	3	27	0	5	24	0	0.00000	0.00000
96	283371005	Laceration of forearm	39	74400008	Appendicitis	1095	75	51	3	72	48	972	0.85882	-0.00846	0.84375	2.77549	0.25650	1.0000000000	1.0000000000	3.49315	-0.16773	39	27	0	36	24	3	-2.19722	-2.56495
94	703151001	History of single seizure (situation)	39	74400008	Appendicitis	1095	39	51	2	37	49	1007	1.10106	0.00429	1.11087	4.74272	0.26019	0.7024948712	1.0000000000	1.81644	0.09109	14	27	1	25	24	1	0.11333	-0.55005
93	128613002	Seizure disorder	39	74400008	Appendicitis	1095	39	51	2	37	49	1007	1.10106	0.00429	1.11087	4.74272	0.26019	0.7024948712	1.0000000000	1.81644	0.09109	14	27	1	25	24	1	0.11333	-0.55005
86	713197008	Recurrent rectal polyp	39	74400008	Appendicitis	1095	22	51	4	18	47	1026	3.90374	0.09190	4.85106	14.90006	1.57938	0.0163942262	0.2183740785	1.02466	1.30425	12	27	1	10	24	3	1.13498	1.09861
75	431855005	Chronic kidney disease stage 1 (disorder)	39	74400008	Appendicitis	1095	28	51	1	27	50	1017	0.76681	-0.00835	0.75333	5.65634	0.10033	1.0000000000	1.0000000000	1.30411	-0.20421	10	27	0	18	24	1	-3.21888	-2.94444
69	233604007	Pneumonia	39	74400008	Appendicitis	1095	7	51	1	6	50	1038	3.06723	0.03665	3.46000	29.28892	0.40874	0.2845222606	0.9659403678	0.32603	0.59289	3	27	0	4	24	1	-3.21888	-1.60944
64	444448004	Injury of medial collateral ligament of knee	39	74400008	Appendicitis	1095	32	51	2	30	49	1014	1.34191	0.01311	1.37959	5.93918	0.32046	0.6576488290	1.0000000000	1.49041	0.26858	17	27	1	15	24	1	0.11333	0.11778
49	88805009	Chronic congestive heart failure (disorder)	39	74400008	Appendicitis	1095	10	51	1	9	50	1035	2.14706	0.02434	2.30000	18.50972	0.28580	0.3805778618	1.0000000000	0.46575	0.44836	5	27	0	5	24	1	-3.21888	-1.79176
47	359817006	Closed fracture of hip	39	74400008	Appendicitis	1095	29	51	1	28	50	1016	0.74037	-0.00946	0.72571	5.44210	0.09678	1.0000000000	1.0000000000	1.35068	-0.23308	11	27	0	18	24	1	-3.21888	-2.94444
44	58150001	Fracture of clavicle	39	74400008	Appendicitis	1095	112	51	8	104	43	940	1.53361	0.03981	1.68157	3.67335	0.76979	0.2305544970	0.8899459402	5.21644	0.53384	55	27	4	57	24	4	0.10178	-0.03334
43	307731004	Injury of tendon of the rotator cuff of shoulder	39	74400008	Appendicitis	1095	51	51	2	49	49	995	0.84198	-0.00772	0.82882	3.50767	0.19584	1.0000000000	1.0000000000	2.37534	-0.17007	26	27	1	25	24	1	0.11333	0.03774
42	16114001	Fracture of ankle	39	74400008	Appendicitis	1095	108	51	2	106	49	938	0.39760	-0.04404	0.36119	1.50642	0.08660	0.2242111777	0.8794911525	5.03014	-1.00723	48	27	1	60	24	1	0.11333	-0.21905
41	283385000	Laceration of thigh	39	74400008	Appendicitis	1095	105	51	9	96	42	948	1.84034	0.06049	2.11607	4.47931	0.99965	0.0526790739	0.4433527430	4.89041	0.76356	50	27	5	55	24	4	-0.08961	-0.29335
38	398254007	Preeclampsia	39	74400008	Appendicitis	1095	101	51	5	96	46	948	1.06290	0.00443	1.07337	2.76574	0.41657	0.8051124427	1.0000000000	4.70411	0.07296	101	27	5	0	24	0	1.85630	3.05400
35	19169002	Miscarriage in first trimester	39	74400008	Appendicitis	1095	174	51	10	164	41	880	1.23394	0.02247	1.30874	2.66484	0.64274	0.4349709406	1.0000000000	8.10411	0.27291	174	27	10	0	24	0	1.30833	2.91235
33	429007001	History of cardiac arrest (situation)	39	74400008	Appendicitis	1095	42	51	4	38	47	1006	2.04482	0.04612	2.25308	6.57506	0.77206	0.1267807618	0.6972941899	1.95616	0.75820	24	27	2	18	24	2	0.10920	0.26236
32	410429000	Cardiac Arrest	39	74400008	Appendicitis	1095	42	51	4	38	47	1006	2.04482	0.04612	2.25308	6.57506	0.77206	0.1267807618	0.6972941899	1.95616	0.75820	24	27	2	18	24	2	0.10920	0.26236
27	408512008	Body mass index 40+ - severely obese (finding)	39	74400008	Appendicitis	1095	97	51	12	85	39	959	2.65616	0.11412	3.47149	6.87959	1.75174	0.0010133584	0.0252592497	4.51781	1.23634	67	27	8	30	24	4	-0.47000	0.09798
21	15777000	Prediabetes	39	74400008	Appendicitis	1095	333	51	20	313	31	731	1.28952	0.04230	1.50675	2.68443	0.84573	0.1635518853	0.7879650300	15.50959	0.34709	159	27	6	174	24	14	0.70622	0.71680
130	314994000	Metastasis from malignant tumor of prostate (disorder)	13	370247008	Facial laceration	1095	1	109	0	1	109	985	0.00000	-0.01005	0.00000	0.00000	0.00000	1.0000000000	1.0000000000	0.09954	-0.13690	0	55	0	1	54	0	0.00000	0.00000
15	40055000	Chronic sinusitis (disorder)	39	74400008	Appendicitis	1095	216	51	13	203	38	841	1.29221	0.03202	1.41729	2.70983	0.74127	0.2823525312	0.9647685943	10.06027	0.34004	104	27	7	112	24	6	-0.02899	-0.21531
14	10509002	Acute bronchitis (disorder)	39	74400008	Appendicitis	1095	863	51	46	817	5	227	1.14443	0.06157	2.55618	6.50837	1.00395	0.0515965443	0.4397227827	40.19452	0.19021	418	27	24	445	24	22	0.01617	-0.14203
125	1734006	Fracture of the vertebral column with spinal cord injury	13	370247008	Facial laceration	1095	5	109	0	5	109	981	0.00000	-0.02252	0.00000	0.00000	0.00000	1.0000000000	1.0000000000	0.49772	-0.58276	3	55	0	2	54	0	0.00000	0.00000
118	48333001	Burn injury(morphologic abnormality)	13	370247008	Facial laceration	1095	1	109	0	1	109	985	0.00000	-0.01005	0.00000	0.00000	0.00000	1.0000000000	1.0000000000	0.09954	-0.13690	0	55	0	1	54	0	0.00000	0.00000
117	230265002	Familial Alzheimer's disease of early onset (disorder)	13	370247008	Facial laceration	1095	6	109	1	5	108	981	1.67431	0.01664	1.81667	15.69300	0.21030	0.4677486559	1.0000000000	0.59726	0.32440	2	55	1	4	54	0	4.02535	1.09861
109	90560007	Gout	13	370247008	Facial laceration	1095	4	109	0	4	109	982	0.00000	-0.02013	0.00000	0.00000	0.00000	1.0000000000	1.0000000000	0.39817	-0.48354	0	55	0	4	54	0	0.00000	0.00000
102	90781000119102	Microalbuminuria due to type 2 diabetes mellitus (disorder)	13	370247008	Facial laceration	1095	6	109	1	5	108	981	1.67431	0.01664	1.81667	15.69300	0.21030	0.4677486559	1.0000000000	0.59726	0.32440	3	55	0	3	54	1	-4.00733	-1.38629
98	1551000119108	Nonproliferative diabetic retinopathy due to type 2 diabetes mellitus (disorder)	13	370247008	Facial laceration	1095	12	109	1	11	108	975	0.83716	-0.00570	0.82071	6.41832	0.10494	1.0000000000	1.0000000000	1.19452	-0.13391	7	55	1	5	54	0	4.02535	2.07944
97	403192003	Third degree burn	13	370247008	Facial laceration	1095	8	109	1	7	108	979	1.25573	0.00729	1.29497	10.62474	0.15784	0.5690084463	1.0000000000	0.79635	0.15493	3	55	0	5	54	1	-4.00733	-1.79176
96	283371005	Laceration of forearm	13	370247008	Facial laceration	1095	75	109	6	69	103	917	0.80367	-0.01770	0.77417	1.82714	0.32802	0.6910901890	1.0000000000	7.46575	-0.27428	39	55	5	36	54	1	-1.52243	-1.43617
94	703151001	History of single seizure (situation)	13	370247008	Facial laceration	1095	39	109	3	36	106	950	0.77276	-0.01452	0.74686	2.46672	0.22613	0.7903785974	1.0000000000	3.88219	-0.28753	14	55	1	25	54	2	0.69315	0.10536
93	128613002	Seizure disorder	13	370247008	Facial laceration	1095	39	109	3	36	106	950	0.77276	-0.01452	0.74686	2.46672	0.22613	0.7903785974	1.0000000000	3.88219	-0.28753	14	55	1	25	54	2	0.69315	0.10536
89	47693006	Rupture of appendix	13	370247008	Facial laceration	1095	20	109	6	14	103	972	3.01376	0.09133	4.04438	10.75125	1.52141	0.0102742749	0.1582730098	1.99087	1.22679	10	55	2	10	54	4	0.67576	0.53900
86	713197008	Recurrent rectal polyp	13	370247008	Facial laceration	1095	22	109	7	15	102	971	3.19641	0.10457	4.44248	11.14807	1.77032	0.0038573636	0.0734488881	2.18995	1.32646	12	55	3	10	54	4	0.28768	0.35667
75	431855005	Chronic kidney disease stage 1 (disorder)	13	370247008	Facial laceration	1095	28	109	2	26	107	960	0.71756	-0.01521	0.69015	2.94817	0.16156	1.0000000000	1.0000000000	2.78721	-0.33617	10	55	0	18	54	2	-3.33220	-2.30259
72	35999006	Blighted ovum	13	370247008	Facial laceration	1095	53	109	7	46	102	940	1.32681	0.02451	1.40239	3.18730	0.61704	0.4764410345	1.0000000000	5.27580	0.35020	53	55	7	0	54	0	2.18122	2.14843
69	233604007	Pneumonia	13	370247008	Facial laceration	1095	7	109	0	7	109	979	0.00000	-0.02667	0.00000	0.00000	0.00000	1.0000000000	1.0000000000	0.69680	-0.76282	3	55	0	4	54	0	0.00000	0.00000
67	403191005	Second degree burn	13	370247008	Facial laceration	1095	49	109	3	46	106	940	0.61505	-0.02770	0.57834	1.89166	0.17682	0.4692485365	1.0000000000	4.87763	-0.55523	23	55	3	26	54	0	2.96183	2.15948
64	444448004	Injury of medial collateral ligament of knee	13	370247008	Facial laceration	1095	32	109	3	29	106	957	0.94180	-0.00336	0.93396	3.11794	0.27976	1.0000000000	1.0000000000	3.18539	-0.06536	17	55	3	15	54	0	2.96183	1.89712
63	68496003	Polyp of colon	13	370247008	Facial laceration	1095	91	109	15	76	94	910	1.65591	0.06566	1.91069	3.45747	1.05590	0.0420345035	0.3927987138	9.05845	0.66966	43	55	6	48	54	9	0.37320	0.25423
50	446096008	Perennial allergic rhinitis	13	370247008	Facial laceration	1095	26	109	3	23	106	963	1.15914	0.00825	1.18499	4.01269	0.34994	0.7379522816	1.0000000000	2.58813	0.15677	14	55	0	12	54	3	-2.94444	-1.60944
49	88805009	Chronic congestive heart failure (disorder)	13	370247008	Facial laceration	1095	10	109	1	9	108	977	1.00459	0.00015	1.00514	8.00971	0.12614	1.0000000000	1.0000000000	0.99543	0.00330	5	55	1	5	54	0	4.02535	1.79176
47	359817006	Closed fracture of hip	13	370247008	Facial laceration	1095	29	109	3	26	106	960	1.03923	0.00215	1.04499	3.51071	0.31105	1.0000000000	1.0000000000	2.88676	0.04143	11	55	2	18	54	1	-0.65743	-1.07264
44	58150001	Fracture of clavicle	13	370247008	Facial laceration	1095	112	109	13	99	96	887	1.16604	0.01863	1.21328	2.24492	0.65572	0.5071375204	1.0000000000	11.14886	0.20461	55	55	6	57	54	7	0.15415	0.10614
43	307731004	Injury of tendon of the rotator cuff of shoulder	13	370247008	Facial laceration	1095	51	109	5	46	104	940	0.98489	-0.00111	0.98244	2.52737	0.38189	1.0000000000	1.0000000000	5.07671	-0.01833	26	55	2	25	54	3	0.40547	0.40547
42	16114001	Fracture of ankle	13	370247008	Facial laceration	1095	108	109	11	97	98	889	1.02319	0.00255	1.02872	1.98545	0.53301	0.8666141202	1.0000000000	10.75068	0.03029	48	55	4	60	54	7	0.52628	0.30617
41	283385000	Laceration of thigh	13	370247008	Facial laceration	1095	105	109	10	95	99	891	0.95675	-0.00468	0.94737	1.87727	0.47809	1.0000000000	1.0000000000	10.45205	-0.05810	50	55	5	55	54	5	0.01681	-0.08701
39	74400008	Appendicitis	13	370247008	Facial laceration	1095	51	109	10	41	99	945	1.96978	0.07127	2.32816	4.79072	1.13142	0.0282166279	0.3099944430	5.07671	0.85614	27	55	4	24	54	6	0.38866	0.43825
38	398254007	Preeclampsia	13	370247008	Facial laceration	1095	101	109	18	83	91	903	1.79035	0.08377	2.15199	3.74236	1.23747	0.0087481024	0.1391138464	10.05388	0.78145	101	55	18	0	54	0	1.40009	1.88875
35	19169002	Miscarriage in first trimester	13	370247008	Facial laceration	1095	174	109	21	153	88	833	1.21243	0.03070	1.29924	2.15554	0.78311	0.3331532485	1.0000000000	17.32055	0.26404	174	55	21	0	54	0	1.28621	2.22848
33	429007001	History of cardiac arrest (situation)	13	370247008	Facial laceration	1095	42	109	2	40	107	946	0.47837	-0.03464	0.44206	1.85487	0.10535	0.4255222693	1.0000000000	4.18082	-0.78822	24	55	1	18	54	1	0.01802	0.27444
32	410429000	Cardiac Arrest	13	370247008	Facial laceration	1095	42	109	2	40	107	946	0.47837	-0.03464	0.44206	1.85487	0.10535	0.4255222693	1.0000000000	4.18082	-0.78822	24	55	1	18	54	1	0.01802	0.27444
27	408512008	Body mass index 40+ - severely obese (finding)	13	370247008	Facial laceration	1095	97	109	12	85	97	901	1.24279	0.02517	1.31134	2.48612	0.69169	0.3771943959	1.0000000000	9.65571	0.28689	67	55	10	30	54	2	-1.46040	-0.73137
21	15777000	Prediabetes	13	370247008	Facial laceration	1095	333	109	49	284	60	702	1.47822	0.10511	2.01866	3.01683	1.35075	0.0009080590	0.0231041787	33.14795	0.55013	159	55	23	174	54	26	0.09728	0.02829
20	80394007	Hyperglycemia (disorder)	13	370247008	Facial laceration	1095	55	109	9	46	100	940	1.64387	0.04923	1.83913	3.86834	0.87438	0.1067820837	0.6424490271	5.47489	0.62707	23	55	4	32	54	5	0.22314	-0.09194
18	302870006	Hypertriglyceridemia (disorder)	13	370247008	Facial laceration	1095	64	109	9	55	100	931	1.41270	0.03419	1.52345	3.17495	0.73101	0.2783723549	0.9565195531	6.37078	0.44011	28	55	4	36	54	5	0.22314	-0.02469
15	40055000	Chronic sinusitis (disorder)	13	370247008	Facial laceration	1095	216	109	26	190	83	796	1.20923	0.03448	1.31237	2.09570	0.82183	0.2548463452	0.9153196474	21.50137	0.26295	104	55	11	112	54	15	0.26570	0.21090
14	10509002	Acute bronchitis (disorder)	13	370247008	Facial laceration	1095	863	109	93	770	16	216	1.08258	0.05296	1.63052	2.83039	0.93930	0.0843876248	0.5737835561	85.90594	0.11321	418	55	47	445	54	46	-0.00170	-0.07591
10	62106007	Concussion with no loss of consciousness	13	370247008	Facial laceration	1095	206	109	28	178	81	808	1.36546	0.05849	1.56915	2.48391	0.99127	0.0694807809	0.5190657827	20.50594	0.43132	96	55	15	110	54	13	-0.09930	-0.24575
6	39848009	Whiplash injury to neck	13	370247008	Facial laceration	1095	182	109	28	154	81	832	1.54552	0.08098	1.86756	2.96665	1.17567	0.0099030586	0.1538567234	18.11689	0.60120	92	55	16	90	54	12	-0.21466	-0.23052
130	314994000	Metastasis from malignant tumor of prostate (disorder)	52	124171000119105	Chronic intractable migraine without aura	1095	1	51	1	0	50	1044	21.47059	0.13679	0.00000	0.00000	0.00000	0.0465753425	0.4136336033	0.04658	0.93432	0	21	0	1	30	1	-3.43399	-0.69315
114	449868002	Smokes tobacco daily	61	198992004	Antepartum eclampsia	1095	9	96	0	9	96	990	0.00000	-0.02822	0.00000	0.00000	0.00000	1.0000000000	1.0000000000	0.78904	-0.83919	2	96	0	7	0	0	0.00000	0.00000
115	36923009	Major depression  single episode	61	198992004	Antepartum eclampsia	1095	6	96	0	6	96	993	0.00000	-0.02301	0.00000	0.00000	0.00000	1.0000000000	1.0000000000	0.52603	-0.60978	3	96	0	3	0	0	0.00000	0.00000
116	370143000	Major depression disorder	61	198992004	Antepartum eclampsia	1095	8	96	0	8	96	991	0.00000	-0.02659	0.00000	0.00000	0.00000	1.0000000000	1.0000000000	0.70137	-0.76670	3	96	0	5	0	0	0.00000	0.00000
117	230265002	Familial Alzheimer's disease of early onset (disorder)	61	198992004	Antepartum eclampsia	1095	6	96	2	4	94	995	3.80208	0.06448	5.29255	29.27711	0.95676	0.0904056179	0.5966770779	0.52603	0.97518	2	96	2	4	0	0	3.89182	0.69315
118	48333001	Burn injury(morphologic abnormality)	61	198992004	Antepartum eclampsia	1095	1	96	0	1	96	998	0.00000	-0.00937	0.00000	0.00000	0.00000	1.0000000000	1.0000000000	0.08767	-0.12124	0	96	0	1	0	0	0.00000	0.00000
114	449868002	Smokes tobacco daily	87	109838007	Overlapping malignant neoplasm of colon	1095	9	8	0	9	8	1078	0.00000	-0.00781	0.00000	0.00000	0.00000	1.0000000000	1.0000000000	0.06575	-0.09187	2	5	0	7	3	0	0.00000	0.00000
116	370143000	Major depression disorder	87	109838007	Overlapping malignant neoplasm of colon	1095	8	8	0	8	8	1079	0.00000	-0.00736	0.00000	0.00000	0.00000	1.0000000000	1.0000000000	0.05845	-0.08195	3	5	0	5	3	0	0.00000	0.00000
117	230265002	Familial Alzheimer's disease of early onset (disorder)	87	109838007	Overlapping malignant neoplasm of colon	1095	6	8	0	6	8	1081	0.00000	-0.00637	0.00000	0.00000	0.00000	1.0000000000	1.0000000000	0.04384	-0.06189	2	5	0	4	3	0	0.00000	0.00000
118	48333001	Burn injury(morphologic abnormality)	87	109838007	Overlapping malignant neoplasm of colon	1095	1	8	0	1	8	1086	0.00000	-0.00259	0.00000	0.00000	0.00000	1.0000000000	1.0000000000	0.00731	-0.01050	0	5	0	1	3	0	0.00000	0.00000
119	275272006	Brain damage - traumatic	87	109838007	Overlapping malignant neoplasm of colon	1095	4	8	0	4	8	1083	0.00000	-0.00519	0.00000	0.00000	0.00000	1.0000000000	1.0000000000	0.02922	-0.04156	0	5	0	4	3	0	0.00000	0.00000
120	162573006	Suspected lung cancer (situation)	87	109838007	Overlapping malignant neoplasm of colon	1095	8	8	0	8	8	1079	0.00000	-0.00736	0.00000	0.00000	0.00000	1.0000000000	1.0000000000	0.05845	-0.08195	0	5	0	8	3	0	0.00000	0.00000
121	254637007	Non-small cell lung cancer (disorder)	87	109838007	Overlapping malignant neoplasm of colon	1095	8	8	0	8	8	1079	0.00000	-0.00736	0.00000	0.00000	0.00000	1.0000000000	1.0000000000	0.05845	-0.08195	0	5	0	8	3	0	0.00000	0.00000
123	195967001	Asthma	87	109838007	Overlapping malignant neoplasm of colon	1095	2	8	0	2	8	1085	0.00000	-0.00367	0.00000	0.00000	0.00000	1.0000000000	1.0000000000	0.01461	-0.02093	1	5	0	1	3	0	0.00000	0.00000
126	698754002	Chronic paralysis due to lesion of spinal cord	87	109838007	Overlapping malignant neoplasm of colon	1095	2	8	0	2	8	1085	0.00000	-0.00367	0.00000	0.00000	0.00000	1.0000000000	1.0000000000	0.01461	-0.02093	2	5	0	0	3	0	0.00000	0.00000
127	431856006	Chronic kidney disease stage 2 (disorder)	87	109838007	Overlapping malignant neoplasm of colon	1095	5	8	0	5	8	1082	0.00000	-0.00581	0.00000	0.00000	0.00000	1.0000000000	1.0000000000	0.03653	-0.05176	3	5	0	2	3	0	0.00000	0.00000
128	86849004	Suicidal deliberate poisoning	87	109838007	Overlapping malignant neoplasm of colon	1095	1	8	0	1	8	1086	0.00000	-0.00259	0.00000	0.00000	0.00000	1.0000000000	1.0000000000	0.00731	-0.01050	0	5	0	1	3	0	0.00000	0.00000
130	314994000	Metastasis from malignant tumor of prostate (disorder)	87	109838007	Overlapping malignant neoplasm of colon	1095	1	8	0	1	8	1086	0.00000	-0.00259	0.00000	0.00000	0.00000	1.0000000000	1.0000000000	0.00731	-0.01050	0	5	0	1	3	0	0.00000	0.00000
131	93761005	Primary malignant neoplasm of colon	87	109838007	Overlapping malignant neoplasm of colon	1095	5	8	0	5	8	1082	0.00000	-0.00581	0.00000	0.00000	0.00000	1.0000000000	1.0000000000	0.03653	-0.05176	3	5	0	2	3	0	0.00000	0.00000
132	69896004	Rheumatoid arthritis	87	109838007	Overlapping malignant neoplasm of colon	1095	3	8	1	2	7	1085	45.62500	0.20066	77.50000	956.37450	6.28023	0.0217778229	0.2655079578	0.02192	0.96872	2	5	1	1	3	0	1.79176	1.09861
131	93761005	Primary malignant neoplasm of colon	126	698754002	Chronic paralysis due to lesion of spinal cord	1095	5	2	0	5	2	1088	0.00000	-0.00290	0.00000	0.00000	0.00000	1.0000000000	1.0000000000	0.00913	-0.01312	3	2	0	2	0	0	0.00000	0.00000
130	314994000	Metastasis from malignant tumor of prostate (disorder)	126	698754002	Chronic paralysis due to lesion of spinal cord	1095	1	2	0	1	2	1092	0.00000	-0.00129	0.00000	0.00000	0.00000	1.0000000000	1.0000000000	0.00183	-0.00263	0	2	0	1	0	0	0.00000	0.00000
129	47505003	Posttraumatic stress disorder	126	698754002	Chronic paralysis due to lesion of spinal cord	1095	4	2	0	4	2	1089	0.00000	-0.00259	0.00000	0.00000	0.00000	1.0000000000	1.0000000000	0.00731	-0.01050	1	2	0	3	0	0	0.00000	0.00000
128	86849004	Suicidal deliberate poisoning	126	698754002	Chronic paralysis due to lesion of spinal cord	1095	1	2	0	1	2	1092	0.00000	-0.00129	0.00000	0.00000	0.00000	1.0000000000	1.0000000000	0.00183	-0.00263	0	2	0	1	0	0	0.00000	0.00000
127	431856006	Chronic kidney disease stage 2 (disorder)	126	698754002	Chronic paralysis due to lesion of spinal cord	1095	5	2	0	5	2	1088	0.00000	-0.00290	0.00000	0.00000	0.00000	1.0000000000	1.0000000000	0.00913	-0.01312	3	2	0	2	0	0	0.00000	0.00000
125	1734006	Fracture of the vertebral column with spinal cord injury	126	698754002	Chronic paralysis due to lesion of spinal cord	1095	5	2	2	3	0	1090	219.00000	0.63159	0.00000	0.00000	0.00000	0.0000166955	0.0006661491	0.00913	1.57185	3	2	2	2	0	0	0.69315	0.91629
124	1501000119109	Proliferative diabetic retinopathy due to type II diabetes mellitus (disorder)	126	698754002	Chronic paralysis due to lesion of spinal cord	1095	1	2	0	1	2	1092	0.00000	-0.00129	0.00000	0.00000	0.00000	1.0000000000	1.0000000000	0.00183	-0.00263	1	2	0	0	0	0	0.00000	0.00000
123	195967001	Asthma	126	698754002	Chronic paralysis due to lesion of spinal cord	1095	2	2	0	2	2	1091	0.00000	-0.00183	0.00000	0.00000	0.00000	1.0000000000	1.0000000000	0.00365	-0.00526	1	2	0	1	0	0	0.00000	0.00000
121	254637007	Non-small cell lung cancer (disorder)	126	698754002	Chronic paralysis due to lesion of spinal cord	1095	8	2	0	8	2	1085	0.00000	-0.00367	0.00000	0.00000	0.00000	1.0000000000	1.0000000000	0.01461	-0.02093	0	2	0	8	0	0	0.00000	0.00000
120	162573006	Suspected lung cancer (situation)	126	698754002	Chronic paralysis due to lesion of spinal cord	1095	8	2	0	8	2	1085	0.00000	-0.00367	0.00000	0.00000	0.00000	1.0000000000	1.0000000000	0.01461	-0.02093	0	2	0	8	0	0	0.00000	0.00000
118	48333001	Burn injury(morphologic abnormality)	126	698754002	Chronic paralysis due to lesion of spinal cord	1095	1	2	0	1	2	1092	0.00000	-0.00129	0.00000	0.00000	0.00000	1.0000000000	1.0000000000	0.00183	-0.00263	0	2	0	1	0	0	0.00000	0.00000
117	230265002	Familial Alzheimer's disease of early onset (disorder)	126	698754002	Chronic paralysis due to lesion of spinal cord	1095	6	2	0	6	2	1087	0.00000	-0.00318	0.00000	0.00000	0.00000	1.0000000000	1.0000000000	0.01096	-0.01572	2	2	0	4	0	0	0.00000	0.00000
115	36923009	Major depression  single episode	126	698754002	Chronic paralysis due to lesion of spinal cord	1095	6	2	0	6	2	1087	0.00000	-0.00318	0.00000	0.00000	0.00000	1.0000000000	1.0000000000	0.01096	-0.01572	3	2	0	3	0	0	0.00000	0.00000
114	449868002	Smokes tobacco daily	126	698754002	Chronic paralysis due to lesion of spinal cord	1095	9	2	0	9	2	1084	0.00000	-0.00389	0.00000	0.00000	0.00000	1.0000000000	1.0000000000	0.01644	-0.02352	2	2	0	7	0	0	0.00000	0.00000
112	49436004	Atrial Fibrillation	126	698754002	Chronic paralysis due to lesion of spinal cord	1095	35	2	0	35	2	1058	0.00000	-0.00777	0.00000	0.00000	0.00000	1.0000000000	1.0000000000	0.06393	-0.08940	9	2	0	26	0	0	0.00000	0.00000
111	235919008	Cholelithiasis	126	698754002	Chronic paralysis due to lesion of spinal cord	1095	9	2	0	9	2	1084	0.00000	-0.00389	0.00000	0.00000	0.00000	1.0000000000	1.0000000000	0.01644	-0.02352	7	2	0	2	0	0	0.00000	0.00000
110	65275009	Acute Cholecystitis	126	698754002	Chronic paralysis due to lesion of spinal cord	1095	9	2	0	9	2	1084	0.00000	-0.00389	0.00000	0.00000	0.00000	1.0000000000	1.0000000000	0.01644	-0.02352	7	2	0	2	0	0	0.00000	0.00000
109	90560007	Gout	126	698754002	Chronic paralysis due to lesion of spinal cord	1095	4	2	0	4	2	1089	0.00000	-0.00259	0.00000	0.00000	0.00000	1.0000000000	1.0000000000	0.00731	-0.01050	0	2	0	4	0	0	0.00000	0.00000
108	40930008	Hypothyroidism (disorder)	126	698754002	Chronic paralysis due to lesion of spinal cord	1095	13	2	0	13	2	1080	0.00000	-0.00469	0.00000	0.00000	0.00000	1.0000000000	1.0000000000	0.02374	-0.03386	11	2	0	2	0	0	0.00000	0.00000
107	40275004	Contact dermatitis	126	698754002	Chronic paralysis due to lesion of spinal cord	1095	18	2	0	18	2	1075	0.00000	-0.00553	0.00000	0.00000	0.00000	1.0000000000	1.0000000000	0.03288	-0.04667	9	2	0	9	0	0	0.00000	0.00000
106	24079001	Atopic dermatitis	126	698754002	Chronic paralysis due to lesion of spinal cord	1095	20	2	0	20	2	1073	0.00000	-0.00583	0.00000	0.00000	0.00000	1.0000000000	1.0000000000	0.03653	-0.05176	13	2	0	7	0	0	0.00000	0.00000
105	363406005	Malignant tumor of colon	126	698754002	Chronic paralysis due to lesion of spinal cord	1095	6	2	0	6	2	1087	0.00000	-0.00318	0.00000	0.00000	0.00000	1.0000000000	1.0000000000	0.01096	-0.01572	4	2	0	2	0	0	0.00000	0.00000
104	367498001	Seasonal allergic rhinitis	126	698754002	Chronic paralysis due to lesion of spinal cord	1095	20	2	0	20	2	1073	0.00000	-0.00583	0.00000	0.00000	0.00000	1.0000000000	1.0000000000	0.03653	-0.05176	9	2	0	11	0	0	0.00000	0.00000
102	90781000119102	Microalbuminuria due to type 2 diabetes mellitus (disorder)	126	698754002	Chronic paralysis due to lesion of spinal cord	1095	6	2	0	6	2	1087	0.00000	-0.00318	0.00000	0.00000	0.00000	1.0000000000	1.0000000000	0.01096	-0.01572	3	2	0	3	0	0	0.00000	0.00000
101	433144002	Chronic kidney disease stage 3 (disorder)	126	698754002	Chronic paralysis due to lesion of spinal cord	1095	3	2	0	3	2	1090	0.00000	-0.00224	0.00000	0.00000	0.00000	1.0000000000	1.0000000000	0.00548	-0.00788	1	2	0	2	0	0	0.00000	0.00000
100	161622006	History of lower limb amputation (situation)	126	698754002	Chronic paralysis due to lesion of spinal cord	1095	1	2	0	1	2	1092	0.00000	-0.00129	0.00000	0.00000	0.00000	1.0000000000	1.0000000000	0.00183	-0.00263	0	2	0	1	0	0	0.00000	0.00000
99	30832001	Rupture of patellar tendon	126	698754002	Chronic paralysis due to lesion of spinal cord	1095	23	2	0	23	2	1070	0.00000	-0.00627	0.00000	0.00000	0.00000	1.0000000000	1.0000000000	0.04201	-0.05937	14	2	0	9	0	0	0.00000	0.00000
98	1551000119108	Nonproliferative diabetic retinopathy due to type 2 diabetes mellitus (disorder)	126	698754002	Chronic paralysis due to lesion of spinal cord	1095	12	2	0	12	2	1081	0.00000	-0.00450	0.00000	0.00000	0.00000	1.0000000000	1.0000000000	0.02192	-0.03128	7	2	0	5	0	0	0.00000	0.00000
97	403192003	Third degree burn	126	698754002	Chronic paralysis due to lesion of spinal cord	1095	8	2	0	8	2	1085	0.00000	-0.00367	0.00000	0.00000	0.00000	1.0000000000	1.0000000000	0.01461	-0.02093	3	2	0	5	0	0	0.00000	0.00000
96	283371005	Laceration of forearm	126	698754002	Chronic paralysis due to lesion of spinal cord	1095	75	2	0	75	2	1018	0.00000	-0.01160	0.00000	0.00000	0.00000	1.0000000000	1.0000000000	0.13699	-0.18521	39	2	0	36	0	0	0.00000	0.00000
95	84757009	Epilepsy	126	698754002	Chronic paralysis due to lesion of spinal cord	1095	30	2	0	30	2	1063	0.00000	-0.00718	0.00000	0.00000	0.00000	1.0000000000	1.0000000000	0.05479	-0.07696	13	2	0	17	0	0	0.00000	0.00000
94	703151001	History of single seizure (situation)	126	698754002	Chronic paralysis due to lesion of spinal cord	1095	39	2	0	39	2	1054	0.00000	-0.00822	0.00000	0.00000	0.00000	1.0000000000	1.0000000000	0.07123	-0.09927	14	2	0	25	0	0	0.00000	0.00000
93	128613002	Seizure disorder	126	698754002	Chronic paralysis due to lesion of spinal cord	1095	39	2	0	39	2	1054	0.00000	-0.00822	0.00000	0.00000	0.00000	1.0000000000	1.0000000000	0.07123	-0.09927	14	2	0	25	0	0	0.00000	0.00000
89	47693006	Rupture of appendix	126	698754002	Chronic paralysis due to lesion of spinal cord	1095	20	2	0	20	2	1073	0.00000	-0.00583	0.00000	0.00000	0.00000	1.0000000000	1.0000000000	0.03653	-0.05176	10	2	0	10	0	0	0.00000	0.00000
86	713197008	Recurrent rectal polyp	126	698754002	Chronic paralysis due to lesion of spinal cord	1095	22	2	0	22	2	1071	0.00000	-0.00613	0.00000	0.00000	0.00000	1.0000000000	1.0000000000	0.04018	-0.05684	12	2	0	10	0	0	0.00000	0.00000
85	241929008	Acute allergic reaction	126	698754002	Chronic paralysis due to lesion of spinal cord	1095	47	2	0	47	2	1046	0.00000	-0.00906	0.00000	0.00000	0.00000	1.0000000000	1.0000000000	0.08584	-0.11882	25	2	0	22	0	0	0.00000	0.00000
82	94260004	Secondary malignant neoplasm of colon	126	698754002	Chronic paralysis due to lesion of spinal cord	1095	4	2	0	4	2	1089	0.00000	-0.00259	0.00000	0.00000	0.00000	1.0000000000	1.0000000000	0.00731	-0.01050	2	2	0	2	0	0	0.00000	0.00000
81	236077008	Protracted diarrhea	126	698754002	Chronic paralysis due to lesion of spinal cord	1095	4	2	0	4	2	1089	0.00000	-0.00259	0.00000	0.00000	0.00000	1.0000000000	1.0000000000	0.00731	-0.01050	2	2	0	2	0	0	0.00000	0.00000
80	6072007	Bleeding from anus	126	698754002	Chronic paralysis due to lesion of spinal cord	1095	4	2	0	4	2	1089	0.00000	-0.00259	0.00000	0.00000	0.00000	1.0000000000	1.0000000000	0.00731	-0.01050	2	2	0	2	0	0	0.00000	0.00000
79	45816000	Pyelonephritis	126	698754002	Chronic paralysis due to lesion of spinal cord	1095	1	2	0	1	2	1092	0.00000	-0.00129	0.00000	0.00000	0.00000	1.0000000000	1.0000000000	0.00183	-0.00263	1	2	0	0	0	0	0.00000	0.00000
78	239872002	Osteoarthritis of hip	126	698754002	Chronic paralysis due to lesion of spinal cord	1095	21	2	0	21	2	1072	0.00000	-0.00598	0.00000	0.00000	0.00000	1.0000000000	1.0000000000	0.03836	-0.05430	13	2	0	8	0	0	0.00000	0.00000
76	127013003	Diabetic renal disease (disorder)	126	698754002	Chronic paralysis due to lesion of spinal cord	1095	28	2	0	28	2	1065	0.00000	-0.00693	0.00000	0.00000	0.00000	1.0000000000	1.0000000000	0.05114	-0.07196	10	2	0	18	0	0	0.00000	0.00000
75	431855005	Chronic kidney disease stage 1 (disorder)	126	698754002	Chronic paralysis due to lesion of spinal cord	1095	28	2	0	28	2	1065	0.00000	-0.00693	0.00000	0.00000	0.00000	1.0000000000	1.0000000000	0.05114	-0.07196	10	2	0	18	0	0	0.00000	0.00000
73	196416002	Impacted molars	126	698754002	Chronic paralysis due to lesion of spinal cord	1095	49	2	0	49	2	1044	0.00000	-0.00926	0.00000	0.00000	0.00000	1.0000000000	1.0000000000	0.08950	-0.12366	25	2	0	24	0	0	0.00000	0.00000
72	35999006	Blighted ovum	126	698754002	Chronic paralysis due to lesion of spinal cord	1095	53	2	0	53	2	1040	0.00000	-0.00965	0.00000	0.00000	0.00000	1.0000000000	1.0000000000	0.09680	-0.13331	53	2	0	0	0	0	0.00000	0.00000
71	201834006	Localized  primary osteoarthritis of the hand	126	698754002	Chronic paralysis due to lesion of spinal cord	1095	28	2	0	28	2	1065	0.00000	-0.00693	0.00000	0.00000	0.00000	1.0000000000	1.0000000000	0.05114	-0.07196	19	2	0	9	0	0	0.00000	0.00000
70	87433001	Pulmonary emphysema (disorder)	126	698754002	Chronic paralysis due to lesion of spinal cord	1095	17	2	0	17	2	1076	0.00000	-0.00537	0.00000	0.00000	0.00000	1.0000000000	1.0000000000	0.03105	-0.04411	9	2	0	8	0	0	0.00000	0.00000
69	233604007	Pneumonia	126	698754002	Chronic paralysis due to lesion of spinal cord	1095	7	2	0	7	2	1086	0.00000	-0.00343	0.00000	0.00000	0.00000	1.0000000000	1.0000000000	0.01279	-0.01833	3	2	0	4	0	0	0.00000	0.00000
68	26929004	Alzheimer's disease (disorder)	126	698754002	Chronic paralysis due to lesion of spinal cord	1095	23	2	0	23	2	1070	0.00000	-0.00627	0.00000	0.00000	0.00000	1.0000000000	1.0000000000	0.04201	-0.05937	15	2	0	8	0	0	0.00000	0.00000
67	403191005	Second degree burn	126	698754002	Chronic paralysis due to lesion of spinal cord	1095	49	2	0	49	2	1044	0.00000	-0.00926	0.00000	0.00000	0.00000	1.0000000000	1.0000000000	0.08950	-0.12366	23	2	0	26	0	0	0.00000	0.00000
65	239873007	Osteoarthritis of knee	126	698754002	Chronic paralysis due to lesion of spinal cord	1095	57	2	0	57	2	1036	0.00000	-0.01002	0.00000	0.00000	0.00000	1.0000000000	1.0000000000	0.10411	-0.14288	30	2	0	27	0	0	0.00000	0.00000
64	444448004	Injury of medial collateral ligament of knee	126	698754002	Chronic paralysis due to lesion of spinal cord	1095	32	2	0	32	2	1061	0.00000	-0.00742	0.00000	0.00000	0.00000	1.0000000000	1.0000000000	0.05845	-0.08195	17	2	0	15	0	0	0.00000	0.00000
63	68496003	Polyp of colon	126	698754002	Chronic paralysis due to lesion of spinal cord	1095	91	2	0	91	2	1002	0.00000	-0.01288	0.00000	0.00000	0.00000	1.0000000000	1.0000000000	0.16621	-0.22183	43	2	0	48	0	0	0.00000	0.00000
62	185086009	Chronic obstructive bronchitis (disorder)	126	698754002	Chronic paralysis due to lesion of spinal cord	1095	6	2	0	6	2	1087	0.00000	-0.00318	0.00000	0.00000	0.00000	1.0000000000	1.0000000000	0.01096	-0.01572	4	2	0	2	0	0	0.00000	0.00000
59	262574004	Bullet wound	126	698754002	Chronic paralysis due to lesion of spinal cord	1095	20	2	0	20	2	1073	0.00000	-0.00583	0.00000	0.00000	0.00000	1.0000000000	1.0000000000	0.03653	-0.05176	9	2	0	11	0	0	0.00000	0.00000
58	239720000	Tear of meniscus of knee	126	698754002	Chronic paralysis due to lesion of spinal cord	1095	20	2	0	20	2	1073	0.00000	-0.00583	0.00000	0.00000	0.00000	1.0000000000	1.0000000000	0.03653	-0.05176	10	2	0	10	0	0	0.00000	0.00000
57	192127007	Child attention deficit disorder	126	698754002	Chronic paralysis due to lesion of spinal cord	1095	76	2	0	76	2	1017	0.00000	-0.01168	0.00000	0.00000	0.00000	1.0000000000	1.0000000000	0.13881	-0.18753	24	2	0	52	0	0	0.00000	0.00000
56	92691004	Carcinoma in situ of prostate (disorder)	126	698754002	Chronic paralysis due to lesion of spinal cord	1095	23	2	0	23	2	1070	0.00000	-0.00627	0.00000	0.00000	0.00000	1.0000000000	1.0000000000	0.04201	-0.05937	0	2	0	23	0	0	0.00000	0.00000
54	5602001	Opioid abuse (disorder)	126	698754002	Chronic paralysis due to lesion of spinal cord	1095	7	2	0	7	2	1086	0.00000	-0.00343	0.00000	0.00000	0.00000	1.0000000000	1.0000000000	0.01279	-0.01833	0	2	0	7	0	0	0.00000	0.00000
53	7200002	Alcoholism	126	698754002	Chronic paralysis due to lesion of spinal cord	1095	5	2	0	5	2	1088	0.00000	-0.00290	0.00000	0.00000	0.00000	1.0000000000	1.0000000000	0.00913	-0.01312	0	2	0	5	0	0	0.00000	0.00000
52	124171000119105	Chronic intractable migraine without aura	126	698754002	Chronic paralysis due to lesion of spinal cord	1095	51	2	0	51	2	1042	0.00000	-0.00945	0.00000	0.00000	0.00000	1.0000000000	1.0000000000	0.09315	-0.12849	21	2	0	30	0	0	0.00000	0.00000
50	446096008	Perennial allergic rhinitis	126	698754002	Chronic paralysis due to lesion of spinal cord	1095	26	2	0	26	2	1067	0.00000	-0.00667	0.00000	0.00000	0.00000	1.0000000000	1.0000000000	0.04749	-0.06693	14	2	0	12	0	0	0.00000	0.00000
49	88805009	Chronic congestive heart failure (disorder)	126	698754002	Chronic paralysis due to lesion of spinal cord	1095	10	2	0	10	2	1083	0.00000	-0.00411	0.00000	0.00000	0.00000	1.0000000000	1.0000000000	0.01826	-0.02611	5	2	0	5	0	0	0.00000	0.00000
47	359817006	Closed fracture of hip	126	698754002	Chronic paralysis due to lesion of spinal cord	1095	29	2	1	28	1	1065	18.87931	0.12615	38.03571	623.66928	2.31968	0.0522902006	0.4421997889	0.05297	0.92554	11	2	1	18	0	0	1.09861	2.48491
46	62564004	Concussion with loss of consciousness	126	698754002	Chronic paralysis due to lesion of spinal cord	1095	67	2	0	67	2	1026	0.00000	-0.01092	0.00000	0.00000	0.00000	1.0000000000	1.0000000000	0.12237	-0.16655	36	2	0	31	0	0	0.00000	0.00000
45	263102004	Fracture subluxation of wrist	126	698754002	Chronic paralysis due to lesion of spinal cord	1095	109	2	0	109	2	984	0.00000	-0.01422	0.00000	0.00000	0.00000	1.0000000000	1.0000000000	0.19909	-0.26194	51	2	0	58	0	0	0.00000	0.00000
44	58150001	Fracture of clavicle	126	698754002	Chronic paralysis due to lesion of spinal cord	1095	112	2	1	111	1	982	4.88839	0.05614	8.84685	142.42448	0.54953	0.1941883082	0.8327234827	0.20457	0.73149	55	2	1	57	0	0	1.09861	4.02535
43	307731004	Injury of tendon of the rotator cuff of shoulder	126	698754002	Chronic paralysis due to lesion of spinal cord	1095	51	2	0	51	2	1042	0.00000	-0.00945	0.00000	0.00000	0.00000	1.0000000000	1.0000000000	0.09315	-0.12849	26	2	0	25	0	0	0.00000	0.00000
42	16114001	Fracture of ankle	126	698754002	Chronic paralysis due to lesion of spinal cord	1095	108	2	0	108	2	985	0.00000	-0.01415	0.00000	0.00000	0.00000	1.0000000000	1.0000000000	0.19726	-0.25974	48	2	0	60	0	0	0.00000	0.00000
41	283385000	Laceration of thigh	126	698754002	Chronic paralysis due to lesion of spinal cord	1095	105	2	0	105	2	988	0.00000	-0.01393	0.00000	0.00000	0.00000	1.0000000000	1.0000000000	0.19178	-0.25312	50	2	0	55	0	0	0.00000	0.00000
40	428251008	History of appendectomy	126	698754002	Chronic paralysis due to lesion of spinal cord	1095	51	2	0	51	2	1042	0.00000	-0.00945	0.00000	0.00000	0.00000	1.0000000000	1.0000000000	0.09315	-0.12849	27	2	0	24	0	0	0.00000	0.00000
39	74400008	Appendicitis	126	698754002	Chronic paralysis due to lesion of spinal cord	1095	51	2	0	51	2	1042	0.00000	-0.00945	0.00000	0.00000	0.00000	1.0000000000	1.0000000000	0.09315	-0.12849	27	2	0	24	0	0	0.00000	0.00000
38	398254007	Preeclampsia	126	698754002	Chronic paralysis due to lesion of spinal cord	1095	101	2	0	101	2	992	0.00000	-0.01364	0.00000	0.00000	0.00000	1.0000000000	1.0000000000	0.18447	-0.24425	101	2	0	0	0	0	0.00000	0.00000
35	19169002	Miscarriage in first trimester	126	698754002	Chronic paralysis due to lesion of spinal cord	1095	174	2	1	173	1	920	3.14655	0.03991	5.31792	85.42576	0.33105	0.2926798728	0.9786512274	0.31781	0.60186	174	2	1	0	0	0	1.09861	5.16479
33	429007001	History of cardiac arrest (situation)	126	698754002	Chronic paralysis due to lesion of spinal cord	1095	42	2	0	42	2	1051	0.00000	-0.00854	0.00000	0.00000	0.00000	1.0000000000	1.0000000000	0.07671	-0.10663	24	2	0	18	0	0	0.00000	0.00000
32	410429000	Cardiac Arrest	126	698754002	Chronic paralysis due to lesion of spinal cord	1095	42	2	0	42	2	1051	0.00000	-0.00854	0.00000	0.00000	0.00000	1.0000000000	1.0000000000	0.07671	-0.10663	24	2	0	18	0	0	0.00000	0.00000
30	399211009	History of myocardial infarction (situation)	126	698754002	Chronic paralysis due to lesion of spinal cord	1095	31	2	0	31	2	1062	0.00000	-0.00730	0.00000	0.00000	0.00000	1.0000000000	1.0000000000	0.05662	-0.07946	2	2	0	29	0	0	0.00000	0.00000
29	22298006	Myocardial Infarction	126	698754002	Chronic paralysis due to lesion of spinal cord	1095	31	2	0	31	2	1062	0.00000	-0.00730	0.00000	0.00000	0.00000	1.0000000000	1.0000000000	0.05662	-0.07946	2	2	0	29	0	0	0.00000	0.00000
28	53741008	Coronary Heart Disease	126	698754002	Chronic paralysis due to lesion of spinal cord	1095	80	2	0	80	2	1013	0.00000	-0.01201	0.00000	0.00000	0.00000	1.0000000000	1.0000000000	0.14612	-0.19676	24	2	0	56	0	0	0.00000	0.00000
27	408512008	Body mass index 40+ - severely obese (finding)	126	698754002	Chronic paralysis due to lesion of spinal cord	1095	97	2	0	97	2	996	0.00000	-0.01334	0.00000	0.00000	0.00000	1.0000000000	1.0000000000	0.17717	-0.23532	67	2	0	30	0	0	0.00000	0.00000
26	33737001	Fracture of rib	126	698754002	Chronic paralysis due to lesion of spinal cord	1095	54	2	1	53	1	1040	10.13889	0.08904	19.62264	318.04792	1.21066	0.0962410158	0.6167705670	0.09863	0.86429	32	2	1	22	0	0	1.09861	3.49651
24	162864005	Body mass index 30+ - obesity (finding)	126	698754002	Chronic paralysis due to lesion of spinal cord	1095	439	2	0	439	2	654	0.00000	-0.03499	0.00000	0.00000	0.00000	0.5191972820	1.0000000000	0.80183	-0.84946	226	2	0	213	0	0	0.00000	0.00000
23	36971009	Sinusitis (disorder)	126	698754002	Chronic paralysis due to lesion of spinal cord	1095	190	2	0	190	2	903	0.00000	-0.01960	0.00000	0.00000	0.00000	1.0000000000	1.0000000000	0.34703	-0.42978	84	2	0	106	0	0	0.00000	0.00000
21	15777000	Prediabetes	126	698754002	Chronic paralysis due to lesion of spinal cord	1095	333	2	1	332	1	761	1.64414	0.01822	2.29217	36.75615	0.14294	0.5159299792	1.0000000000	0.60822	0.31454	159	2	1	174	0	0	1.09861	5.07517
20	80394007	Hyperglycemia (disorder)	126	698754002	Chronic paralysis due to lesion of spinal cord	1095	55	2	0	55	2	1038	0.00000	-0.00984	0.00000	0.00000	0.00000	1.0000000000	1.0000000000	0.10046	-0.13810	23	2	0	32	0	0	0.00000	0.00000
19	237602007	Metabolic syndrome X (disorder)	126	698754002	Chronic paralysis due to lesion of spinal cord	1095	64	2	0	64	2	1029	0.00000	-0.01066	0.00000	0.00000	0.00000	1.0000000000	1.0000000000	0.11689	-0.15949	28	2	0	36	0	0	0.00000	0.00000
18	302870006	Hypertriglyceridemia (disorder)	126	698754002	Chronic paralysis due to lesion of spinal cord	1095	64	2	0	64	2	1029	0.00000	-0.01066	0.00000	0.00000	0.00000	1.0000000000	1.0000000000	0.11689	-0.15949	28	2	0	36	0	0	0.00000	0.00000
17	368581000119106	Neuropathy due to type 2 diabetes mellitus (disorder)	126	698754002	Chronic paralysis due to lesion of spinal cord	1095	28	2	0	28	2	1065	0.00000	-0.00693	0.00000	0.00000	0.00000	1.0000000000	1.0000000000	0.05114	-0.07196	7	2	0	21	0	0	0.00000	0.00000
129	47505003	Posttraumatic stress disorder	100	161622006	History of lower limb amputation (situation)	1095	4	1	0	4	1	1090	0.00000	-0.00183	0.00000	0.00000	0.00000	1.0000000000	1.0000000000	0.00365	-0.00526	1	0	0	3	1	0	0.00000	0.00000
15	40055000	Chronic sinusitis (disorder)	126	698754002	Chronic paralysis due to lesion of spinal cord	1095	216	2	0	216	2	877	0.00000	-0.02120	0.00000	0.00000	0.00000	1.0000000000	1.0000000000	0.39452	-0.47977	104	2	0	112	0	0	0.00000	0.00000
14	10509002	Acute bronchitis (disorder)	126	698754002	Chronic paralysis due to lesion of spinal cord	1095	863	2	1	862	1	231	0.63441	-0.03016	0.26798	4.30069	0.01670	0.3790071206	1.0000000000	1.57626	-0.36528	418	2	1	445	0	0	1.09861	6.03787
13	370247008	Facial laceration	126	698754002	Chronic paralysis due to lesion of spinal cord	1095	109	2	0	109	2	984	0.00000	-0.01422	0.00000	0.00000	0.00000	1.0000000000	1.0000000000	0.19909	-0.26194	55	2	0	54	0	0	0.00000	0.00000
125	1734006	Fracture of the vertebral column with spinal cord injury	100	161622006	History of lower limb amputation (situation)	1095	5	1	0	5	1	1089	0.00000	-0.00205	0.00000	0.00000	0.00000	1.0000000000	1.0000000000	0.00457	-0.00657	3	0	0	2	1	0	0.00000	0.00000
124	1501000119109	Proliferative diabetic retinopathy due to type II diabetes mellitus (disorder)	100	161622006	History of lower limb amputation (situation)	1095	1	1	0	1	1	1093	0.00000	-0.00091	0.00000	0.00000	0.00000	1.0000000000	1.0000000000	0.00091	-0.00132	1	0	0	0	1	0	0.00000	0.00000
10	62106007	Concussion with no loss of consciousness	126	698754002	Chronic paralysis due to lesion of spinal cord	1095	206	2	1	205	1	888	2.65777	0.03414	4.33171	69.54196	0.26982	0.3410032306	1.0000000000	0.37626	0.53925	96	2	1	110	0	0	1.09861	4.57471
9	44465007	Sprain of ankle	126	698754002	Chronic paralysis due to lesion of spinal cord	1095	362	2	0	362	2	731	0.00000	-0.03006	0.00000	0.00000	0.00000	1.0000000000	1.0000000000	0.66119	-0.73221	185	2	0	177	0	0	0.00000	0.00000
8	233678006	Childhood asthma	126	698754002	Chronic paralysis due to lesion of spinal cord	1095	45	2	0	45	2	1048	0.00000	-0.00886	0.00000	0.00000	0.00000	1.0000000000	1.0000000000	0.08219	-0.11396	25	2	0	20	0	0	0.00000	0.00000
7	75498004	Acute bacterial sinusitis (disorder)	126	698754002	Chronic paralysis due to lesion of spinal cord	1095	187	2	0	187	2	906	0.00000	-0.01941	0.00000	0.00000	0.00000	1.0000000000	1.0000000000	0.34155	-0.42390	89	2	0	98	0	0	0.00000	0.00000
6	39848009	Whiplash injury to neck	126	698754002	Chronic paralysis due to lesion of spinal cord	1095	182	2	0	182	2	911	0.00000	-0.01910	0.00000	0.00000	0.00000	1.0000000000	1.0000000000	0.33242	-0.41405	92	2	0	90	0	0	0.00000	0.00000
5	284549007	Laceration of hand	126	698754002	Chronic paralysis due to lesion of spinal cord	1095	104	2	0	104	2	989	0.00000	-0.01386	0.00000	0.00000	0.00000	1.0000000000	1.0000000000	0.18995	-0.25091	54	2	0	50	0	0	0.00000	0.00000
117	230265002	Familial Alzheimer's disease of early onset (disorder)	100	161622006	History of lower limb amputation (situation)	1095	6	1	0	6	1	1088	0.00000	-0.00224	0.00000	0.00000	0.00000	1.0000000000	1.0000000000	0.00548	-0.00788	2	0	0	4	1	0	0.00000	0.00000
115	36923009	Major depression  single episode	100	161622006	History of lower limb amputation (situation)	1095	6	1	0	6	1	1088	0.00000	-0.00224	0.00000	0.00000	0.00000	1.0000000000	1.0000000000	0.00548	-0.00788	3	0	0	3	1	0	0.00000	0.00000
1	444814009	Viral sinusitis (disorder)	126	698754002	Chronic paralysis due to lesion of spinal cord	1095	993	2	2	991	0	102	1.10272	0.01371	0.00000	0.00000	0.00000	1.0000000000	1.0000000000	1.81370	0.09249	478	2	2	515	0	0	0.69315	5.48064
111	235919008	Cholelithiasis	100	161622006	History of lower limb amputation (situation)	1095	9	1	0	9	1	1085	0.00000	-0.00275	0.00000	0.00000	0.00000	1.0000000000	1.0000000000	0.00822	-0.01181	7	0	0	2	1	0	0.00000	0.00000
109	90560007	Gout	100	161622006	History of lower limb amputation (situation)	1095	4	1	0	4	1	1090	0.00000	-0.00183	0.00000	0.00000	0.00000	1.0000000000	1.0000000000	0.00365	-0.00526	0	0	0	4	1	0	0.00000	0.00000
107	40275004	Contact dermatitis	100	161622006	History of lower limb amputation (situation)	1095	18	1	0	18	1	1076	0.00000	-0.00391	0.00000	0.00000	0.00000	1.0000000000	1.0000000000	0.01644	-0.02352	9	0	0	9	1	0	0.00000	0.00000
106	24079001	Atopic dermatitis	100	161622006	History of lower limb amputation (situation)	1095	20	1	0	20	1	1074	0.00000	-0.00412	0.00000	0.00000	0.00000	1.0000000000	1.0000000000	0.01826	-0.02611	13	0	0	7	1	0	0.00000	0.00000
102	90781000119102	Microalbuminuria due to type 2 diabetes mellitus (disorder)	100	161622006	History of lower limb amputation (situation)	1095	6	1	0	6	1	1088	0.00000	-0.00224	0.00000	0.00000	0.00000	1.0000000000	1.0000000000	0.00548	-0.00788	3	0	0	3	1	0	0.00000	0.00000
101	433144002	Chronic kidney disease stage 3 (disorder)	100	161622006	History of lower limb amputation (situation)	1095	3	1	0	3	1	1091	0.00000	-0.00158	0.00000	0.00000	0.00000	1.0000000000	1.0000000000	0.00274	-0.00395	1	0	0	2	1	0	0.00000	0.00000
98	1551000119108	Nonproliferative diabetic retinopathy due to type 2 diabetes mellitus (disorder)	100	161622006	History of lower limb amputation (situation)	1095	12	1	0	12	1	1082	0.00000	-0.00318	0.00000	0.00000	0.00000	1.0000000000	1.0000000000	0.01096	-0.01572	7	0	0	5	1	0	0.00000	0.00000
97	403192003	Third degree burn	100	161622006	History of lower limb amputation (situation)	1095	8	1	0	8	1	1086	0.00000	-0.00259	0.00000	0.00000	0.00000	1.0000000000	1.0000000000	0.00731	-0.01050	3	0	0	5	1	0	0.00000	0.00000
96	283371005	Laceration of forearm	100	161622006	History of lower limb amputation (situation)	1095	75	1	0	75	1	1019	0.00000	-0.00820	0.00000	0.00000	0.00000	1.0000000000	1.0000000000	0.06849	-0.09558	39	0	0	36	1	0	0.00000	0.00000
94	703151001	History of single seizure (situation)	100	161622006	History of lower limb amputation (situation)	1095	39	1	0	39	1	1055	0.00000	-0.00581	0.00000	0.00000	0.00000	1.0000000000	1.0000000000	0.03562	-0.05049	14	0	0	25	1	0	0.00000	0.00000
93	128613002	Seizure disorder	100	161622006	History of lower limb amputation (situation)	1095	39	1	0	39	1	1055	0.00000	-0.00581	0.00000	0.00000	0.00000	1.0000000000	1.0000000000	0.03562	-0.05049	14	0	0	25	1	0	0.00000	0.00000
89	47693006	Rupture of appendix	100	161622006	History of lower limb amputation (situation)	1095	20	1	0	20	1	1074	0.00000	-0.00412	0.00000	0.00000	0.00000	1.0000000000	1.0000000000	0.01826	-0.02611	10	0	0	10	1	0	0.00000	0.00000
86	713197008	Recurrent rectal polyp	100	161622006	History of lower limb amputation (situation)	1095	22	1	0	22	1	1072	0.00000	-0.00433	0.00000	0.00000	0.00000	1.0000000000	1.0000000000	0.02009	-0.02870	12	0	0	10	1	0	0.00000	0.00000
82	94260004	Secondary malignant neoplasm of colon	100	161622006	History of lower limb amputation (situation)	1095	4	1	0	4	1	1090	0.00000	-0.00183	0.00000	0.00000	0.00000	1.0000000000	1.0000000000	0.00365	-0.00526	2	0	0	2	1	0	0.00000	0.00000
78	239872002	Osteoarthritis of hip	100	161622006	History of lower limb amputation (situation)	1095	21	1	1	20	0	1074	52.14286	0.21621	0.00000	0.00000	0.00000	0.0191780822	0.2418752952	0.01918	0.97259	13	0	0	8	1	1	-0.69315	-2.19722
76	127013003	Diabetic renal disease (disorder)	100	161622006	History of lower limb amputation (situation)	1095	28	1	1	27	0	1067	39.10714	0.18664	0.00000	0.00000	0.00000	0.0255707763	0.2905941929	0.02557	0.96357	10	0	0	18	1	1	-0.69315	-2.94444
75	431855005	Chronic kidney disease stage 1 (disorder)	100	161622006	History of lower limb amputation (situation)	1095	28	1	1	27	0	1067	39.10714	0.18664	0.00000	0.00000	0.00000	0.0255707763	0.2905941929	0.02557	0.96357	10	0	0	18	1	1	-0.69315	-2.94444
72	35999006	Blighted ovum	100	161622006	History of lower limb amputation (situation)	1095	53	1	0	53	1	1041	0.00000	-0.00682	0.00000	0.00000	0.00000	1.0000000000	1.0000000000	0.04840	-0.06819	53	0	0	0	1	0	0.00000	0.00000
71	201834006	Localized  primary osteoarthritis of the hand	100	161622006	History of lower limb amputation (situation)	1095	28	1	0	28	1	1066	0.00000	-0.00490	0.00000	0.00000	0.00000	1.0000000000	1.0000000000	0.02557	-0.03643	19	0	0	9	1	0	0.00000	0.00000
70	87433001	Pulmonary emphysema (disorder)	100	161622006	History of lower limb amputation (situation)	1095	17	1	0	17	1	1077	0.00000	-0.00380	0.00000	0.00000	0.00000	1.0000000000	1.0000000000	0.01553	-0.02223	9	0	0	8	1	0	0.00000	0.00000
69	233604007	Pneumonia	100	161622006	History of lower limb amputation (situation)	1095	7	1	0	7	1	1087	0.00000	-0.00243	0.00000	0.00000	0.00000	1.0000000000	1.0000000000	0.00639	-0.00919	3	0	0	4	1	0	0.00000	0.00000
67	403191005	Second degree burn	100	161622006	History of lower limb amputation (situation)	1095	49	1	0	49	1	1045	0.00000	-0.00654	0.00000	0.00000	0.00000	1.0000000000	1.0000000000	0.04475	-0.06316	23	0	0	26	1	0	0.00000	0.00000
64	444448004	Injury of medial collateral ligament of knee	100	161622006	History of lower limb amputation (situation)	1095	32	1	0	32	1	1062	0.00000	-0.00525	0.00000	0.00000	0.00000	1.0000000000	1.0000000000	0.02922	-0.04156	17	0	0	15	1	0	0.00000	0.00000
63	68496003	Polyp of colon	100	161622006	History of lower limb amputation (situation)	1095	91	1	0	91	1	1003	0.00000	-0.00910	0.00000	0.00000	0.00000	1.0000000000	1.0000000000	0.08311	-0.11517	43	0	0	48	1	0	0.00000	0.00000
59	262574004	Bullet wound	100	161622006	History of lower limb amputation (situation)	1095	20	1	0	20	1	1074	0.00000	-0.00412	0.00000	0.00000	0.00000	1.0000000000	1.0000000000	0.01826	-0.02611	9	0	0	11	1	0	0.00000	0.00000
58	239720000	Tear of meniscus of knee	100	161622006	History of lower limb amputation (situation)	1095	20	1	0	20	1	1074	0.00000	-0.00412	0.00000	0.00000	0.00000	1.0000000000	1.0000000000	0.01826	-0.02611	10	0	0	10	1	0	0.00000	0.00000
57	192127007	Child attention deficit disorder	100	161622006	History of lower limb amputation (situation)	1095	76	1	0	76	1	1018	0.00000	-0.00826	0.00000	0.00000	0.00000	1.0000000000	1.0000000000	0.06941	-0.09681	24	0	0	52	1	0	0.00000	0.00000
56	92691004	Carcinoma in situ of prostate (disorder)	100	161622006	History of lower limb amputation (situation)	1095	23	1	0	23	1	1071	0.00000	-0.00443	0.00000	0.00000	0.00000	1.0000000000	1.0000000000	0.02100	-0.02999	0	0	0	23	1	0	0.00000	0.00000
54	5602001	Opioid abuse (disorder)	100	161622006	History of lower limb amputation (situation)	1095	7	1	0	7	1	1087	0.00000	-0.00243	0.00000	0.00000	0.00000	1.0000000000	1.0000000000	0.00639	-0.00919	0	0	0	7	1	0	0.00000	0.00000
52	124171000119105	Chronic intractable migraine without aura	100	161622006	History of lower limb amputation (situation)	1095	51	1	0	51	1	1043	0.00000	-0.00668	0.00000	0.00000	0.00000	1.0000000000	1.0000000000	0.04658	-0.06568	21	0	0	30	1	0	0.00000	0.00000
50	446096008	Perennial allergic rhinitis	100	161622006	History of lower limb amputation (situation)	1095	26	1	0	26	1	1068	0.00000	-0.00472	0.00000	0.00000	0.00000	1.0000000000	1.0000000000	0.02374	-0.03386	14	0	0	12	1	0	0.00000	0.00000
49	88805009	Chronic congestive heart failure (disorder)	100	161622006	History of lower limb amputation (situation)	1095	10	1	0	10	1	1084	0.00000	-0.00290	0.00000	0.00000	0.00000	1.0000000000	1.0000000000	0.00913	-0.01312	5	0	0	5	1	0	0.00000	0.00000
47	359817006	Closed fracture of hip	100	161622006	History of lower limb amputation (situation)	1095	29	1	0	29	1	1065	0.00000	-0.00499	0.00000	0.00000	0.00000	1.0000000000	1.0000000000	0.02648	-0.03771	11	0	0	18	1	0	0.00000	0.00000
45	263102004	Fracture subluxation of wrist	100	161622006	History of lower limb amputation (situation)	1095	109	1	0	109	1	985	0.00000	-0.01005	0.00000	0.00000	0.00000	1.0000000000	1.0000000000	0.09954	-0.13690	51	0	0	58	1	0	0.00000	0.00000
44	58150001	Fracture of clavicle	100	161622006	History of lower limb amputation (situation)	1095	112	1	0	112	1	982	0.00000	-0.01021	0.00000	0.00000	0.00000	1.0000000000	1.0000000000	0.10228	-0.14049	55	0	0	57	1	0	0.00000	0.00000
43	307731004	Injury of tendon of the rotator cuff of shoulder	100	161622006	History of lower limb amputation (situation)	1095	51	1	0	51	1	1043	0.00000	-0.00668	0.00000	0.00000	0.00000	1.0000000000	1.0000000000	0.04658	-0.06568	26	0	0	25	1	0	0.00000	0.00000
42	16114001	Fracture of ankle	100	161622006	History of lower limb amputation (situation)	1095	108	1	0	108	1	986	0.00000	-0.01000	0.00000	0.00000	0.00000	1.0000000000	1.0000000000	0.09863	-0.13571	48	0	0	60	1	0	0.00000	0.00000
41	283385000	Laceration of thigh	100	161622006	History of lower limb amputation (situation)	1095	105	1	0	105	1	989	0.00000	-0.00985	0.00000	0.00000	0.00000	1.0000000000	1.0000000000	0.09589	-0.13210	50	0	0	55	1	0	0.00000	0.00000
39	74400008	Appendicitis	100	161622006	History of lower limb amputation (situation)	1095	51	1	0	51	1	1043	0.00000	-0.00668	0.00000	0.00000	0.00000	1.0000000000	1.0000000000	0.04658	-0.06568	27	0	0	24	1	0	0.00000	0.00000
38	398254007	Preeclampsia	100	161622006	History of lower limb amputation (situation)	1095	101	1	0	101	1	993	0.00000	-0.00964	0.00000	0.00000	0.00000	1.0000000000	1.0000000000	0.09224	-0.12729	101	0	0	0	1	0	0.00000	0.00000
35	19169002	Miscarriage in first trimester	100	161622006	History of lower limb amputation (situation)	1095	174	1	0	174	1	920	0.00000	-0.01314	0.00000	0.00000	0.00000	1.0000000000	1.0000000000	0.15890	-0.21276	174	0	0	0	1	0	0.00000	0.00000
33	429007001	History of cardiac arrest (situation)	100	161622006	History of lower limb amputation (situation)	1095	42	1	0	42	1	1052	0.00000	-0.00604	0.00000	0.00000	0.00000	1.0000000000	1.0000000000	0.03836	-0.05430	24	0	0	18	1	0	0.00000	0.00000
32	410429000	Cardiac Arrest	100	161622006	History of lower limb amputation (situation)	1095	42	1	0	42	1	1052	0.00000	-0.00604	0.00000	0.00000	0.00000	1.0000000000	1.0000000000	0.03836	-0.05430	24	0	0	18	1	0	0.00000	0.00000
30	399211009	History of myocardial infarction (situation)	100	161622006	History of lower limb amputation (situation)	1095	31	1	0	31	1	1063	0.00000	-0.00516	0.00000	0.00000	0.00000	1.0000000000	1.0000000000	0.02831	-0.04028	2	0	0	29	1	0	0.00000	0.00000
29	22298006	Myocardial Infarction	100	161622006	History of lower limb amputation (situation)	1095	31	1	0	31	1	1063	0.00000	-0.00516	0.00000	0.00000	0.00000	1.0000000000	1.0000000000	0.02831	-0.04028	2	0	0	29	1	0	0.00000	0.00000
27	408512008	Body mass index 40+ - severely obese (finding)	100	161622006	History of lower limb amputation (situation)	1095	97	1	0	97	1	997	0.00000	-0.00943	0.00000	0.00000	0.00000	1.0000000000	1.0000000000	0.08858	-0.12245	67	0	0	30	1	0	0.00000	0.00000
24	162864005	Body mass index 30+ - obesity (finding)	100	161622006	History of lower limb amputation (situation)	1095	439	1	0	439	1	655	0.00000	-0.02473	0.00000	0.00000	0.00000	1.0000000000	1.0000000000	0.40091	-0.48637	226	0	0	213	1	0	0.00000	0.00000
23	36971009	Sinusitis (disorder)	100	161622006	History of lower limb amputation (situation)	1095	190	1	0	190	1	904	0.00000	-0.01385	0.00000	0.00000	0.00000	1.0000000000	1.0000000000	0.17352	-0.23084	84	0	0	106	1	0	0.00000	0.00000
21	15777000	Prediabetes	100	161622006	History of lower limb amputation (situation)	1095	333	1	1	332	0	762	3.28829	0.04573	0.00000	0.00000	0.00000	0.3041095890	0.9949586182	0.30411	0.61693	159	0	0	174	1	1	-0.69315	-5.16479
20	80394007	Hyperglycemia (disorder)	100	161622006	History of lower limb amputation (situation)	1095	55	1	1	54	0	1040	19.90909	0.13147	0.00000	0.00000	0.00000	0.0502283105	0.4320205543	0.05023	0.92930	23	0	0	32	1	1	-0.69315	-3.49651
19	237602007	Metabolic syndrome X (disorder)	100	161622006	History of lower limb amputation (situation)	1095	64	1	1	63	0	1031	17.10937	0.12135	0.00000	0.00000	0.00000	0.0584474886	0.4685406893	0.05845	0.91805	28	0	0	36	1	1	-0.69315	-3.61092
18	302870006	Hypertriglyceridemia (disorder)	100	161622006	History of lower limb amputation (situation)	1095	64	1	1	63	0	1031	17.10937	0.12135	0.00000	0.00000	0.00000	0.0584474886	0.4685406893	0.05845	0.91805	28	0	0	36	1	1	-0.69315	-3.61092
17	368581000119106	Neuropathy due to type 2 diabetes mellitus (disorder)	100	161622006	History of lower limb amputation (situation)	1095	28	1	1	27	0	1067	39.10714	0.18664	0.00000	0.00000	0.00000	0.0255707763	0.2905941929	0.02557	0.96357	7	0	0	21	1	1	-0.69315	-3.09104
129	47505003	Posttraumatic stress disorder	74	79586000	Tubal pregnancy	1095	4	23	0	4	23	1068	0.00000	-0.00887	0.00000	0.00000	0.00000	1.0000000000	1.0000000000	0.08402	-0.11639	1	23	0	3	0	0	0.00000	0.00000
15	40055000	Chronic sinusitis (disorder)	100	161622006	History of lower limb amputation (situation)	1095	216	1	0	216	1	878	0.00000	-0.01499	0.00000	0.00000	0.00000	1.0000000000	1.0000000000	0.19726	-0.25974	104	0	0	112	1	0	0.00000	0.00000
14	10509002	Acute bronchitis (disorder)	100	161622006	History of lower limb amputation (situation)	1095	863	1	1	862	0	232	1.26883	0.01568	0.00000	0.00000	0.00000	1.0000000000	1.0000000000	0.78813	0.16155	418	0	0	445	1	1	-0.69315	-6.10032
13	370247008	Facial laceration	100	161622006	History of lower limb amputation (situation)	1095	109	1	1	108	0	986	10.04587	0.09093	0.00000	0.00000	0.00000	0.0995433790	0.6255159994	0.09954	0.86310	55	0	0	54	1	1	-0.69315	-4.00733
125	1734006	Fracture of the vertebral column with spinal cord injury	74	79586000	Tubal pregnancy	1095	5	23	0	5	23	1067	0.00000	-0.00992	0.00000	0.00000	0.00000	1.0000000000	1.0000000000	0.10502	-0.14408	3	23	0	2	0	0	0.00000	0.00000
124	1501000119109	Proliferative diabetic retinopathy due to type II diabetes mellitus (disorder)	74	79586000	Tubal pregnancy	1095	1	23	0	1	23	1071	0.00000	-0.00443	0.00000	0.00000	0.00000	1.0000000000	1.0000000000	0.02100	-0.02999	1	23	0	0	0	0	0.00000	0.00000
10	62106007	Concussion with no loss of consciousness	100	161622006	History of lower limb amputation (situation)	1095	206	1	0	206	1	888	0.00000	-0.01455	0.00000	0.00000	0.00000	1.0000000000	1.0000000000	0.18813	-0.24869	96	0	0	110	1	0	0.00000	0.00000
121	254637007	Non-small cell lung cancer (disorder)	74	79586000	Tubal pregnancy	1095	8	23	0	8	23	1064	0.00000	-0.01257	0.00000	0.00000	0.00000	1.0000000000	1.0000000000	0.16804	-0.22409	0	23	0	8	0	0	0.00000	0.00000
7	75498004	Acute bacterial sinusitis (disorder)	100	161622006	History of lower limb amputation (situation)	1095	187	1	0	187	1	907	0.00000	-0.01372	0.00000	0.00000	0.00000	1.0000000000	1.0000000000	0.17078	-0.22747	89	0	0	98	1	0	0.00000	0.00000
6	39848009	Whiplash injury to neck	100	161622006	History of lower limb amputation (situation)	1095	182	1	1	181	0	913	6.01648	0.06772	0.00000	0.00000	0.00000	0.1662100457	0.7915572889	0.16621	0.77817	92	0	0	90	1	1	-0.69315	-4.51086
5	284549007	Laceration of hand	100	161622006	History of lower limb amputation (situation)	1095	104	1	0	104	1	990	0.00000	-0.00979	0.00000	0.00000	0.00000	1.0000000000	1.0000000000	0.09498	-0.13090	54	0	0	50	1	0	0.00000	0.00000
117	230265002	Familial Alzheimer's disease of early onset (disorder)	74	79586000	Tubal pregnancy	1095	6	23	0	6	23	1066	0.00000	-0.01087	0.00000	0.00000	0.00000	1.0000000000	1.0000000000	0.12603	-0.17124	2	23	0	4	0	0	0.00000	0.00000
116	370143000	Major depression disorder	74	79586000	Tubal pregnancy	1095	8	23	0	8	23	1064	0.00000	-0.01257	0.00000	0.00000	0.00000	1.0000000000	1.0000000000	0.16804	-0.22409	3	23	0	5	0	0	0.00000	0.00000
115	36923009	Major depression  single episode	74	79586000	Tubal pregnancy	1095	6	23	0	6	23	1066	0.00000	-0.01087	0.00000	0.00000	0.00000	1.0000000000	1.0000000000	0.12603	-0.17124	3	23	0	3	0	0	0.00000	0.00000
1	444814009	Viral sinusitis (disorder)	100	161622006	History of lower limb amputation (situation)	1095	993	1	1	992	0	102	1.10272	0.00969	0.00000	0.00000	0.00000	1.0000000000	1.0000000000	0.90685	0.06881	478	0	0	515	1	1	-0.69315	-6.24611
113	443165006	Pathological fracture due to osteoporosis (disorder)	74	79586000	Tubal pregnancy	1095	10	23	1	9	22	1063	4.76087	0.05289	5.36869	44.22373	0.65175	0.1919811700	0.8268943621	0.21005	0.72494	7	23	1	3	0	0	3.17805	2.07944
112	49436004	Atrial Fibrillation	74	79586000	Tubal pregnancy	1095	35	23	1	34	22	1038	1.36025	0.00959	1.38770	10.59697	0.18172	0.5299435145	1.0000000000	0.73516	0.20493	9	23	1	26	0	0	3.17805	2.30259
111	235919008	Cholelithiasis	74	79586000	Tubal pregnancy	1095	9	23	0	9	23	1063	0.00000	-0.01333	0.00000	0.00000	0.00000	1.0000000000	1.0000000000	0.18904	-0.24980	7	23	0	2	0	0	0.00000	0.00000
110	65275009	Acute Cholecystitis	74	79586000	Tubal pregnancy	1095	9	23	0	9	23	1063	0.00000	-0.01333	0.00000	0.00000	0.00000	1.0000000000	1.0000000000	0.18904	-0.24980	7	23	0	2	0	0	0.00000	0.00000
109	90560007	Gout	74	79586000	Tubal pregnancy	1095	4	23	0	4	23	1068	0.00000	-0.00887	0.00000	0.00000	0.00000	1.0000000000	1.0000000000	0.08402	-0.11639	0	23	0	4	0	0	0.00000	0.00000
108	40930008	Hypothyroidism (disorder)	74	79586000	Tubal pregnancy	1095	13	23	0	13	23	1059	0.00000	-0.01606	0.00000	0.00000	0.00000	1.0000000000	1.0000000000	0.27306	-0.34830	11	23	0	2	0	0	0.00000	0.00000
107	40275004	Contact dermatitis	74	79586000	Tubal pregnancy	1095	18	23	2	16	21	1056	5.28986	0.08123	6.28571	29.09014	1.35820	0.0526615077	0.4433527430	0.37808	1.12230	9	23	2	9	0	0	2.52573	1.70475
106	24079001	Atopic dermatitis	74	79586000	Tubal pregnancy	1095	20	23	1	19	22	1053	2.38043	0.02758	2.51914	19.66118	0.32277	0.3484063322	1.0000000000	0.42009	0.49402	13	23	1	7	0	0	3.17805	2.63906
105	363406005	Malignant tumor of colon	74	79586000	Tubal pregnancy	1095	6	23	0	6	23	1066	0.00000	-0.01087	0.00000	0.00000	0.00000	1.0000000000	1.0000000000	0.12603	-0.17124	4	23	0	2	0	0	0.00000	0.00000
104	367498001	Seasonal allergic rhinitis	74	79586000	Tubal pregnancy	1095	20	23	1	19	22	1053	2.38043	0.02758	2.51914	19.66118	0.32277	0.3484063322	1.0000000000	0.42009	0.49402	9	23	1	11	0	0	3.17805	2.30259
103	157141000119108	Proteinuria due to type 2 diabetes mellitus (disorder)	74	79586000	Tubal pregnancy	1095	3	23	0	3	23	1069	0.00000	-0.00768	0.00000	0.00000	0.00000	1.0000000000	1.0000000000	0.06301	-0.08816	1	23	0	2	0	0	0.00000	0.00000
102	90781000119102	Microalbuminuria due to type 2 diabetes mellitus (disorder)	74	79586000	Tubal pregnancy	1095	6	23	0	6	23	1066	0.00000	-0.01087	0.00000	0.00000	0.00000	1.0000000000	1.0000000000	0.12603	-0.17124	3	23	0	3	0	0	0.00000	0.00000
101	433144002	Chronic kidney disease stage 3 (disorder)	74	79586000	Tubal pregnancy	1095	3	23	0	3	23	1069	0.00000	-0.00768	0.00000	0.00000	0.00000	1.0000000000	1.0000000000	0.06301	-0.08816	1	23	0	2	0	0	0.00000	0.00000
100	161622006	History of lower limb amputation (situation)	74	79586000	Tubal pregnancy	1095	1	23	0	1	23	1071	0.00000	-0.00443	0.00000	0.00000	0.00000	1.0000000000	1.0000000000	0.02100	-0.02999	0	23	0	1	0	0	0.00000	0.00000
99	30832001	Rupture of patellar tendon	74	79586000	Tubal pregnancy	1095	23	23	1	22	22	1050	2.06994	0.02296	2.16942	16.81837	0.27984	0.3893784286	1.0000000000	0.48311	0.43138	14	23	1	9	0	0	3.17805	2.70805
98	1551000119108	Nonproliferative diabetic retinopathy due to type 2 diabetes mellitus (disorder)	74	79586000	Tubal pregnancy	1095	12	23	0	12	23	1060	0.00000	-0.01542	0.00000	0.00000	0.00000	1.0000000000	1.0000000000	0.25205	-0.32430	7	23	0	5	0	0	0.00000	0.00000
97	403192003	Third degree burn	74	79586000	Tubal pregnancy	1095	8	23	0	8	23	1064	0.00000	-0.01257	0.00000	0.00000	0.00000	1.0000000000	1.0000000000	0.16804	-0.22409	3	23	0	5	0	0	0.00000	0.00000
96	283371005	Laceration of forearm	74	79586000	Tubal pregnancy	1095	75	23	5	70	18	1002	3.17391	0.08635	3.97619	11.02686	1.43378	0.0167399604	0.2199751085	1.57534	1.22020	39	23	5	36	0	0	1.72277	2.17475
95	84757009	Epilepsy	74	79586000	Tubal pregnancy	1095	30	23	0	30	23	1042	0.00000	-0.02458	0.00000	0.00000	0.00000	1.0000000000	1.0000000000	0.63014	-0.70499	13	23	0	17	0	0	0.00000	0.00000
94	703151001	History of single seizure (situation)	74	79586000	Tubal pregnancy	1095	39	23	0	39	23	1033	0.00000	-0.02815	0.00000	0.00000	0.00000	1.0000000000	1.0000000000	0.81918	-0.86329	14	23	0	25	0	0	0.00000	0.00000
93	128613002	Seizure disorder	74	79586000	Tubal pregnancy	1095	39	23	0	39	23	1033	0.00000	-0.02815	0.00000	0.00000	0.00000	1.0000000000	1.0000000000	0.81918	-0.86329	14	23	0	25	0	0	0.00000	0.00000
92	82423001	Chronic pain	74	79586000	Tubal pregnancy	1095	52	23	1	51	22	1021	0.91555	-0.00276	0.90998	6.88484	0.12027	1.0000000000	1.0000000000	1.09224	-0.06505	24	23	1	28	0	0	3.17805	3.21888
91	64859006	Osteoporosis (disorder)	74	79586000	Tubal pregnancy	1095	37	23	1	36	22	1036	1.28672	0.00785	1.30808	9.97357	0.17156	0.5501303079	1.0000000000	0.77717	0.17042	24	23	1	13	0	0	3.17805	3.21888
90	444470001	Injury of anterior cruciate ligament	74	79586000	Tubal pregnancy	1095	19	23	0	19	23	1053	0.00000	-0.01946	0.00000	0.00000	0.00000	1.0000000000	1.0000000000	0.39909	-0.48449	10	23	0	9	0	0	0.00000	0.00000
89	47693006	Rupture of appendix	74	79586000	Tubal pregnancy	1095	20	23	0	20	23	1052	0.00000	-0.01998	0.00000	0.00000	0.00000	1.0000000000	1.0000000000	0.42009	-0.50598	10	23	0	10	0	0	0.00000	0.00000
88	197927001	Recurrent urinary tract infection	74	79586000	Tubal pregnancy	1095	8	23	0	8	23	1064	0.00000	-0.01257	0.00000	0.00000	0.00000	1.0000000000	1.0000000000	0.16804	-0.22409	8	23	0	0	0	0	0.00000	0.00000
87	109838007	Overlapping malignant neoplasm of colon	74	79586000	Tubal pregnancy	1095	8	23	0	8	23	1064	0.00000	-0.01257	0.00000	0.00000	0.00000	1.0000000000	1.0000000000	0.16804	-0.22409	5	23	0	3	0	0	0.00000	0.00000
86	713197008	Recurrent rectal polyp	74	79586000	Tubal pregnancy	1095	22	23	0	22	23	1050	0.00000	-0.02097	0.00000	0.00000	0.00000	1.0000000000	1.0000000000	0.46210	-0.54804	12	23	0	10	0	0	0.00000	0.00000
85	241929008	Acute allergic reaction	74	79586000	Tubal pregnancy	1095	47	23	1	46	22	1026	1.01295	0.00040	1.01383	7.68606	0.13373	1.0000000000	1.0000000000	0.98721	0.00925	25	23	1	22	0	0	3.17805	3.25810
84	232353008	Perennial allergic rhinitis with seasonal variation	74	79586000	Tubal pregnancy	1095	29	23	0	29	23	1043	0.00000	-0.02416	0.00000	0.00000	0.00000	1.0000000000	1.0000000000	0.60913	-0.68628	14	23	0	15	0	0	0.00000	0.00000
83	110030002	Concussion injury of brain	74	79586000	Tubal pregnancy	1095	7	23	0	7	23	1065	0.00000	-0.01175	0.00000	0.00000	0.00000	1.0000000000	1.0000000000	0.14703	-0.19791	1	23	0	6	0	0	0.00000	0.00000
82	94260004	Secondary malignant neoplasm of colon	74	79586000	Tubal pregnancy	1095	4	23	1	3	22	1069	11.90217	0.09669	16.19697	161.90868	1.62031	0.0815162066	0.5629813232	0.08402	0.88361	2	23	1	2	0	0	3.17805	1.09861
81	236077008	Protracted diarrhea	74	79586000	Tubal pregnancy	1095	4	23	1	3	22	1069	11.90217	0.09669	16.19697	161.90868	1.62031	0.0815162066	0.5629813232	0.08402	0.88361	2	23	1	2	0	0	3.17805	1.09861
80	6072007	Bleeding from anus	74	79586000	Tubal pregnancy	1095	4	23	1	3	22	1069	11.90217	0.09669	16.19697	161.90868	1.62031	0.0815162066	0.5629813232	0.08402	0.88361	2	23	1	2	0	0	3.17805	1.09861
79	45816000	Pyelonephritis	74	79586000	Tubal pregnancy	1095	1	23	0	1	23	1071	0.00000	-0.00443	0.00000	0.00000	0.00000	1.0000000000	1.0000000000	0.02100	-0.02999	1	23	0	0	0	0	0.00000	0.00000
78	239872002	Osteoarthritis of hip	74	79586000	Tubal pregnancy	1095	21	23	1	20	22	1052	2.26708	0.02595	2.39091	18.61452	0.30710	0.3623474060	1.0000000000	0.44110	0.47283	13	23	1	8	0	0	3.17805	2.63906
77	422034002	Diabetic retinopathy associated with type II diabetes mellitus (disorder)	74	79586000	Tubal pregnancy	1095	20	23	0	20	23	1052	0.00000	-0.01998	0.00000	0.00000	0.00000	1.0000000000	1.0000000000	0.42009	-0.50598	8	23	0	12	0	0	0.00000	0.00000
76	127013003	Diabetic renal disease (disorder)	74	79586000	Tubal pregnancy	1095	28	23	0	28	23	1044	0.00000	-0.02373	0.00000	0.00000	0.00000	1.0000000000	1.0000000000	0.58813	-0.66733	10	23	0	18	0	0	0.00000	0.00000
75	431855005	Chronic kidney disease stage 1 (disorder)	74	79586000	Tubal pregnancy	1095	28	23	0	28	23	1044	0.00000	-0.02373	0.00000	0.00000	0.00000	1.0000000000	1.0000000000	0.58813	-0.66733	10	23	0	18	0	0	0.00000	0.00000
73	196416002	Impacted molars	74	79586000	Tubal pregnancy	1095	49	23	2	47	21	1025	1.94321	0.02990	2.07700	9.12028	0.47300	0.2751020356	0.9503524867	1.02922	0.56403	25	23	2	24	0	0	2.52573	2.60269
72	35999006	Blighted ovum	74	79586000	Tubal pregnancy	1095	53	23	5	48	18	1024	4.49139	0.11534	5.92593	16.63590	2.11089	0.0037980399	0.0729522842	1.11324	1.50550	53	23	5	0	0	0	1.72277	2.45101
71	201834006	Localized  primary osteoarthritis of the hand	74	79586000	Tubal pregnancy	1095	28	23	1	27	22	1045	1.70031	0.01662	1.75926	13.53121	0.22873	0.4522447128	1.0000000000	0.58813	0.33267	19	23	1	9	0	0	3.17805	2.99573
70	87433001	Pulmonary emphysema (disorder)	74	79586000	Tubal pregnancy	1095	17	23	1	16	22	1056	2.80051	0.03312	3.00000	23.63061	0.38086	0.3048121888	0.9953175875	0.35708	0.55950	9	23	1	8	0	0	3.17805	2.30259
69	233604007	Pneumonia	74	79586000	Tubal pregnancy	1095	7	23	0	7	23	1065	0.00000	-0.01175	0.00000	0.00000	0.00000	1.0000000000	1.0000000000	0.14703	-0.19791	3	23	0	4	0	0	0.00000	0.00000
68	26929004	Alzheimer's disease (disorder)	74	79586000	Tubal pregnancy	1095	23	23	1	22	22	1050	2.06994	0.02296	2.16942	16.81837	0.27984	0.3893784286	1.0000000000	0.48311	0.43138	15	23	1	8	0	0	3.17805	2.77259
67	403191005	Second degree burn	74	79586000	Tubal pregnancy	1095	49	23	3	46	20	1026	2.91482	0.06071	3.34565	11.66494	0.95958	0.0794562744	0.5584007465	1.02922	0.97907	23	23	3	26	0	0	2.15948	2.15948
66	55822004	Hyperlipidemia	74	79586000	Tubal pregnancy	1095	119	23	1	118	22	954	0.40007	-0.03068	0.36749	2.75126	0.04909	0.5009501224	1.0000000000	2.49954	-0.80717	64	23	1	55	0	0	3.17805	4.17439
65	239873007	Osteoarthritis of knee	74	79586000	Tubal pregnancy	1095	57	23	2	55	21	1017	1.67048	0.02301	1.76104	7.70189	0.40266	0.3388072991	1.0000000000	1.19726	0.44926	30	23	2	27	0	0	2.52573	2.77259
64	444448004	Injury of medial collateral ligament of knee	74	79586000	Tubal pregnancy	1095	32	23	1	31	22	1041	1.48777	0.01240	1.52639	11.68742	0.19935	0.4980309114	1.0000000000	0.67215	0.25830	17	23	1	15	0	0	3.17805	2.89037
63	68496003	Polyp of colon	74	79586000	Tubal pregnancy	1095	91	23	0	91	23	981	0.00000	-0.04410	0.00000	0.00000	0.00000	0.2498168014	0.9133257124	1.91142	-1.54172	43	23	0	48	0	0	0.00000	0.00000
62	185086009	Chronic obstructive bronchitis (disorder)	74	79586000	Tubal pregnancy	1095	6	23	0	6	23	1066	0.00000	-0.01087	0.00000	0.00000	0.00000	1.0000000000	1.0000000000	0.12603	-0.17124	4	23	0	2	0	0	0.00000	0.00000
61	198992004	Antepartum eclampsia	74	79586000	Tubal pregnancy	1095	96	23	10	86	13	986	4.95924	0.17978	8.81932	20.70336	3.75690	0.0000074411	0.0003233572	2.01644	1.86659	96	23	10	0	0	0	1.19392	2.36085
60	301011002	Escherichia coli urinary tract infection	74	79586000	Tubal pregnancy	1095	92	23	3	89	20	983	1.55246	0.02451	1.65674	5.68361	0.48293	0.4336087286	1.0000000000	1.93242	0.44791	85	23	3	7	0	0	2.15948	3.37872
59	262574004	Bullet wound	74	79586000	Tubal pregnancy	1095	20	23	0	20	23	1052	0.00000	-0.01998	0.00000	0.00000	0.00000	1.0000000000	1.0000000000	0.42009	-0.50598	9	23	0	11	0	0	0.00000	0.00000
58	239720000	Tear of meniscus of knee	74	79586000	Tubal pregnancy	1095	20	23	0	20	23	1052	0.00000	-0.01998	0.00000	0.00000	0.00000	1.0000000000	1.0000000000	0.42009	-0.50598	10	23	0	10	0	0	0.00000	0.00000
57	192127007	Child attention deficit disorder	74	79586000	Tubal pregnancy	1095	76	23	3	73	20	999	1.87929	0.03517	2.05274	7.06897	0.59609	0.2103996939	0.8634354899	1.59635	0.62352	24	23	3	52	0	0	2.15948	2.19722
56	92691004	Carcinoma in situ of prostate (disorder)	74	79586000	Tubal pregnancy	1095	23	23	0	23	23	1049	0.00000	-0.02146	0.00000	0.00000	0.00000	1.0000000000	1.0000000000	0.48311	-0.56862	0	23	0	23	0	0	0.00000	0.00000
55	126906006	Neoplasm of prostate	74	79586000	Tubal pregnancy	1095	24	23	0	24	23	1048	0.00000	-0.02193	0.00000	0.00000	0.00000	1.0000000000	1.0000000000	0.50411	-0.58891	0	23	0	24	0	0	0.00000	0.00000
54	5602001	Opioid abuse (disorder)	74	79586000	Tubal pregnancy	1095	7	23	0	7	23	1065	0.00000	-0.01175	0.00000	0.00000	0.00000	1.0000000000	1.0000000000	0.14703	-0.19791	0	23	0	7	0	0	0.00000	0.00000
53	7200002	Alcoholism	74	79586000	Tubal pregnancy	1095	5	23	0	5	23	1067	0.00000	-0.00992	0.00000	0.00000	0.00000	1.0000000000	1.0000000000	0.10502	-0.14408	0	23	0	5	0	0	0.00000	0.00000
52	124171000119105	Chronic intractable migraine without aura	74	79586000	Tubal pregnancy	1095	51	23	1	50	22	1022	0.93350	-0.00215	0.92909	7.03202	0.12275	1.0000000000	1.0000000000	1.07123	-0.05049	21	23	1	30	0	0	3.17805	3.09104
51	403190006	First degree burn	74	79586000	Tubal pregnancy	1095	79	23	4	75	19	997	2.41057	0.05761	2.79860	8.43658	0.92835	0.0776924419	0.5519212949	1.65936	0.91085	43	23	4	36	0	0	1.90954	2.46385
50	446096008	Perennial allergic rhinitis	74	79586000	Tubal pregnancy	1095	26	23	0	26	23	1046	0.00000	-0.02284	0.00000	0.00000	0.00000	1.0000000000	1.0000000000	0.54612	-0.62865	14	23	0	12	0	0	0.00000	0.00000
49	88805009	Chronic congestive heart failure (disorder)	74	79586000	Tubal pregnancy	1095	10	23	0	10	23	1062	0.00000	-0.01406	0.00000	0.00000	0.00000	1.0000000000	1.0000000000	0.21005	-0.27506	5	23	0	5	0	0	0.00000	0.00000
48	55680006	Drug overdose	74	79586000	Tubal pregnancy	1095	50	23	1	49	22	1023	0.95217	-0.00153	0.94898	7.18533	0.12533	1.0000000000	1.0000000000	1.05023	-0.03578	24	23	1	26	0	0	3.17805	3.21888
47	359817006	Closed fracture of hip	74	79586000	Tubal pregnancy	1095	29	23	1	28	22	1044	1.64168	0.01550	1.69481	13.01925	0.22062	0.4640519964	1.0000000000	0.60913	0.31372	11	23	1	18	0	0	3.17805	2.48491
46	62564004	Concussion with loss of consciousness	74	79586000	Tubal pregnancy	1095	67	23	1	66	22	1006	0.71058	-0.01082	0.69284	5.21986	0.09196	1.0000000000	1.0000000000	1.40731	-0.26742	36	23	1	31	0	0	3.17805	3.61092
45	263102004	Fracture subluxation of wrist	74	79586000	Tubal pregnancy	1095	109	23	5	104	18	968	2.18389	0.05766	2.58547	7.10750	0.94051	0.0698743122	0.5202347010	2.28950	0.86710	51	23	5	58	0	0	1.72277	2.41591
44	58150001	Fracture of clavicle	74	79586000	Tubal pregnancy	1095	112	23	5	107	18	965	2.12539	0.05564	2.50519	6.88333	0.91177	0.0768756527	0.5486296578	2.35251	0.83972	55	23	5	57	0	0	1.72277	2.48491
43	307731004	Injury of tendon of the rotator cuff of shoulder	74	79586000	Tubal pregnancy	1095	51	23	1	50	22	1022	0.93350	-0.00215	0.92909	7.03202	0.12275	1.0000000000	1.0000000000	1.07123	-0.05049	26	23	1	25	0	0	3.17805	3.29584
42	16114001	Fracture of ankle	74	79586000	Tubal pregnancy	1095	108	23	3	105	20	967	1.32246	0.01562	1.38143	4.72661	0.40375	0.4891446374	1.0000000000	2.26849	0.29137	48	23	3	60	0	0	2.15948	2.83321
41	283385000	Laceration of thigh	74	79586000	Tubal pregnancy	1095	105	23	5	100	18	972	2.26708	0.06044	2.70000	7.42771	0.98146	0.0611414834	0.4826962916	2.20548	0.90442	50	23	5	55	0	0	1.72277	2.39790
40	428251008	History of appendectomy	74	79586000	Tubal pregnancy	1095	51	23	0	51	23	1021	0.00000	-0.03237	0.00000	0.00000	0.00000	0.6211545311	1.0000000000	1.07123	-1.05049	27	23	0	24	0	0	0.00000	0.00000
39	74400008	Appendicitis	74	79586000	Tubal pregnancy	1095	51	23	0	51	23	1021	0.00000	-0.03237	0.00000	0.00000	0.00000	0.6211545311	1.0000000000	1.07123	-1.05049	27	23	0	24	0	0	0.00000	0.00000
38	398254007	Preeclampsia	74	79586000	Tubal pregnancy	1095	101	23	7	94	16	978	3.29961	0.10737	4.55186	11.34288	1.82665	0.0032823448	0.0646018438	2.12146	1.35778	101	23	7	0	0	0	1.45529	2.73622
37	38822007	Cystitis	74	79586000	Tubal pregnancy	1095	71	23	5	66	18	1006	3.35273	0.09074	4.23401	11.76090	1.52427	0.0133640972	0.1876960724	1.49132	1.26805	68	23	5	3	0	0	1.72277	2.68102
36	156073000	Fetus with unknown complication	74	79586000	Tubal pregnancy	1095	125	23	15	110	8	962	5.71304	0.24782	16.39773	39.55118	6.79842	0.0000000007	0.0000000565	2.62557	2.14179	125	23	15	0	0	0	0.92954	2.23359
35	19169002	Miscarriage in first trimester	74	79586000	Tubal pregnancy	1095	174	23	23	151	0	921	6.29310	0.33699	0.00000	0.00000	0.00000	0.0000000000	0.0000000000	3.65479	2.36625	174	23	23	0	0	0	0.69315	2.14771
33	429007001	History of cardiac arrest (situation)	74	79586000	Tubal pregnancy	1095	42	23	3	39	20	1033	3.40062	0.07023	3.97308	13.93556	1.13274	0.0544727505	0.4515220052	0.88219	1.08759	24	23	3	18	0	0	2.15948	2.19722
32	410429000	Cardiac Arrest	74	79586000	Tubal pregnancy	1095	42	23	3	39	20	1033	3.40062	0.07023	3.97308	13.93556	1.13274	0.0544727505	0.4515220052	0.88219	1.08759	24	23	3	18	0	0	2.15948	2.19722
31	230690007	Stroke	74	79586000	Tubal pregnancy	1095	62	23	2	60	21	1012	1.53576	0.01923	1.60635	7.01155	0.36802	0.3780175858	1.0000000000	1.30228	0.38190	32	23	2	30	0	0	2.52573	2.83321
30	399211009	History of myocardial infarction (situation)	74	79586000	Tubal pregnancy	1095	31	23	1	30	22	1042	1.53576	0.01340	1.57879	12.10086	0.20598	0.4869403360	1.0000000000	0.65114	0.27654	2	23	1	29	0	0	3.17805	1.09861
29	22298006	Myocardial Infarction	74	79586000	Tubal pregnancy	1095	31	23	1	30	22	1042	1.53576	0.01340	1.57879	12.10086	0.20598	0.4869403360	1.0000000000	0.65114	0.27654	2	23	1	29	0	0	3.17805	1.09861
28	53741008	Coronary Heart Disease	74	79586000	Tubal pregnancy	1095	80	23	3	77	20	995	1.78533	0.03229	1.93831	6.66758	0.56348	0.2330584830	0.8937472100	1.68037	0.57757	24	23	3	56	0	0	2.15948	2.19722
27	408512008	Body mass index 40+ - severely obese (finding)	74	79586000	Tubal pregnancy	1095	97	23	2	95	21	977	0.98162	-0.00084	0.97945	4.24122	0.22619	1.0000000000	1.0000000000	2.03744	-0.01789	67	23	2	30	0	0	2.52573	3.54096
26	33737001	Fracture of rib	74	79586000	Tubal pregnancy	1095	54	23	3	51	20	1021	2.64493	0.05488	3.00294	10.43582	0.86411	0.0999333239	0.6256881010	1.13425	0.90627	32	23	3	22	0	0	2.15948	2.45674
25	284551006	Laceration of foot	74	79586000	Tubal pregnancy	1095	118	23	2	116	21	956	0.80693	-0.00983	0.78489	3.39037	0.18171	1.0000000000	1.0000000000	2.47854	-0.21352	53	23	2	65	0	0	2.52573	3.31419
24	162864005	Body mass index 30+ - obesity (finding)	74	79586000	Tubal pregnancy	1095	439	23	16	423	7	649	1.73517	0.08809	3.50692	8.59628	1.43068	0.0046453491	0.0860271616	9.22100	0.73400	226	23	16	213	0	0	0.89097	2.71635
23	36971009	Sinusitis (disorder)	74	79586000	Tubal pregnancy	1095	190	23	5	185	18	887	1.25286	0.01697	1.33183	3.63261	0.48829	0.5772211086	1.0000000000	3.99087	0.26567	84	23	5	106	0	0	1.72277	2.87920
22	70704007	Sprain of wrist	74	79586000	Tubal pregnancy	1095	195	23	7	188	16	884	1.70903	0.04834	2.05718	5.07011	0.83469	0.1613482742	0.7850970902	4.09589	0.65067	90	23	7	105	0	0	1.45529	2.62880
21	15777000	Prediabetes	74	79586000	Tubal pregnancy	1095	333	23	13	320	10	752	1.85860	0.08314	3.05500	7.03923	1.32586	0.0100629756	0.1555459839	6.99452	0.80834	159	23	13	174	0	0	1.01857	2.58255
20	80394007	Hyperglycemia (disorder)	74	79586000	Tubal pregnancy	1095	55	23	2	53	21	1019	1.73123	0.02463	1.83109	8.01538	0.41831	0.3229546888	1.0000000000	1.15525	0.47711	23	23	2	32	0	0	2.52573	2.52573
19	237602007	Metabolic syndrome X (disorder)	74	79586000	Tubal pregnancy	1095	64	23	2	62	21	1010	1.48777	0.01780	1.55146	6.76723	0.35569	0.6401488482	1.0000000000	1.34429	0.35581	28	23	2	36	0	0	2.52573	2.70805
18	302870006	Hypertriglyceridemia (disorder)	74	79586000	Tubal pregnancy	1095	64	23	2	62	21	1010	1.48777	0.01780	1.55146	6.76723	0.35569	0.6401488482	1.0000000000	1.34429	0.35581	28	23	2	36	0	0	2.52573	2.70805
17	368581000119106	Neuropathy due to type 2 diabetes mellitus (disorder)	74	79586000	Tubal pregnancy	1095	28	23	1	27	22	1045	1.70031	0.01662	1.75926	13.53121	0.22873	0.4522447128	1.0000000000	0.58813	0.33267	7	23	1	21	0	0	3.17805	2.07944
16	44054006	Diabetes	74	79586000	Tubal pregnancy	1095	68	23	2	66	21	1006	1.40026	0.01509	1.45166	6.32388	0.33323	0.6493073967	1.0000000000	1.42831	0.30501	29	23	2	39	0	0	2.52573	2.74084
15	40055000	Chronic sinusitis (disorder)	74	79586000	Tubal pregnancy	1095	216	23	11	205	12	867	2.42452	0.10343	3.87683	8.91017	1.68681	0.0019884156	0.0430970671	4.53699	1.11586	104	23	11	112	0	0	1.12847	2.34704
14	10509002	Acute bronchitis (disorder)	74	79586000	Tubal pregnancy	1095	863	23	23	840	0	232	1.26883	0.07595	0.00000	0.00000	0.00000	0.0075883293	0.1256799135	18.12694	0.32743	418	23	23	445	0	0	0.69315	2.95355
13	370247008	Facial laceration	74	79586000	Tubal pregnancy	1095	109	23	1	108	22	964	0.43678	-0.02743	0.40572	3.03976	0.05415	0.7202597604	1.0000000000	2.28950	-0.71787	55	23	1	54	0	0	3.17805	4.02535
12	65966004	Fracture of forearm	74	79586000	Tubal pregnancy	1095	123	23	1	122	22	950	0.38706	-0.03194	0.35395	2.64921	0.04729	0.5025046321	1.0000000000	2.58356	-0.84139	55	23	1	68	0	0	3.17805	4.02535
11	38341003	Hypertension	74	79586000	Tubal pregnancy	1095	278	23	4	274	19	798	0.68502	-0.02691	0.61314	1.81802	0.20678	0.4731776365	1.0000000000	5.83927	-0.45191	131	23	4	147	0	0	1.90954	3.51898
10	62106007	Concussion with no loss of consciousness	74	79586000	Tubal pregnancy	1095	206	23	4	202	19	870	0.92444	-0.00533	0.90672	2.69422	0.30515	1.0000000000	1.0000000000	4.32694	-0.09138	96	23	4	110	0	0	1.90954	3.21888
9	44465007	Sprain of ankle	74	79586000	Tubal pregnancy	1095	362	23	11	351	12	721	1.44667	0.04598	1.88295	4.30968	0.82269	0.1768099552	0.8029498763	7.60365	0.48001	185	23	11	177	0	0	1.12847	2.88022
8	233678006	Childhood asthma	74	79586000	Tubal pregnancy	1095	45	23	1	44	22	1028	1.05797	0.00176	1.06198	8.05862	0.13995	1.0000000000	1.0000000000	0.94521	0.04008	25	23	1	20	0	0	3.17805	3.25810
7	75498004	Acute bacterial sinusitis (disorder)	74	79586000	Tubal pregnancy	1095	187	23	9	178	14	894	2.29133	0.08584	3.22873	7.57452	1.37629	0.0093554868	0.1471728725	3.92785	1.02097	89	23	9	98	0	0	1.26851	2.38774
6	39848009	Whiplash injury to neck	74	79586000	Tubal pregnancy	1095	182	23	5	177	18	895	1.30793	0.02014	1.40458	3.83276	0.51473	0.5680697544	1.0000000000	3.82283	0.31508	92	23	5	90	0	0	1.72277	2.96527
5	284549007	Laceration of hand	74	79586000	Tubal pregnancy	1095	104	23	2	102	21	970	0.91555	-0.00401	0.90570	3.91818	0.20935	1.0000000000	1.0000000000	2.18447	-0.08609	54	23	2	50	0	0	2.52573	3.33220
4	195662009	Acute viral pharyngitis (disorder)	74	79586000	Tubal pregnancy	1095	890	23	23	867	0	205	1.23034	0.07030	0.00000	0.00000	0.00000	0.0130923035	0.1844690856	18.69406	0.28527	430	23	23	460	0	0	0.69315	2.98040
3	65363002	Otitis media	74	79586000	Tubal pregnancy	1095	580	23	12	568	11	504	0.98501	-0.00233	0.96799	2.21300	0.42341	1.0000000000	1.0000000000	12.18265	-0.02013	277	23	12	303	0	0	1.07044	3.18152
2	43878008	Streptococcal sore throat (disorder)	74	79586000	Tubal pregnancy	1095	523	23	15	508	8	564	1.36545	0.05119	2.08169	4.95098	0.87527	0.0962606148	0.6167705670	10.98539	0.41680	246	23	15	277	0	0	0.92954	2.85647
1	444814009	Viral sinusitis (disorder)	74	79586000	Tubal pregnancy	1095	993	23	23	970	0	102	1.10272	0.04695	0.00000	0.00000	0.00000	0.1580460463	0.7763448205	20.85753	0.13490	478	23	23	515	0	0	0.69315	3.08111
113	443165006	Pathological fracture due to osteoporosis (disorder)	48	55680006	Drug overdose	1095	10	50	1	9	49	1036	2.19000	0.02499	2.34921	18.91281	0.29180	0.3745931068	1.0000000000	0.45662	0.45737	7	24	1	3	26	0	3.21888	2.07944
112	49436004	Atrial Fibrillation	48	55680006	Drug overdose	1095	35	50	3	32	47	1013	1.87714	0.03486	2.02061	6.83763	0.59712	0.2117110528	0.8671354646	1.59817	0.62250	9	24	0	26	26	3	-2.26868	-2.26868
111	235919008	Cholelithiasis	48	55680006	Drug overdose	1095	9	50	0	9	50	1036	0.00000	-0.01991	0.00000	0.00000	0.00000	1.0000000000	1.0000000000	0.41096	-0.49668	7	24	0	2	26	0	0.00000	0.00000
110	65275009	Acute Cholecystitis	48	55680006	Drug overdose	1095	9	50	0	9	50	1036	0.00000	-0.01991	0.00000	0.00000	0.00000	1.0000000000	1.0000000000	0.41096	-0.49668	7	24	0	2	26	0	0.00000	0.00000
109	90560007	Gout	48	55680006	Drug overdose	1095	4	50	0	4	50	1041	0.00000	-0.01324	0.00000	0.00000	0.00000	1.0000000000	1.0000000000	0.18265	-0.24202	0	24	0	4	26	0	0.00000	0.00000
108	40930008	Hypothyroidism (disorder)	48	55680006	Drug overdose	1095	13	50	1	12	49	1033	1.68462	0.01641	1.75680	13.78418	0.22391	0.4572043022	1.0000000000	0.59361	0.32770	11	24	1	2	26	0	3.21888	2.48491
107	40275004	Contact dermatitis	48	55680006	Drug overdose	1095	18	50	1	17	49	1028	1.21667	0.00613	1.23409	9.46297	0.16094	0.5717439000	1.0000000000	0.82192	0.13454	9	24	0	9	26	1	-3.29584	-2.30259
106	24079001	Atopic dermatitis	48	55680006	Drug overdose	1095	20	50	0	20	50	1025	0.00000	-0.02984	0.00000	0.00000	0.00000	1.0000000000	1.0000000000	0.91324	-0.93602	13	24	0	7	26	0	0.00000	0.00000
105	363406005	Malignant tumor of colon	48	55680006	Drug overdose	1095	6	50	1	5	49	1040	3.65000	0.04303	4.24490	37.03214	0.48658	0.2450339970	0.9133257124	0.27397	0.65067	4	24	0	2	26	1	-3.29584	-1.09861
104	367498001	Seasonal allergic rhinitis	48	55680006	Drug overdose	1095	20	50	1	19	49	1026	1.09500	0.00283	1.10204	8.40115	0.14456	0.6106022951	1.0000000000	0.91324	0.06398	9	24	1	11	26	0	3.21888	2.30259
103	157141000119108	Proteinuria due to type 2 diabetes mellitus (disorder)	48	55680006	Drug overdose	1095	3	50	0	3	50	1042	0.00000	-0.01147	0.00000	0.00000	0.00000	1.0000000000	1.0000000000	0.13699	-0.18521	1	24	0	2	26	0	0.00000	0.00000
102	90781000119102	Microalbuminuria due to type 2 diabetes mellitus (disorder)	48	55680006	Drug overdose	1095	6	50	0	6	50	1039	0.00000	-0.01624	0.00000	0.00000	0.00000	1.0000000000	1.0000000000	0.27397	-0.34933	3	24	0	3	26	0	0.00000	0.00000
101	433144002	Chronic kidney disease stage 3 (disorder)	48	55680006	Drug overdose	1095	3	50	0	3	50	1042	0.00000	-0.01147	0.00000	0.00000	0.00000	1.0000000000	1.0000000000	0.13699	-0.18521	1	24	0	2	26	0	0.00000	0.00000
100	161622006	History of lower limb amputation (situation)	48	55680006	Drug overdose	1095	1	50	0	1	50	1044	0.00000	-0.00661	0.00000	0.00000	0.00000	1.0000000000	1.0000000000	0.04566	-0.06442	0	24	0	1	26	0	0.00000	0.00000
99	30832001	Rupture of patellar tendon	48	55680006	Drug overdose	1095	23	50	1	22	49	1023	0.95217	-0.00153	0.94898	7.18533	0.12533	1.0000000000	1.0000000000	1.05023	-0.03578	14	24	1	9	26	0	3.21888	2.70805
98	1551000119108	Nonproliferative diabetic retinopathy due to type 2 diabetes mellitus (disorder)	48	55680006	Drug overdose	1095	12	50	1	11	49	1034	1.82500	0.01900	1.91837	15.15834	0.24278	0.4309315192	1.0000000000	0.54795	0.36965	7	24	1	5	26	0	3.21888	2.07944
97	403192003	Third degree burn	48	55680006	Drug overdose	1095	8	50	0	8	50	1037	0.00000	-0.01877	0.00000	0.00000	0.00000	1.0000000000	1.0000000000	0.36530	-0.44921	3	24	0	5	26	0	0.00000	0.00000
96	283371005	Laceration of forearm	48	55680006	Drug overdose	1095	75	50	7	68	43	977	2.04400	0.06192	2.33892	5.39502	1.01400	0.0752662991	0.5406608622	3.42466	0.85443	39	24	4	36	26	3	-0.32277	-0.19004
95	84757009	Epilepsy	48	55680006	Drug overdose	1095	30	50	0	30	50	1015	0.00000	-0.03671	0.00000	0.00000	0.00000	0.3947290276	1.0000000000	1.36986	-1.24480	13	24	0	17	26	0	0.00000	0.00000
94	703151001	History of single seizure (situation)	48	55680006	Drug overdose	1095	39	50	0	39	50	1006	0.00000	-0.04204	0.00000	0.00000	0.00000	0.2537433958	0.9133257124	1.78082	-1.47551	14	24	0	25	26	0	0.00000	0.00000
93	128613002	Seizure disorder	48	55680006	Drug overdose	1095	39	50	0	39	50	1006	0.00000	-0.04204	0.00000	0.00000	0.00000	0.2537433958	0.9133257124	1.78082	-1.47551	14	24	0	25	26	0	0.00000	0.00000
92	82423001	Chronic pain	48	55680006	Drug overdose	1095	52	50	36	16	14	1029	15.16154	0.69167	165.37500	364.57647	75.01551	0.0000000000	0.0000000000	2.37443	3.45481	24	24	18	28	26	18	-0.04652	-0.09097
91	64859006	Osteoporosis (disorder)	48	55680006	Drug overdose	1095	37	50	3	34	47	1011	1.77568	0.03173	1.89800	6.40413	0.56251	0.2363325370	0.9019682653	1.68950	0.57266	24	24	2	13	26	1	-0.73089	-0.07411
89	47693006	Rupture of appendix	48	55680006	Drug overdose	1095	20	50	2	18	48	1027	2.19000	0.03550	2.37731	10.54066	0.53617	0.2310723683	0.8905172734	0.91324	0.64894	10	24	1	10	26	1	-0.07696	0.00000
88	197927001	Recurrent urinary tract infection	48	55680006	Drug overdose	1095	8	50	0	8	50	1037	0.00000	-0.01877	0.00000	0.00000	0.00000	1.0000000000	1.0000000000	0.36530	-0.44921	8	24	0	0	26	0	0.00000	0.00000
86	713197008	Recurrent rectal polyp	48	55680006	Drug overdose	1095	22	50	3	19	47	1026	2.98636	0.06222	3.44681	12.05774	0.98530	0.0748452866	0.5403135912	1.00457	0.99671	12	24	1	10	26	2	0.57982	0.77319
85	241929008	Acute allergic reaction	48	55680006	Drug overdose	1095	47	50	0	47	50	998	0.00000	-0.04632	0.00000	0.00000	0.00000	0.2682331818	0.9388450812	2.14612	-1.65357	25	24	0	22	26	0	0.00000	0.00000
84	232353008	Perennial allergic rhinitis with seasonal variation	48	55680006	Drug overdose	1095	29	50	2	27	48	1018	1.51034	0.01841	1.57099	6.79989	0.36295	0.3857192787	1.0000000000	1.32420	0.36823	14	24	1	15	26	1	-0.07696	-0.06454
83	110030002	Concussion injury of brain	48	55680006	Drug overdose	1095	7	50	0	7	50	1038	0.00000	-0.01755	0.00000	0.00000	0.00000	1.0000000000	1.0000000000	0.31963	-0.40014	1	24	0	6	26	0	0.00000	0.00000
82	94260004	Secondary malignant neoplasm of colon	48	55680006	Drug overdose	1095	4	50	0	4	50	1041	0.00000	-0.01324	0.00000	0.00000	0.00000	1.0000000000	1.0000000000	0.18265	-0.24202	2	24	0	2	26	0	0.00000	0.00000
81	236077008	Protracted diarrhea	48	55680006	Drug overdose	1095	4	50	0	4	50	1041	0.00000	-0.01324	0.00000	0.00000	0.00000	1.0000000000	1.0000000000	0.18265	-0.24202	2	24	0	2	26	0	0.00000	0.00000
80	6072007	Bleeding from anus	48	55680006	Drug overdose	1095	4	50	0	4	50	1041	0.00000	-0.01324	0.00000	0.00000	0.00000	1.0000000000	1.0000000000	0.18265	-0.24202	2	24	0	2	26	0	0.00000	0.00000
79	45816000	Pyelonephritis	48	55680006	Drug overdose	1095	1	50	0	1	50	1044	0.00000	-0.00661	0.00000	0.00000	0.00000	1.0000000000	1.0000000000	0.04566	-0.06442	1	24	0	0	26	0	0.00000	0.00000
78	239872002	Osteoarthritis of hip	48	55680006	Drug overdose	1095	21	50	1	20	49	1025	1.04286	0.00131	1.04592	7.95349	0.13754	1.0000000000	1.0000000000	0.95890	0.02995	13	24	1	8	26	0	3.21888	2.63906
77	422034002	Diabetic retinopathy associated with type II diabetes mellitus (disorder)	48	55680006	Drug overdose	1095	20	50	2	18	48	1027	2.19000	0.03550	2.37731	10.54066	0.53617	0.2310723683	0.8905172734	0.91324	0.64894	8	24	1	12	26	1	-0.07696	-0.36772
76	127013003	Diabetic renal disease (disorder)	48	55680006	Drug overdose	1095	28	50	2	26	48	1019	1.56429	0.02000	1.63301	7.08155	0.37657	0.3689399696	1.0000000000	1.27854	0.39685	10	24	1	18	26	1	-0.07696	-0.54654
75	431855005	Chronic kidney disease stage 1 (disorder)	48	55680006	Drug overdose	1095	28	50	2	26	48	1019	1.56429	0.02000	1.63301	7.08155	0.37657	0.3689399696	1.0000000000	1.27854	0.39685	10	24	1	18	26	1	-0.07696	-0.54654
73	196416002	Impacted molars	48	55680006	Drug overdose	1095	49	50	37	12	13	1033	16.53673	0.73556	245.00641	573.45173	104.67863	0.0000000000	0.0000000000	2.23744	3.55307	25	24	17	24	26	20	0.04745	0.11600
72	35999006	Blighted ovum	48	55680006	Drug overdose	1095	53	50	4	49	46	996	1.65283	0.03221	1.76752	5.10782	0.61164	0.2980876970	0.9862848865	2.42009	0.54789	53	24	4	0	26	0	1.94591	2.65676
71	201834006	Localized  primary osteoarthritis of the hand	48	55680006	Drug overdose	1095	28	50	3	25	47	1020	2.34643	0.04771	2.60426	8.93420	0.75912	0.1317490397	0.7138846116	1.27854	0.81189	19	24	2	9	26	1	-0.73089	0.04879
70	87433001	Pulmonary emphysema (disorder)	48	55680006	Drug overdose	1095	17	50	1	16	49	1029	1.28824	0.00792	1.31250	10.09910	0.17058	0.5509143231	1.0000000000	0.77626	0.17116	9	24	0	8	26	1	-3.29584	-2.19722
69	233604007	Pneumonia	48	55680006	Drug overdose	1095	7	50	2	5	48	1040	6.25714	0.09224	8.66667	45.81642	1.63939	0.0370543818	0.3610026234	0.31963	1.18482	3	24	1	4	26	1	-0.07696	-0.22314
68	26929004	Alzheimer's disease (disorder)	48	55680006	Drug overdose	1095	23	50	2	21	48	1024	1.90435	0.02898	2.03175	8.91644	0.46296	0.2830902807	0.9659403678	1.05023	0.54918	15	24	2	8	26	0	2.56495	2.14007
67	403191005	Second degree burn	48	55680006	Drug overdose	1095	49	50	3	46	47	999	1.34082	0.01614	1.38622	4.62077	0.41586	0.4859670049	1.0000000000	2.23744	0.30515	23	24	1	26	26	2	0.57982	0.53900
65	239873007	Osteoarthritis of knee	48	55680006	Drug overdose	1095	57	50	1	56	49	989	0.38421	-0.03156	0.36042	2.65809	0.04887	0.5113550241	1.0000000000	2.60274	-0.84909	30	24	0	27	26	1	-3.29584	-3.33220
64	444448004	Injury of medial collateral ligament of knee	48	55680006	Drug overdose	1095	32	50	2	30	48	1015	1.36875	0.01399	1.40972	6.07228	0.32728	0.6541004624	1.0000000000	1.46119	0.28561	17	24	2	15	26	0	2.56495	2.25129
63	68496003	Polyp of colon	48	55680006	Drug overdose	1095	91	50	7	84	43	961	1.68462	0.04508	1.86240	4.26837	0.81262	0.1811355664	0.8137869183	4.15525	0.63396	43	24	2	48	26	5	0.74040	0.75266
62	185086009	Chronic obstructive bronchitis (disorder)	48	55680006	Drug overdose	1095	6	50	1	5	49	1040	3.65000	0.04303	4.24490	37.03214	0.48658	0.2450339970	0.9133257124	0.27397	0.65067	4	24	1	2	26	0	3.21888	1.60944
61	198992004	Antepartum eclampsia	48	55680006	Drug overdose	1095	96	50	8	88	42	957	1.82500	0.05594	2.07143	4.55035	0.94296	0.0726125795	0.5329374774	4.38356	0.74136	96	24	8	0	26	0	1.38629	2.56495
60	301011002	Escherichia coli urinary tract infection	48	55680006	Drug overdose	1095	92	50	5	87	45	958	1.19022	0.01260	1.22350	3.16249	0.47335	0.6034003879	1.0000000000	4.20091	0.20620	85	24	5	7	26	0	1.75786	2.89037
59	262574004	Bullet wound	48	55680006	Drug overdose	1095	20	50	0	20	50	1025	0.00000	-0.02984	0.00000	0.00000	0.00000	1.0000000000	1.0000000000	0.91324	-0.93602	9	24	0	11	26	0	0.00000	0.00000
58	239720000	Tear of meniscus of knee	48	55680006	Drug overdose	1095	20	50	1	19	49	1026	1.09500	0.00283	1.10204	8.40115	0.14456	0.6106022951	1.0000000000	0.91324	0.06398	10	24	0	10	26	1	-3.29584	-2.39790
57	192127007	Child attention deficit disorder	48	55680006	Drug overdose	1095	76	50	1	75	49	970	0.28816	-0.04252	0.26395	1.93816	0.03595	0.2499703292	0.9133257124	3.47032	-1.16038	24	24	1	52	26	0	3.21888	3.21888
56	92691004	Carcinoma in situ of prostate (disorder)	48	55680006	Drug overdose	1095	23	50	2	21	48	1024	1.90435	0.02898	2.03175	8.91644	0.46296	0.2830902807	0.9659403678	1.05023	0.54918	0	24	0	23	26	2	-2.63906	-2.52573
55	126906006	Neoplasm of prostate	48	55680006	Drug overdose	1095	24	50	3	21	47	1024	2.73750	0.05689	3.11246	10.80450	0.89661	0.0923262184	0.6006517651	1.09589	0.93244	0	24	0	24	26	3	-2.26868	-2.19722
54	5602001	Opioid abuse (disorder)	48	55680006	Drug overdose	1095	7	50	1	6	49	1039	3.12857	0.03735	3.53401	29.92640	0.41733	0.2796972662	0.9574808819	0.31963	0.59986	0	24	0	7	26	1	-3.29584	-2.07944
53	7200002	Alcoholism	48	55680006	Drug overdose	1095	5	50	1	4	49	1041	4.38000	0.05007	5.31122	48.41367	0.58267	0.2087375545	0.8610424124	0.22831	0.70332	0	24	0	5	26	1	-3.29584	-1.79176
52	124171000119105	Chronic intractable migraine without aura	48	55680006	Drug overdose	1095	51	50	36	15	14	1030	15.45882	0.69903	176.57143	393.19423	79.29280	0.0000000000	0.0000000000	2.32877	3.47447	21	24	15	30	26	21	0.14989	-0.01183
50	446096008	Perennial allergic rhinitis	48	55680006	Drug overdose	1095	26	50	2	24	48	1021	1.68462	0.02335	1.77257	7.71899	0.40705	0.3349152888	1.0000000000	1.18721	0.45587	14	24	1	12	26	1	-0.07696	0.14310
49	88805009	Chronic congestive heart failure (disorder)	48	55680006	Drug overdose	1095	10	50	2	8	48	1037	4.38000	0.07098	5.40104	26.12440	1.11663	0.0727558031	0.5335425563	0.45662	1.04234	5	24	0	5	26	2	-2.63906	-1.25276
47	359817006	Closed fracture of hip	48	55680006	Drug overdose	1095	29	50	3	26	47	1019	2.26552	0.04566	2.50164	8.56160	0.73096	0.1424192971	0.7404942507	1.32420	0.78327	11	24	1	18	26	2	0.57982	0.18232
46	62564004	Concussion with loss of consciousness	48	55680006	Drug overdose	1095	67	50	7	60	43	985	2.28806	0.07193	2.67248	6.19207	1.15343	0.0283723935	0.3105397383	3.05936	0.97875	36	24	4	31	26	3	-0.32277	-0.12516
45	263102004	Fracture subluxation of wrist	48	55680006	Drug overdose	1095	109	50	6	103	44	942	1.20550	0.01495	1.24713	2.99735	0.51890	0.6263052464	1.0000000000	4.97717	0.22789	51	24	4	58	26	2	-0.69315	-0.78016
44	58150001	Fracture of clavicle	48	55680006	Drug overdose	1095	112	50	7	105	43	940	1.36875	0.02723	1.45736	3.32183	0.63938	0.3408017677	1.0000000000	5.11416	0.38785	55	24	4	57	26	3	-0.32277	-0.30449
43	307731004	Injury of tendon of the rotator cuff of shoulder	48	55680006	Drug overdose	1095	51	50	1	50	49	995	0.42941	-0.02759	0.40612	3.00128	0.05496	0.7255777212	1.0000000000	2.32877	-0.73499	26	24	0	25	26	1	-3.29584	-3.25810
42	16114001	Fracture of ankle	48	55680006	Drug overdose	1095	108	50	7	101	43	944	1.41944	0.03035	1.52153	3.47110	0.66695	0.3273137515	1.0000000000	4.93151	0.43160	48	24	4	60	26	3	-0.32277	-0.47957
41	283385000	Laceration of thigh	48	55680006	Drug overdose	1095	105	50	4	101	46	944	0.83429	-0.01180	0.81274	2.30427	0.28666	1.0000000000	1.0000000000	4.79452	-0.21276	50	24	1	55	26	3	0.95019	0.96999
40	428251008	History of appendectomy	48	55680006	Drug overdose	1095	51	50	3	48	47	997	1.28824	0.01394	1.32580	4.41301	0.39831	0.5024556072	1.0000000000	2.32877	0.26501	27	24	2	24	26	1	-0.73089	-0.54473
39	74400008	Appendicitis	48	55680006	Drug overdose	1095	51	50	3	48	47	997	1.28824	0.01394	1.32580	4.41301	0.39831	0.5024556072	1.0000000000	2.32877	0.26501	27	24	2	24	26	1	-0.73089	-0.54473
38	398254007	Preeclampsia	48	55680006	Drug overdose	1095	101	50	4	97	46	948	0.86733	-0.00925	0.84984	2.41125	0.29953	1.0000000000	1.0000000000	4.61187	-0.16655	101	24	4	0	26	0	1.94591	3.26767
37	38822007	Cystitis	48	55680006	Drug overdose	1095	71	50	5	66	45	979	1.54225	0.03123	1.64815	4.29143	0.63298	0.3686011696	1.0000000000	3.24201	0.50021	68	24	4	3	26	1	-1.34993	1.50408
35	19169002	Miscarriage in first trimester	48	55680006	Drug overdose	1095	174	50	16	158	34	887	2.01379	0.09639	2.64185	4.90038	1.42425	0.0043786589	0.0821279219	7.94521	0.92635	174	24	16	0	26	0	0.91629	2.47444
33	429007001	History of cardiac arrest (situation)	48	55680006	Drug overdose	1095	42	50	3	39	47	1006	1.56429	0.02465	1.64648	5.52245	0.49089	0.4349013606	1.0000000000	1.91781	0.45511	24	24	2	18	26	1	-0.73089	-0.37949
32	410429000	Cardiac Arrest	48	55680006	Drug overdose	1095	42	50	3	39	47	1006	1.56429	0.02465	1.64648	5.52245	0.49089	0.4349013606	1.0000000000	1.91781	0.45511	24	24	2	18	26	1	-0.73089	-0.37949
31	230690007	Stroke	48	55680006	Drug overdose	1095	62	50	2	60	48	985	0.70645	-0.01573	0.68403	2.88215	0.16234	1.0000000000	1.0000000000	2.83105	-0.35278	32	24	0	30	26	2	-2.63906	-2.77259
30	399211009	History of myocardial infarction (situation)	48	55680006	Drug overdose	1095	31	50	0	31	50	1014	0.00000	-0.03734	0.00000	0.00000	0.00000	0.3946176975	1.0000000000	1.41553	-1.27234	2	24	0	29	26	0	0.00000	0.00000
29	22298006	Myocardial Infarction	48	55680006	Drug overdose	1095	31	50	0	31	50	1014	0.00000	-0.03734	0.00000	0.00000	0.00000	0.3946176975	1.0000000000	1.41553	-1.27234	2	24	0	29	26	0	0.00000	0.00000
28	53741008	Coronary Heart Disease	48	55680006	Drug overdose	1095	80	50	3	77	47	968	0.82125	-0.01098	0.80243	2.63764	0.24412	1.0000000000	1.0000000000	3.65297	-0.21815	24	24	2	56	26	1	-0.73089	-1.47810
27	408512008	Body mass index 40+ - severely obese (finding)	48	55680006	Drug overdose	1095	97	50	6	91	44	954	1.35464	0.02418	1.42957	3.44536	0.59317	0.4398579735	1.0000000000	4.42922	0.36661	67	24	3	30	26	3	-0.07146	0.75199
26	33737001	Fracture of rib	48	55680006	Drug overdose	1095	54	50	1	53	49	992	0.40556	-0.02961	0.38198	2.81980	0.05174	0.5087761081	1.0000000000	2.46575	-0.79317	32	24	0	22	26	1	-3.29584	-3.13549
25	284551006	Laceration of foot	48	55680006	Drug overdose	1095	118	50	6	112	44	933	1.11356	0.00863	1.13596	2.72555	0.47345	0.8141363817	1.0000000000	5.38813	0.13196	53	24	3	65	26	3	-0.07146	-0.19416
24	162864005	Body mass index 30+ - obesity (finding)	48	55680006	Drug overdose	1095	439	50	24	415	26	630	1.19727	0.03530	1.40130	2.47409	0.79368	0.2420109308	0.9105752038	20.04566	0.24841	226	24	10	213	26	14	0.17395	0.37535
23	36971009	Sinusitis (disorder)	48	55680006	Drug overdose	1095	190	50	9	181	41	864	1.03737	0.00375	1.04784	2.19411	0.50041	0.8495886720	1.0000000000	8.67580	0.04755	84	24	1	106	26	8	1.77196	1.78589
22	70704007	Sprain of wrist	48	55680006	Drug overdose	1095	195	50	16	179	34	866	1.79692	0.08114	2.27670	4.21367	1.23013	0.0125451766	0.1787687669	8.90411	0.77944	90	24	10	105	26	6	-0.45020	-0.61519
21	15777000	Prediabetes	48	55680006	Drug overdose	1095	333	50	22	311	28	734	1.44685	0.06461	1.85439	3.29196	1.04459	0.0401865983	0.3842679298	15.20548	0.50515	159	24	11	174	26	11	-0.05557	-0.08456
20	80394007	Hyperglycemia (disorder)	48	55680006	Drug overdose	1095	55	50	5	50	45	995	1.99091	0.04985	2.21111	5.81309	0.84103	0.1003122054	0.6275578005	2.51142	0.77291	23	24	3	32	26	2	-0.44183	-0.67373
19	237602007	Metabolic syndrome X (disorder)	48	55680006	Drug overdose	1095	64	50	5	59	45	986	1.71094	0.03875	1.85687	4.85228	0.71059	0.2078241417	0.8605095829	2.92237	0.61324	28	24	3	36	26	2	-0.44183	-0.60906
18	302870006	Hypertriglyceridemia (disorder)	48	55680006	Drug overdose	1095	64	50	5	59	45	986	1.71094	0.03875	1.85687	4.85228	0.71059	0.2078241417	0.8605095829	2.92237	0.61324	28	24	3	36	26	2	-0.44183	-0.60906
17	368581000119106	Neuropathy due to type 2 diabetes mellitus (disorder)	48	55680006	Drug overdose	1095	28	50	1	27	49	1018	0.78214	-0.00772	0.76946	5.77969	0.10244	1.0000000000	1.0000000000	1.27854	-0.18811	7	24	1	21	26	0	3.21888	2.07944
16	44054006	Diabetes	48	55680006	Drug overdose	1095	68	50	5	63	45	982	1.61029	0.03435	1.73192	4.51606	0.66420	0.2311002904	0.8905172734	3.10502	0.54757	29	24	3	39	26	2	-0.44183	-0.65330
15	40055000	Chronic sinusitis (disorder)	48	55680006	Drug overdose	1095	216	50	8	208	42	837	0.81111	-0.02048	0.76648	1.65737	0.35448	0.5881656208	1.0000000000	9.86301	-0.27143	104	24	2	112	26	6	0.89097	0.99137
14	10509002	Acute bronchitis (disorder)	48	55680006	Drug overdose	1095	863	50	46	817	4	228	1.16732	0.07059	3.20930	9.00923	1.14323	0.0198974541	0.2473935583	39.40639	0.21808	418	24	21	445	26	25	0.04919	0.10612
13	370247008	Facial laceration	48	55680006	Drug overdose	1095	109	50	7	102	43	943	1.40642	0.02956	1.50502	3.43266	0.65986	0.3303944011	1.0000000000	4.97717	0.42054	55	24	4	54	26	3	-0.32277	-0.25320
12	65966004	Fracture of forearm	48	55680006	Drug overdose	1095	123	50	4	119	46	926	0.71220	-0.02239	0.67665	1.91321	0.23932	0.6459328598	1.0000000000	5.61644	-0.40413	55	24	2	68	26	2	-0.07411	-0.20544
11	38341003	Hypertension	48	55680006	Drug overdose	1095	278	50	17	261	33	784	1.33921	0.04328	1.54743	2.82428	0.84784	0.1820019692	0.8150956220	12.69406	0.39445	131	24	10	147	26	7	-0.32682	-0.44487
10	62106007	Concussion with no loss of consciousness	48	55680006	Drug overdose	1095	206	50	12	194	38	851	1.27573	0.02903	1.38524	2.70028	0.71063	0.3538380464	1.0000000000	9.40639	0.32104	96	24	4	110	26	8	0.49899	0.52763
9	44465007	Sprain of ankle	48	55680006	Drug overdose	1095	362	50	20	342	30	703	1.20994	0.03227	1.37037	2.44842	0.76699	0.2851898674	0.9659403678	16.52968	0.26059	185	24	9	177	26	11	0.08626	0.23209
8	233678006	Childhood asthma	48	55680006	Drug overdose	1095	45	50	2	43	48	1002	0.97333	-0.00121	0.97093	4.12697	0.22843	1.0000000000	1.0000000000	2.05479	-0.02611	25	24	1	20	26	1	-0.07696	0.21357
7	75498004	Acute bacterial sinusitis (disorder)	48	55680006	Drug overdose	1095	187	50	3	184	47	861	0.35134	-0.06439	0.29868	0.97003	0.09197	0.0330311937	0.3359766140	8.53881	-1.25381	89	24	0	98	26	3	-2.26868	-3.51651
6	39848009	Whiplash injury to neck	48	55680006	Drug overdose	1095	182	50	4	178	46	867	0.48132	-0.05066	0.42355	1.19156	0.15055	0.1181900419	0.6820987428	8.31050	-0.89693	92	24	2	90	26	2	-0.07411	0.02151
5	284549007	Laceration of hand	48	55680006	Drug overdose	1095	104	50	7	97	43	948	1.47404	0.03359	1.59099	3.63296	0.69674	0.3170833411	1.0000000000	4.74886	0.47672	54	24	3	50	26	4	0.18232	0.34175
4	195662009	Acute viral pharyngitis (disorder)	48	55680006	Drug overdose	1095	890	50	46	844	4	201	1.13191	0.06012	2.73874	7.69613	0.97461	0.0609125326	0.4820786466	40.63927	0.17472	430	24	21	460	26	25	0.04919	0.10167
3	65363002	Otitis media	48	55680006	Drug overdose	1095	580	50	23	557	27	488	0.86845	-0.03054	0.74633	1.31874	0.42238	0.3150379405	1.0000000000	26.48402	-0.19556	277	24	13	303	26	10	-0.23497	-0.33869
115	36923009	Major depression  single episode	22	70704007	Sprain of wrist	1095	6	195	0	6	195	894	0.00000	-0.03455	0.00000	0.00000	0.00000	0.5981727712	1.0000000000	1.06849	-1.04858	3	90	0	3	105	0	0.00000	0.00000
1	444814009	Viral sinusitis (disorder)	48	55680006	Drug overdose	1095	993	50	50	943	0	102	1.10272	0.07011	0.00000	0.00000	0.00000	0.0111778707	0.1657421438	45.34247	0.13816	478	24	24	515	26	26	0.00000	0.00522
113	443165006	Pathological fracture due to osteoporosis (disorder)	22	70704007	Sprain of wrist	1095	10	195	1	9	194	891	0.56154	-0.01959	0.51031	4.05145	0.06428	1.0000000000	1.0000000000	1.78082	-0.47551	7	90	1	3	105	0	4.51086	2.07944
112	49436004	Atrial Fibrillation	22	70704007	Sprain of wrist	1095	35	195	5	30	190	870	0.80220	-0.01673	0.76316	1.99249	0.29230	0.8218154521	1.0000000000	6.23288	-0.26961	9	90	2	26	105	3	0.24512	-0.56394
111	235919008	Cholelithiasis	22	70704007	Sprain of wrist	1095	9	195	2	7	193	893	1.24786	0.01050	1.32198	6.41273	0.27253	0.6656076641	1.0000000000	1.60274	0.20493	7	90	2	2	105	0	3.82864	1.50408
110	65275009	Acute Cholecystitis	22	70704007	Sprain of wrist	1095	9	195	2	7	193	893	1.24786	0.01050	1.32198	6.41273	0.27253	0.6656076641	1.0000000000	1.60274	0.20493	7	90	2	2	105	0	3.82864	1.50408
109	90560007	Gout	22	70704007	Sprain of wrist	1095	4	195	0	4	195	896	0.00000	-0.02818	0.00000	0.00000	0.00000	1.0000000000	1.0000000000	0.71233	-0.77596	0	90	0	4	105	0	0.00000	0.00000
108	40930008	Hypothyroidism (disorder)	22	70704007	Sprain of wrist	1095	13	195	3	10	192	890	1.29586	0.01510	1.39062	5.10057	0.37914	0.7125082403	1.0000000000	2.31507	0.27096	11	90	2	2	105	1	-0.83480	0.77319
107	40275004	Contact dermatitis	22	70704007	Sprain of wrist	1095	18	195	2	16	193	884	0.62393	-0.02263	0.57254	2.51061	0.13057	0.7549055828	1.0000000000	3.20548	-0.48731	9	90	1	9	105	1	-0.15258	0.00000
106	24079001	Atopic dermatitis	22	70704007	Sprain of wrist	1095	20	195	2	18	193	882	0.56154	-0.02784	0.50777	2.20655	0.11685	0.5554584812	1.0000000000	3.56164	-0.60459	13	90	1	7	105	1	-0.15258	0.55962
105	363406005	Malignant tumor of colon	22	70704007	Sprain of wrist	1095	6	195	0	6	195	894	0.00000	-0.03455	0.00000	0.00000	0.00000	0.5981727712	1.0000000000	1.06849	-1.04858	4	90	0	2	105	0	0.00000	0.00000
104	367498001	Seasonal allergic rhinitis	22	70704007	Sprain of wrist	1095	20	195	1	19	194	881	0.28077	-0.04566	0.23901	1.79614	0.03181	0.2318280185	0.8920331834	3.56164	-1.18955	9	90	1	11	105	0	4.51086	2.30259
102	90781000119102	Microalbuminuria due to type 2 diabetes mellitus (disorder)	22	70704007	Sprain of wrist	1095	6	195	2	4	193	896	1.87179	0.03012	2.32124	12.76357	0.42215	0.2907921133	0.9768039197	1.06849	0.53638	3	90	1	3	105	1	-0.15258	0.00000
101	433144002	Chronic kidney disease stage 3 (disorder)	22	70704007	Sprain of wrist	1095	3	195	2	1	193	899	3.74359	0.06694	9.31606	103.25787	0.84051	0.0835859286	0.5700988979	0.53425	0.96743	1	90	1	2	105	1	-0.15258	-0.40547
100	161622006	History of lower limb amputation (situation)	22	70704007	Sprain of wrist	1095	1	195	0	1	195	899	0.00000	-0.01407	0.00000	0.00000	0.00000	1.0000000000	1.0000000000	0.17808	-0.23644	0	90	0	1	105	0	0.00000	0.00000
99	30832001	Rupture of patellar tendon	22	70704007	Sprain of wrist	1095	23	195	5	18	190	882	1.22074	0.01505	1.28947	3.51616	0.47289	0.5843765988	1.0000000000	4.09589	0.23563	14	90	3	9	105	2	-0.54569	0.02985
98	1551000119108	Nonproliferative diabetic retinopathy due to type 2 diabetes mellitus (disorder)	22	70704007	Sprain of wrist	1095	12	195	2	10	193	890	0.93590	-0.00314	0.92228	4.24284	0.20048	1.0000000000	1.0000000000	2.13699	-0.06442	7	90	0	5	105	2	-3.97968	-1.25276
97	403192003	Third degree burn	22	70704007	Sprain of wrist	1095	8	195	0	8	195	892	0.00000	-0.03993	0.00000	0.00000	0.00000	0.3633905491	1.0000000000	1.42466	-1.27778	3	90	0	5	105	0	0.00000	0.00000
96	283371005	Laceration of forearm	22	70704007	Sprain of wrist	1095	75	195	18	57	177	843	1.34769	0.04389	1.50401	2.61765	0.86416	0.1588384740	0.7768414475	13.35616	0.40433	39	90	11	36	105	7	-0.55536	-0.30116
95	84757009	Epilepsy	22	70704007	Sprain of wrist	1095	30	195	2	28	193	872	0.37436	-0.04888	0.32272	1.36621	0.07623	0.1443232646	0.7404942507	5.34247	-1.08008	13	90	0	17	105	2	-3.97968	-2.25129
94	703151001	History of single seizure (situation)	22	70704007	Sprain of wrist	1095	39	195	3	36	192	864	0.43195	-0.05081	0.37500	1.23035	0.11430	0.1323357231	0.7140816678	6.94521	-0.99008	14	90	0	25	105	3	-3.58352	-2.23359
93	128613002	Seizure disorder	22	70704007	Sprain of wrist	1095	39	195	3	36	192	864	0.43195	-0.05081	0.37500	1.23035	0.11430	0.1323357231	0.7140816678	6.94521	-0.99008	14	90	0	25	105	3	-3.58352	-2.23359
91	64859006	Osteoporosis (disorder)	22	70704007	Sprain of wrist	1095	37	195	6	31	189	869	0.91060	-0.00778	0.88991	2.16317	0.36610	1.0000000000	1.0000000000	6.58904	-0.11656	24	90	3	13	105	3	-0.14953	0.52325
89	47693006	Rupture of appendix	22	70704007	Sprain of wrist	1095	20	195	4	16	191	884	1.12308	0.00781	1.15707	3.49960	0.38256	0.7688384102	1.0000000000	3.56164	0.13237	10	90	3	10	105	1	-1.22945	-0.93156
88	197927001	Recurrent urinary tract infection	22	70704007	Sprain of wrist	1095	8	195	1	7	194	893	0.70192	-0.01190	0.65758	5.37551	0.08044	1.0000000000	1.0000000000	1.42466	-0.27778	8	90	1	0	105	0	4.51086	2.19722
86	713197008	Recurrent rectal polyp	22	70704007	Sprain of wrist	1095	22	195	2	20	193	880	0.51049	-0.03263	0.45596	1.96702	0.10569	0.4019389946	1.0000000000	3.91781	-0.71305	12	90	1	10	105	1	-0.15258	0.16705
85	241929008	Acute allergic reaction	22	70704007	Sprain of wrist	1095	47	195	6	41	189	859	0.71686	-0.02791	0.66512	1.58925	0.27836	0.4386408001	1.0000000000	8.36986	-0.42067	25	90	3	22	105	3	-0.14953	0.11333
83	110030002	Concussion injury of brain	22	70704007	Sprain of wrist	1095	7	195	3	4	192	896	2.40659	0.05252	3.50000	15.76520	0.77703	0.1118332464	0.6583985495	1.24658	0.83227	1	90	0	6	105	3	-3.58352	-1.09861
82	94260004	Secondary malignant neoplasm of colon	22	70704007	Sprain of wrist	1095	4	195	1	3	194	897	1.40385	0.01138	1.54124	14.89572	0.15947	0.5441764707	1.0000000000	0.71233	0.22404	2	90	0	2	105	1	-4.66344	-1.09861
81	236077008	Protracted diarrhea	22	70704007	Sprain of wrist	1095	4	195	1	3	194	897	1.40385	0.01138	1.54124	14.89572	0.15947	0.5441764707	1.0000000000	0.71233	0.22404	2	90	0	2	105	1	-4.66344	-1.09861
80	6072007	Bleeding from anus	22	70704007	Sprain of wrist	1095	4	195	1	3	194	897	1.40385	0.01138	1.54124	14.89572	0.15947	0.5441764707	1.0000000000	0.71233	0.22404	2	90	0	2	105	1	-4.66344	-1.09861
79	45816000	Pyelonephritis	22	70704007	Sprain of wrist	1095	1	195	0	1	195	899	0.00000	-0.01407	0.00000	0.00000	0.00000	1.0000000000	1.0000000000	0.17808	-0.23644	1	90	0	0	105	0	0.00000	0.00000
78	239872002	Osteoarthritis of hip	22	70704007	Sprain of wrist	1095	21	195	3	18	192	882	0.80220	-0.01287	0.76562	2.62510	0.22330	1.0000000000	1.0000000000	3.73973	-0.24480	13	90	2	8	105	1	-0.83480	-0.18232
76	127013003	Diabetic renal disease (disorder)	22	70704007	Sprain of wrist	1095	28	195	7	21	188	879	1.40385	0.03045	1.55851	3.71920	0.65309	0.3170567051	1.0000000000	4.98630	0.41834	10	90	2	18	105	5	0.73760	0.26570
75	431855005	Chronic kidney disease stage 1 (disorder)	22	70704007	Sprain of wrist	1095	28	195	7	21	188	879	1.40385	0.03045	1.55851	3.71920	0.65309	0.3170567051	1.0000000000	4.98630	0.41834	10	90	2	18	105	5	0.73760	0.26570
73	196416002	Impacted molars	22	70704007	Sprain of wrist	1095	49	195	14	35	181	865	1.60440	0.06089	1.91160	3.62592	1.00781	0.0547370010	0.4520620234	8.72603	0.62504	25	90	8	24	105	6	-0.41224	-0.19237
72	35999006	Blighted ovum	22	70704007	Sprain of wrist	1095	53	195	7	46	188	854	0.74165	-0.02712	0.69126	1.55496	0.30730	0.4629853740	1.0000000000	9.43836	-0.38382	53	90	7	0	105	0	2.62880	2.14843
71	201834006	Localized  primary osteoarthritis of the hand	22	70704007	Sprain of wrist	1095	28	195	3	25	192	875	0.60165	-0.03004	0.54687	1.82973	0.16345	0.4539241673	1.0000000000	4.98630	-0.58166	19	90	2	9	105	1	-0.83480	0.04879
70	87433001	Pulmonary emphysema (disorder)	22	70704007	Sprain of wrist	1095	17	195	4	13	191	887	1.32127	0.01878	1.42892	4.43011	0.46089	0.5233316491	1.0000000000	3.02740	0.31208	9	90	2	8	105	2	-0.15104	0.09531
69	233604007	Pneumonia	22	70704007	Sprain of wrist	1095	7	195	1	6	194	894	0.80220	-0.00739	0.76804	6.41589	0.09194	1.0000000000	1.0000000000	1.24658	-0.16773	3	90	1	4	105	0	4.51086	1.38629
68	26929004	Alzheimer's disease (disorder)	22	70704007	Sprain of wrist	1095	23	195	3	20	192	880	0.73244	-0.01824	0.68750	2.33684	0.20226	0.7832707957	1.0000000000	4.09589	-0.34933	15	90	2	8	105	1	-0.83480	-0.05716
67	403191005	Second degree burn	22	70704007	Sprain of wrist	1095	49	195	10	39	185	861	1.14600	0.01471	1.19335	2.43370	0.58515	0.5713447212	1.0000000000	8.72603	0.17758	23	90	4	26	105	6	0.23923	0.23557
65	239873007	Osteoarthritis of knee	22	70704007	Sprain of wrist	1095	57	195	15	42	180	858	1.47773	0.05211	1.70238	3.13640	0.92402	0.1071231569	0.6440596376	10.15068	0.52094	30	90	6	27	105	9	0.23361	0.40547
64	444448004	Injury of medial collateral ligament of knee	22	70704007	Sprain of wrist	1095	32	195	6	26	189	874	1.05288	0.00427	1.06716	2.62874	0.43322	0.8169350280	1.0000000000	5.69863	0.06349	17	90	2	15	105	4	0.52359	0.69315
63	68496003	Polyp of colon	22	70704007	Sprain of wrist	1095	91	195	14	77	181	823	0.86391	-0.01907	0.82672	1.49401	0.45747	0.6674202899	1.0000000000	16.20548	-0.19791	43	90	4	48	105	10	0.71465	0.70600
62	185086009	Chronic obstructive bronchitis (disorder)	22	70704007	Sprain of wrist	1095	6	195	1	5	194	895	0.93590	-0.00221	0.92268	7.94201	0.10719	1.0000000000	1.0000000000	1.06849	-0.04858	4	90	1	2	105	0	4.51086	1.60944
60	301011002	Escherichia coli urinary tract infection	22	70704007	Sprain of wrist	1095	92	195	18	74	177	826	1.09866	0.01391	1.13514	1.94804	0.66145	0.6691544353	1.0000000000	16.38356	0.12828	85	90	17	7	105	1	-2.82382	-0.28768
59	262574004	Bullet wound	22	70704007	Sprain of wrist	1095	20	195	5	15	190	885	1.40385	0.02564	1.55263	4.32380	0.55753	0.3791927785	1.0000000000	3.56164	0.39541	9	90	2	11	105	3	0.24512	0.16430
58	239720000	Tear of meniscus of knee	22	70704007	Sprain of wrist	1095	20	195	3	17	192	883	0.84231	-0.01001	0.81158	2.79684	0.23550	1.0000000000	1.0000000000	3.56164	-0.18955	10	90	1	10	105	2	0.53118	0.60614
57	192127007	Child attention deficit disorder	22	70704007	Sprain of wrist	1095	76	195	8	68	187	832	0.59109	-0.05198	0.52344	1.10762	0.24736	0.0889670567	0.5906415940	13.53425	-0.69146	24	90	4	52	105	4	-0.14805	-0.69315
56	92691004	Carcinoma in situ of prostate (disorder)	22	70704007	Sprain of wrist	1095	23	195	7	16	188	884	1.70903	0.04834	2.05718	5.07011	0.83469	0.1613482742	0.7850970902	4.09589	0.65067	0	90	0	23	105	7	-2.77259	-1.45529
54	5602001	Opioid abuse (disorder)	22	70704007	Sprain of wrist	1095	7	195	3	4	192	896	2.40659	0.05252	3.50000	15.76520	0.77703	0.1118332464	0.6583985495	1.24658	0.83227	0	90	0	7	105	3	-3.58352	-1.20397
53	7200002	Alcoholism	22	70704007	Sprain of wrist	1095	5	195	1	4	194	896	1.12308	0.00388	1.15464	10.38733	0.12835	1.0000000000	1.0000000000	0.89041	0.08130	0	90	0	5	105	1	-4.66344	-1.79176
52	124171000119105	Chronic intractable migraine without aura	22	70704007	Sprain of wrist	1095	51	195	13	38	182	862	1.43137	0.04438	1.62030	3.10292	0.84610	0.1867339146	0.8181443419	9.08219	0.47362	21	90	6	30	105	7	0.00000	-0.16093
50	446096008	Perennial allergic rhinitis	22	70704007	Sprain of wrist	1095	26	195	4	22	191	878	0.86391	-0.00988	0.83579	2.45324	0.28475	1.0000000000	1.0000000000	4.63014	-0.17124	14	90	3	12	105	1	-1.22945	-0.83035
49	88805009	Chronic congestive heart failure (disorder)	22	70704007	Sprain of wrist	1095	10	195	3	7	192	893	1.68462	0.03059	1.99330	7.77766	0.51086	0.3961505290	1.0000000000	1.78082	0.52449	5	90	0	5	105	3	-3.58352	-0.98083
47	359817006	Closed fracture of hip	22	70704007	Sprain of wrist	1095	29	195	11	18	184	882	2.12997	0.08675	2.92935	6.30604	1.36077	0.0106912983	0.1612512303	5.16438	0.96101	11	90	3	18	105	8	0.78604	0.36179
46	62564004	Concussion with loss of consciousness	22	70704007	Sprain of wrist	1095	67	195	8	59	187	841	0.67049	-0.03916	0.60981	1.29776	0.28654	0.2481848686	0.9133257124	11.93151	-0.52289	36	90	5	31	105	3	-0.63908	-0.32361
45	263102004	Fracture subluxation of wrist	22	70704007	Sprain of wrist	1095	109	195	22	87	173	813	1.13338	0.02064	1.18836	1.95082	0.72390	0.5095498986	1.0000000000	19.41096	0.17229	51	90	12	58	105	10	-0.30228	-0.25869
44	58150001	Fracture of clavicle	22	70704007	Sprain of wrist	1095	112	195	17	95	178	805	0.85234	-0.02320	0.80928	1.39023	0.47110	0.5152351888	1.0000000000	19.94521	-0.21862	55	90	10	57	105	7	-0.47000	-0.34117
43	307731004	Injury of tendon of the rotator cuff of shoulder	22	70704007	Sprain of wrist	1095	51	195	11	40	184	860	1.21116	0.02172	1.28533	2.55236	0.64727	0.4554974429	1.0000000000	9.08219	0.25123	26	90	3	25	105	8	0.78604	0.85162
42	16114001	Fracture of ankle	22	70704007	Sprain of wrist	1095	108	195	18	90	177	810	0.93590	-0.00987	0.91525	1.55736	0.53789	0.8945497433	1.0000000000	19.23288	-0.09070	48	90	8	60	105	10	0.06318	0.00000
41	283385000	Laceration of thigh	22	70704007	Sprain of wrist	1095	105	195	24	81	171	819	1.28352	0.04298	1.41910	2.30349	0.87426	0.1787134993	0.8061393098	18.69863	0.34383	50	90	7	55	105	17	0.65799	0.65369
40	428251008	History of appendectomy	22	70704007	Sprain of wrist	1095	51	195	7	44	188	856	0.77074	-0.02359	0.72437	1.63325	0.32127	0.5737262590	1.0000000000	9.08219	-0.33374	27	90	5	24	105	2	-1.03524	-0.70865
39	74400008	Appendicitis	22	70704007	Sprain of wrist	1095	51	195	7	44	188	856	0.77074	-0.02359	0.72437	1.63325	0.32127	0.5737262590	1.0000000000	9.08219	-0.33374	27	90	5	24	105	2	-1.03524	-0.70865
38	398254007	Preeclampsia	22	70704007	Sprain of wrist	1095	101	195	25	76	170	824	1.38995	0.05786	1.59443	2.57957	0.98551	0.0746457611	0.5403135912	17.98630	0.45355	101	90	25	0	105	0	1.52606	1.61741
37	38822007	Cystitis	22	70704007	Sprain of wrist	1095	71	195	14	57	181	843	1.10726	0.01315	1.14394	2.09750	0.62388	0.6323415330	1.0000000000	12.64384	0.13671	68	90	12	3	105	2	-1.83962	0.98083
35	19169002	Miscarriage in first trimester	22	70704007	Sprain of wrist	1095	174	195	37	137	158	763	1.19408	0.03927	1.30421	1.94860	0.87292	0.1958258984	0.8340316782	30.98630	0.24855	174	90	37	0	105	0	1.23327	1.74094
33	429007001	History of cardiac arrest (situation)	22	70704007	Sprain of wrist	1095	42	195	7	35	188	865	0.93590	-0.00596	0.92021	2.10336	0.40259	1.0000000000	1.0000000000	7.47945	-0.08397	24	90	5	18	105	2	-1.03524	-0.54473
32	410429000	Cardiac Arrest	22	70704007	Sprain of wrist	1095	42	195	7	35	188	865	0.93590	-0.00596	0.92021	2.10336	0.40259	1.0000000000	1.0000000000	7.47945	-0.08397	24	90	5	18	105	2	-1.03524	-0.54473
30	399211009	History of myocardial infarction (situation)	22	70704007	Sprain of wrist	1095	31	195	10	21	185	879	1.81141	0.06447	2.26255	4.88438	1.04806	0.0520628437	0.4411270672	5.52055	0.75444	2	90	0	29	105	10	-2.44235	-1.36098
29	22298006	Myocardial Infarction	22	70704007	Sprain of wrist	1095	31	195	10	21	185	879	1.81141	0.06447	2.26255	4.88438	1.04806	0.0520628437	0.4411270672	5.52055	0.75444	2	90	0	29	105	10	-2.44235	-1.36098
28	53741008	Coronary Heart Disease	22	70704007	Sprain of wrist	1095	80	195	21	59	174	841	1.47404	0.06195	1.72034	2.90555	1.01859	0.0480192927	0.4214740129	14.24658	0.52902	24	90	5	56	105	16	0.92124	0.25378
27	408512008	Body mass index 40+ - severely obese (finding)	22	70704007	Sprain of wrist	1095	97	195	15	82	180	818	0.86836	-0.01910	0.83130	1.47522	0.46845	0.5809190295	1.0000000000	17.27397	-0.19172	67	90	11	30	105	4	-1.08783	-0.18125
26	33737001	Fracture of rib	22	70704007	Sprain of wrist	1095	54	195	10	44	185	856	1.03989	0.00423	1.05160	2.12779	0.51972	0.8559636863	1.0000000000	9.61644	0.05120	32	90	6	22	105	4	-0.53246	-0.02598
24	162864005	Body mass index 30+ - obesity (finding)	22	70704007	Sprain of wrist	1095	439	195	92	347	103	553	1.17680	0.06732	1.42346	1.94381	1.04241	0.0294675450	0.3166312918	78.17808	0.23213	226	90	44	213	105	48	-0.04559	0.12091
23	36971009	Sinusitis (disorder)	22	70704007	Sprain of wrist	1095	190	195	41	149	154	751	1.21174	0.04516	1.34189	1.97541	0.91154	0.1443364847	0.7404942507	33.83562	0.26983	84	90	17	106	105	24	0.15786	0.09243
21	15777000	Prediabetes	22	70704007	Sprain of wrist	1095	333	195	75	258	120	642	1.26473	0.08146	1.55523	2.14744	1.12634	0.0078335337	0.1290108046	59.30137	0.33381	159	90	33	174	105	42	0.06291	0.12338
20	80394007	Hyperglycemia (disorder)	22	70704007	Sprain of wrist	1095	55	195	18	37	177	863	1.83776	0.08968	2.37197	4.26190	1.32012	0.0058544307	0.1027803856	9.79452	0.81570	23	90	6	32	105	12	0.49532	0.27625
19	237602007	Metabolic syndrome X (disorder)	22	70704007	Sprain of wrist	1095	64	195	18	46	177	854	1.57933	0.06719	1.88799	3.33327	1.06937	0.0413120739	0.3885023469	11.39726	0.61598	28	90	6	36	105	12	0.49532	0.34831
18	302870006	Hypertriglyceridemia (disorder)	22	70704007	Sprain of wrist	1095	64	195	18	46	177	854	1.57933	0.06719	1.88799	3.33327	1.06937	0.0413120739	0.3885023469	11.39726	0.61598	28	90	6	36	105	12	0.49532	0.34831
17	368581000119106	Neuropathy due to type 2 diabetes mellitus (disorder)	22	70704007	Sprain of wrist	1095	28	195	6	22	189	878	1.20330	0.01533	1.26696	3.16733	0.50679	0.6165119980	1.0000000000	4.98630	0.22569	7	90	1	21	105	5	1.41982	0.43078
15	40055000	Chronic sinusitis (disorder)	22	70704007	Sprain of wrist	1095	216	195	44	172	151	728	1.14387	0.03320	1.23333	1.79384	0.84796	0.2757553130	0.9505356881	38.46575	0.18932	104	90	14	112	105	30	0.50126	0.57700
14	10509002	Acute bronchitis (disorder)	22	70704007	Sprain of wrist	1095	863	195	171	692	24	208	1.11267	0.10115	2.14162	3.37378	1.35946	0.0006690213	0.0179592330	153.68493	0.15308	418	90	78	445	105	93	0.01159	0.09461
13	370247008	Facial laceration	22	70704007	Sprain of wrist	1095	109	195	21	88	174	812	1.08186	0.01267	1.11364	1.84229	0.67318	0.6923139626	1.0000000000	19.41096	0.10816	55	90	10	54	105	11	-0.05311	0.09531
10	62106007	Concussion with no loss of consciousness	22	70704007	Sprain of wrist	1095	206	195	39	167	156	733	1.06311	0.01414	1.09731	1.61918	0.74364	0.6860001770	1.0000000000	36.68493	0.08601	96	90	15	110	105	24	0.26415	0.28169
9	44465007	Sprain of ankle	22	70704007	Sprain of wrist	1095	362	195	71	291	124	609	1.10136	0.03316	1.19829	1.65583	0.86717	0.2760773324	0.9505356881	64.46575	0.13726	185	90	31	177	105	40	0.07395	0.25027
8	233678006	Childhood asthma	22	70704007	Sprain of wrist	1095	45	195	5	40	190	860	0.62393	-0.03624	0.56579	1.45258	0.22038	0.3186673593	1.0000000000	8.01370	-0.58716	25	90	2	20	105	3	0.24512	0.56581
7	75498004	Acute bacterial sinusitis (disorder)	22	70704007	Sprain of wrist	1095	187	195	39	148	156	752	1.17112	0.03615	1.27027	1.88118	0.85775	0.2481930845	0.9133257124	33.30137	0.22173	89	90	10	98	105	29	0.77204	0.81564
6	39848009	Whiplash injury to neck	22	70704007	Sprain of wrist	1095	182	195	34	148	161	752	1.04903	0.01019	1.07302	1.61647	0.71228	0.7504468992	1.0000000000	32.41096	0.06703	92	90	19	90	105	15	-0.33253	-0.18082
5	284549007	Laceration of hand	22	70704007	Sprain of wrist	1095	104	195	31	73	164	827	1.67382	0.10161	2.14141	3.36627	1.36224	0.0017126432	0.0379635899	18.52055	0.71308	54	90	13	50	105	18	0.14797	0.31061
4	195662009	Acute viral pharyngitis (disorder)	22	70704007	Sprain of wrist	1095	890	195	170	720	25	180	1.07260	0.07041	1.70000	2.66741	1.08345	0.0197502958	0.2463827683	158.49315	0.10050	430	90	78	460	105	92	0.00584	0.08201
3	65363002	Otitis media	22	70704007	Sprain of wrist	1095	580	195	99	481	96	419	0.95849	-0.02051	0.89832	1.22455	0.65901	0.5269836668	1.0000000000	103.28767	-0.06057	277	90	43	303	105	56	0.07310	0.14915
1	444814009	Viral sinusitis (disorder)	22	70704007	Sprain of wrist	1095	993	195	185	808	10	92	1.04617	0.06705	2.10644	4.12422	1.07586	0.0288293528	0.3121289194	176.83562	0.06476	478	90	84	515	105	101	0.01548	0.09256
118	48333001	Burn injury(morphologic abnormality)	105	363406005	Malignant tumor of colon	1095	1	6	0	1	6	1088	0.00000	-0.00224	0.00000	0.00000	0.00000	1.0000000000	1.0000000000	0.00548	-0.00788	0	4	0	1	2	0	0.00000	0.00000
128	86849004	Suicidal deliberate poisoning	105	363406005	Malignant tumor of colon	1095	1	6	0	1	6	1088	0.00000	-0.00224	0.00000	0.00000	0.00000	1.0000000000	1.0000000000	0.00548	-0.00788	0	4	0	1	2	0	0.00000	0.00000
130	314994000	Metastasis from malignant tumor of prostate (disorder)	105	363406005	Malignant tumor of colon	1095	1	6	0	1	6	1088	0.00000	-0.00224	0.00000	0.00000	0.00000	1.0000000000	1.0000000000	0.00548	-0.00788	0	4	0	1	2	0	0.00000	0.00000
130	314994000	Metastasis from malignant tumor of prostate (disorder)	50	446096008	Perennial allergic rhinitis	1095	1	26	0	1	26	1068	0.00000	-0.00472	0.00000	0.00000	0.00000	1.0000000000	1.0000000000	0.02374	-0.03386	0	14	0	1	12	0	0.00000	0.00000
125	1734006	Fracture of the vertebral column with spinal cord injury	109	90560007	Gout	1095	5	4	0	5	4	1086	0.00000	-0.00410	0.00000	0.00000	0.00000	1.0000000000	1.0000000000	0.01826	-0.02611	3	0	0	2	4	0	0.00000	0.00000
118	48333001	Burn injury(morphologic abnormality)	109	90560007	Gout	1095	1	4	0	1	4	1090	0.00000	-0.00183	0.00000	0.00000	0.00000	1.0000000000	1.0000000000	0.00365	-0.00526	0	0	0	1	4	0	0.00000	0.00000
96	283371005	Laceration of forearm	109	90560007	Gout	1095	75	4	0	75	4	1016	0.00000	-0.01642	0.00000	0.00000	0.00000	1.0000000000	1.0000000000	0.27397	-0.34933	39	0	0	36	4	0	0.00000	0.00000
94	703151001	History of single seizure (situation)	109	90560007	Gout	1095	39	4	0	39	4	1052	0.00000	-0.01164	0.00000	0.00000	0.00000	1.0000000000	1.0000000000	0.14247	-0.19215	14	0	0	25	4	0	0.00000	0.00000
93	128613002	Seizure disorder	109	90560007	Gout	1095	39	4	0	39	4	1052	0.00000	-0.01164	0.00000	0.00000	0.00000	1.0000000000	1.0000000000	0.14247	-0.19215	14	0	0	25	4	0	0.00000	0.00000
86	713197008	Recurrent rectal polyp	109	90560007	Gout	1095	22	4	0	22	4	1069	0.00000	-0.00867	0.00000	0.00000	0.00000	1.0000000000	1.0000000000	0.08037	-0.11152	12	0	0	10	4	0	0.00000	0.00000
75	431855005	Chronic kidney disease stage 1 (disorder)	109	90560007	Gout	1095	28	4	0	28	4	1063	0.00000	-0.00981	0.00000	0.00000	0.00000	1.0000000000	1.0000000000	0.10228	-0.14049	10	0	0	18	4	0	0.00000	0.00000
64	444448004	Injury of medial collateral ligament of knee	109	90560007	Gout	1095	32	4	0	32	4	1059	0.00000	-0.01051	0.00000	0.00000	0.00000	1.0000000000	1.0000000000	0.11689	-0.15949	17	0	0	15	4	0	0.00000	0.00000
47	359817006	Closed fracture of hip	109	90560007	Gout	1095	29	4	0	29	4	1062	0.00000	-0.00999	0.00000	0.00000	0.00000	1.0000000000	1.0000000000	0.10594	-0.14527	11	0	0	18	4	0	0.00000	0.00000
44	58150001	Fracture of clavicle	109	90560007	Gout	1095	112	4	1	111	3	980	2.44420	0.02952	2.94294	28.53354	0.30353	0.3509385028	1.0000000000	0.40913	0.50519	55	0	0	57	4	1	-1.60944	-4.06044
43	307731004	Injury of tendon of the rotator cuff of shoulder	109	90560007	Gout	1095	51	4	0	51	4	1040	0.00000	-0.01338	0.00000	0.00000	0.00000	1.0000000000	1.0000000000	0.18630	-0.24647	26	0	0	25	4	0	0.00000	0.00000
42	16114001	Fracture of ankle	109	90560007	Gout	1095	108	4	0	108	4	983	0.00000	-0.02003	0.00000	0.00000	0.00000	1.0000000000	1.0000000000	0.39452	-0.47977	48	0	0	60	4	0	0.00000	0.00000
41	283385000	Laceration of thigh	109	90560007	Gout	1095	105	4	0	105	4	986	0.00000	-0.01972	0.00000	0.00000	0.00000	1.0000000000	1.0000000000	0.38356	-0.46839	50	0	0	55	4	0	0.00000	0.00000
38	398254007	Preeclampsia	109	90560007	Gout	1095	101	4	0	101	4	990	0.00000	-0.01930	0.00000	0.00000	0.00000	1.0000000000	1.0000000000	0.36895	-0.45307	101	0	0	0	4	0	0.00000	0.00000
35	19169002	Miscarriage in first trimester	109	90560007	Gout	1095	174	4	0	174	4	917	0.00000	-0.02632	0.00000	0.00000	0.00000	1.0000000000	1.0000000000	0.63562	-0.70983	174	0	0	0	4	0	0.00000	0.00000
33	429007001	History of cardiac arrest (situation)	109	90560007	Gout	1095	42	4	0	42	4	1049	0.00000	-0.01209	0.00000	0.00000	0.00000	1.0000000000	1.0000000000	0.15342	-0.20592	24	0	0	18	4	0	0.00000	0.00000
32	410429000	Cardiac Arrest	109	90560007	Gout	1095	42	4	0	42	4	1049	0.00000	-0.01209	0.00000	0.00000	0.00000	1.0000000000	1.0000000000	0.15342	-0.20592	24	0	0	18	4	0	0.00000	0.00000
27	408512008	Body mass index 40+ - severely obese (finding)	109	90560007	Gout	1095	97	4	1	96	3	995	2.82216	0.03440	3.45486	33.53633	0.35591	0.3103418429	1.0000000000	0.35434	0.56241	67	0	0	30	4	1	-1.60944	-3.43399
21	15777000	Prediabetes	109	90560007	Gout	1095	333	4	3	330	1	761	2.46622	0.05869	6.91818	66.75380	0.71698	0.0864561147	0.5823623432	1.21644	0.85176	159	0	0	174	4	3	-0.84730	-4.07754
131	93761005	Primary malignant neoplasm of colon	83	110030002	Concussion injury of brain	1095	5	7	0	5	7	1083	0.00000	-0.00543	0.00000	0.00000	0.00000	1.0000000000	1.0000000000	0.03196	-0.04539	3	1	0	2	6	0	0.00000	0.00000
130	314994000	Metastasis from malignant tumor of prostate (disorder)	83	110030002	Concussion injury of brain	1095	1	7	0	1	7	1087	0.00000	-0.00243	0.00000	0.00000	0.00000	1.0000000000	1.0000000000	0.00639	-0.00919	0	1	0	1	6	0	0.00000	0.00000
129	47505003	Posttraumatic stress disorder	83	110030002	Concussion injury of brain	1095	4	7	0	4	7	1084	0.00000	-0.00486	0.00000	0.00000	0.00000	1.0000000000	1.0000000000	0.02557	-0.03643	1	1	0	3	6	0	0.00000	0.00000
15	40055000	Chronic sinusitis (disorder)	109	90560007	Gout	1095	216	4	0	216	4	875	0.00000	-0.03002	0.00000	0.00000	0.00000	1.0000000000	1.0000000000	0.78904	-0.83919	104	0	0	112	4	0	0.00000	0.00000
14	10509002	Acute bronchitis (disorder)	109	90560007	Gout	1095	863	4	4	859	0	232	1.26883	0.03139	0.00000	0.00000	0.00000	0.5842857155	1.0000000000	3.15251	0.26794	418	0	0	445	4	4	-0.69315	-4.72073
126	698754002	Chronic paralysis due to lesion of spinal cord	83	110030002	Concussion injury of brain	1095	2	7	0	2	7	1086	0.00000	-0.00343	0.00000	0.00000	0.00000	1.0000000000	1.0000000000	0.01279	-0.01833	2	1	0	0	6	0	0.00000	0.00000
125	1734006	Fracture of the vertebral column with spinal cord injury	83	110030002	Concussion injury of brain	1095	5	7	0	5	7	1083	0.00000	-0.00543	0.00000	0.00000	0.00000	1.0000000000	1.0000000000	0.03196	-0.04539	3	1	0	2	6	0	0.00000	0.00000
124	1501000119109	Proliferative diabetic retinopathy due to type II diabetes mellitus (disorder)	83	110030002	Concussion injury of brain	1095	1	7	0	1	7	1087	0.00000	-0.00243	0.00000	0.00000	0.00000	1.0000000000	1.0000000000	0.00639	-0.00919	1	1	0	0	6	0	0.00000	0.00000
123	195967001	Asthma	83	110030002	Concussion injury of brain	1095	2	7	0	2	7	1086	0.00000	-0.00343	0.00000	0.00000	0.00000	1.0000000000	1.0000000000	0.01279	-0.01833	1	1	0	1	6	0	0.00000	0.00000
121	254637007	Non-small cell lung cancer (disorder)	83	110030002	Concussion injury of brain	1095	8	7	0	8	7	1080	0.00000	-0.00688	0.00000	0.00000	0.00000	1.0000000000	1.0000000000	0.05114	-0.07196	0	1	0	8	6	0	0.00000	0.00000
120	162573006	Suspected lung cancer (situation)	83	110030002	Concussion injury of brain	1095	8	7	0	8	7	1080	0.00000	-0.00688	0.00000	0.00000	0.00000	1.0000000000	1.0000000000	0.05114	-0.07196	0	1	0	8	6	0	0.00000	0.00000
118	48333001	Burn injury(morphologic abnormality)	83	110030002	Concussion injury of brain	1095	1	7	0	1	7	1087	0.00000	-0.00243	0.00000	0.00000	0.00000	1.0000000000	1.0000000000	0.00639	-0.00919	0	1	0	1	6	0	0.00000	0.00000
117	230265002	Familial Alzheimer's disease of early onset (disorder)	83	110030002	Concussion injury of brain	1095	6	7	0	6	7	1082	0.00000	-0.00595	0.00000	0.00000	0.00000	1.0000000000	1.0000000000	0.03836	-0.05430	2	1	0	4	6	0	0.00000	0.00000
115	36923009	Major depression  single episode	83	110030002	Concussion injury of brain	1095	6	7	0	6	7	1082	0.00000	-0.00595	0.00000	0.00000	0.00000	1.0000000000	1.0000000000	0.03836	-0.05430	3	1	0	3	6	0	0.00000	0.00000
114	449868002	Smokes tobacco daily	83	110030002	Concussion injury of brain	1095	9	7	0	9	7	1079	0.00000	-0.00730	0.00000	0.00000	0.00000	1.0000000000	1.0000000000	0.05753	-0.08070	2	1	0	7	6	0	0.00000	0.00000
112	49436004	Atrial Fibrillation	83	110030002	Concussion injury of brain	1095	35	7	1	34	6	1054	4.46939	0.05057	5.16667	44.10628	0.60523	0.2039027947	0.8524167357	0.22374	0.70870	9	1	0	26	6	1	-1.94591	-3.29584
111	235919008	Cholelithiasis	83	110030002	Concussion injury of brain	1095	9	7	0	9	7	1079	0.00000	-0.00730	0.00000	0.00000	0.00000	1.0000000000	1.0000000000	0.05753	-0.08070	7	1	0	2	6	0	0.00000	0.00000
110	65275009	Acute Cholecystitis	83	110030002	Concussion injury of brain	1095	9	7	0	9	7	1079	0.00000	-0.00730	0.00000	0.00000	0.00000	1.0000000000	1.0000000000	0.05753	-0.08070	7	1	0	2	6	0	0.00000	0.00000
109	90560007	Gout	83	110030002	Concussion injury of brain	1095	4	7	0	4	7	1084	0.00000	-0.00486	0.00000	0.00000	0.00000	1.0000000000	1.0000000000	0.02557	-0.03643	0	1	0	4	6	0	0.00000	0.00000
108	40930008	Hypothyroidism (disorder)	83	110030002	Concussion injury of brain	1095	13	7	0	13	7	1075	0.00000	-0.00879	0.00000	0.00000	0.00000	1.0000000000	1.0000000000	0.08311	-0.11517	11	1	0	2	6	0	0.00000	0.00000
107	40275004	Contact dermatitis	83	110030002	Concussion injury of brain	1095	18	7	0	18	7	1070	0.00000	-0.01037	0.00000	0.00000	0.00000	1.0000000000	1.0000000000	0.11507	-0.15713	9	1	0	9	6	0	0.00000	0.00000
106	24079001	Atopic dermatitis	83	110030002	Concussion injury of brain	1095	20	7	0	20	7	1068	0.00000	-0.01094	0.00000	0.00000	0.00000	1.0000000000	1.0000000000	0.12785	-0.17358	13	1	0	7	6	0	0.00000	0.00000
105	363406005	Malignant tumor of colon	83	110030002	Concussion injury of brain	1095	6	7	0	6	7	1082	0.00000	-0.00595	0.00000	0.00000	0.00000	1.0000000000	1.0000000000	0.03836	-0.05430	4	1	0	2	6	0	0.00000	0.00000
104	367498001	Seasonal allergic rhinitis	83	110030002	Concussion injury of brain	1095	20	7	0	20	7	1068	0.00000	-0.01094	0.00000	0.00000	0.00000	1.0000000000	1.0000000000	0.12785	-0.17358	9	1	0	11	6	0	0.00000	0.00000
102	90781000119102	Microalbuminuria due to type 2 diabetes mellitus (disorder)	83	110030002	Concussion injury of brain	1095	6	7	0	6	7	1082	0.00000	-0.00595	0.00000	0.00000	0.00000	1.0000000000	1.0000000000	0.03836	-0.05430	3	1	0	3	6	0	0.00000	0.00000
101	433144002	Chronic kidney disease stage 3 (disorder)	83	110030002	Concussion injury of brain	1095	3	7	0	3	7	1085	0.00000	-0.00420	0.00000	0.00000	0.00000	1.0000000000	1.0000000000	0.01918	-0.02741	1	1	0	2	6	0	0.00000	0.00000
100	161622006	History of lower limb amputation (situation)	83	110030002	Concussion injury of brain	1095	1	7	0	1	7	1087	0.00000	-0.00243	0.00000	0.00000	0.00000	1.0000000000	1.0000000000	0.00639	-0.00919	0	1	0	1	6	0	0.00000	0.00000
99	30832001	Rupture of patellar tendon	83	110030002	Concussion injury of brain	1095	23	7	0	23	7	1065	0.00000	-0.01175	0.00000	0.00000	0.00000	1.0000000000	1.0000000000	0.14703	-0.19791	14	1	0	9	6	0	0.00000	0.00000
98	1551000119108	Nonproliferative diabetic retinopathy due to type 2 diabetes mellitus (disorder)	83	110030002	Concussion injury of brain	1095	12	7	0	12	7	1076	0.00000	-0.00844	0.00000	0.00000	0.00000	1.0000000000	1.0000000000	0.07671	-0.10663	7	1	0	5	6	0	0.00000	0.00000
97	403192003	Third degree burn	83	110030002	Concussion injury of brain	1095	8	7	0	8	7	1080	0.00000	-0.00688	0.00000	0.00000	0.00000	1.0000000000	1.0000000000	0.05114	-0.07196	3	1	0	5	6	0	0.00000	0.00000
96	283371005	Laceration of forearm	83	110030002	Concussion injury of brain	1095	75	7	1	74	6	1014	2.08571	0.02361	2.28378	19.22005	0.27137	0.3923025386	1.0000000000	0.47945	0.43494	39	1	0	36	6	1	-1.94591	-3.61092
95	84757009	Epilepsy	83	110030002	Concussion injury of brain	1095	30	7	0	30	7	1058	0.00000	-0.01346	0.00000	0.00000	0.00000	1.0000000000	1.0000000000	0.19178	-0.25312	13	1	0	17	6	0	0.00000	0.00000
94	703151001	History of single seizure (situation)	83	110030002	Concussion injury of brain	1095	39	7	0	39	7	1049	0.00000	-0.01541	0.00000	0.00000	0.00000	1.0000000000	1.0000000000	0.24932	-0.32114	14	1	0	25	6	0	0.00000	0.00000
93	128613002	Seizure disorder	83	110030002	Concussion injury of brain	1095	39	7	0	39	7	1049	0.00000	-0.01541	0.00000	0.00000	0.00000	1.0000000000	1.0000000000	0.24932	-0.32114	14	1	0	25	6	0	0.00000	0.00000
89	47693006	Rupture of appendix	83	110030002	Concussion injury of brain	1095	20	7	0	20	7	1068	0.00000	-0.01094	0.00000	0.00000	0.00000	1.0000000000	1.0000000000	0.12785	-0.17358	10	1	0	10	6	0	0.00000	0.00000
86	713197008	Recurrent rectal polyp	83	110030002	Concussion injury of brain	1095	22	7	0	22	7	1066	0.00000	-0.01149	0.00000	0.00000	0.00000	1.0000000000	1.0000000000	0.14064	-0.18984	12	1	0	10	6	0	0.00000	0.00000
85	241929008	Acute allergic reaction	83	110030002	Concussion injury of brain	1095	47	7	0	47	7	1041	0.00000	-0.01699	0.00000	0.00000	0.00000	1.0000000000	1.0000000000	0.30046	-0.37902	25	1	0	22	6	0	0.00000	0.00000
82	94260004	Secondary malignant neoplasm of colon	83	110030002	Concussion injury of brain	1095	4	7	0	4	7	1084	0.00000	-0.00486	0.00000	0.00000	0.00000	1.0000000000	1.0000000000	0.02557	-0.03643	2	1	0	2	6	0	0.00000	0.00000
81	236077008	Protracted diarrhea	83	110030002	Concussion injury of brain	1095	4	7	0	4	7	1084	0.00000	-0.00486	0.00000	0.00000	0.00000	1.0000000000	1.0000000000	0.02557	-0.03643	2	1	0	2	6	0	0.00000	0.00000
80	6072007	Bleeding from anus	83	110030002	Concussion injury of brain	1095	4	7	0	4	7	1084	0.00000	-0.00486	0.00000	0.00000	0.00000	1.0000000000	1.0000000000	0.02557	-0.03643	2	1	0	2	6	0	0.00000	0.00000
79	45816000	Pyelonephritis	83	110030002	Concussion injury of brain	1095	1	7	0	1	7	1087	0.00000	-0.00243	0.00000	0.00000	0.00000	1.0000000000	1.0000000000	0.00639	-0.00919	1	1	0	0	6	0	0.00000	0.00000
78	239872002	Osteoarthritis of hip	83	110030002	Concussion injury of brain	1095	21	7	0	21	7	1067	0.00000	-0.01122	0.00000	0.00000	0.00000	1.0000000000	1.0000000000	0.13425	-0.18173	13	1	0	8	6	0	0.00000	0.00000
76	127013003	Diabetic renal disease (disorder)	83	110030002	Concussion injury of brain	1095	28	7	0	28	7	1060	0.00000	-0.01299	0.00000	0.00000	0.00000	1.0000000000	1.0000000000	0.17900	-0.23756	10	1	0	18	6	0	0.00000	0.00000
75	431855005	Chronic kidney disease stage 1 (disorder)	83	110030002	Concussion injury of brain	1095	28	7	0	28	7	1060	0.00000	-0.01299	0.00000	0.00000	0.00000	1.0000000000	1.0000000000	0.17900	-0.23756	10	1	0	18	6	0	0.00000	0.00000
73	196416002	Impacted molars	83	110030002	Concussion injury of brain	1095	49	7	0	49	7	1039	0.00000	-0.01736	0.00000	0.00000	0.00000	1.0000000000	1.0000000000	0.31324	-0.39313	25	1	0	24	6	0	0.00000	0.00000
72	35999006	Blighted ovum	83	110030002	Concussion injury of brain	1095	53	7	0	53	7	1035	0.00000	-0.01809	0.00000	0.00000	0.00000	1.0000000000	1.0000000000	0.33881	-0.42095	53	1	0	0	6	0	0.00000	0.00000
71	201834006	Localized  primary osteoarthritis of the hand	83	110030002	Concussion injury of brain	1095	28	7	0	28	7	1060	0.00000	-0.01299	0.00000	0.00000	0.00000	1.0000000000	1.0000000000	0.17900	-0.23756	19	1	0	9	6	0	0.00000	0.00000
70	87433001	Pulmonary emphysema (disorder)	83	110030002	Concussion injury of brain	1095	17	7	0	17	7	1071	0.00000	-0.01007	0.00000	0.00000	0.00000	1.0000000000	1.0000000000	0.10868	-0.14884	9	1	0	8	6	0	0.00000	0.00000
69	233604007	Pneumonia	83	110030002	Concussion injury of brain	1095	7	7	0	7	7	1081	0.00000	-0.00643	0.00000	0.00000	0.00000	1.0000000000	1.0000000000	0.04475	-0.06316	3	1	0	4	6	0	0.00000	0.00000
68	26929004	Alzheimer's disease (disorder)	83	110030002	Concussion injury of brain	1095	23	7	0	23	7	1065	0.00000	-0.01175	0.00000	0.00000	0.00000	1.0000000000	1.0000000000	0.14703	-0.19791	15	1	0	8	6	0	0.00000	0.00000
67	403191005	Second degree burn	83	110030002	Concussion injury of brain	1095	49	7	0	49	7	1039	0.00000	-0.01736	0.00000	0.00000	0.00000	1.0000000000	1.0000000000	0.31324	-0.39313	23	1	0	26	6	0	0.00000	0.00000
65	239873007	Osteoarthritis of knee	83	110030002	Concussion injury of brain	1095	57	7	1	56	6	1032	2.74436	0.03279	3.07143	25.94972	0.36354	0.3128945348	1.0000000000	0.36438	0.55175	30	1	0	27	6	1	-1.94591	-3.33220
64	444448004	Injury of medial collateral ligament of knee	83	110030002	Concussion injury of brain	1095	32	7	0	32	7	1056	0.00000	-0.01392	0.00000	0.00000	0.00000	1.0000000000	1.0000000000	0.20457	-0.26851	17	1	0	15	6	0	0.00000	0.00000
63	68496003	Polyp of colon	83	110030002	Concussion injury of brain	1095	91	7	0	91	7	997	0.00000	-0.02415	0.00000	0.00000	0.00000	1.0000000000	1.0000000000	0.58174	-0.66151	43	1	0	48	6	0	0.00000	0.00000
62	185086009	Chronic obstructive bronchitis (disorder)	83	110030002	Concussion injury of brain	1095	6	7	0	6	7	1082	0.00000	-0.00595	0.00000	0.00000	0.00000	1.0000000000	1.0000000000	0.03836	-0.05430	4	1	0	2	6	0	0.00000	0.00000
59	262574004	Bullet wound	83	110030002	Concussion injury of brain	1095	20	7	0	20	7	1068	0.00000	-0.01094	0.00000	0.00000	0.00000	1.0000000000	1.0000000000	0.12785	-0.17358	9	1	0	11	6	0	0.00000	0.00000
58	239720000	Tear of meniscus of knee	83	110030002	Concussion injury of brain	1095	20	7	0	20	7	1068	0.00000	-0.01094	0.00000	0.00000	0.00000	1.0000000000	1.0000000000	0.12785	-0.17358	10	1	0	10	6	0	0.00000	0.00000
57	192127007	Child attention deficit disorder	83	110030002	Concussion injury of brain	1095	76	7	2	74	5	1014	4.11654	0.06827	5.48108	28.73237	1.04559	0.0795170806	0.5584007465	0.48584	1.01368	24	1	0	52	6	2	-1.38629	-3.29584
56	92691004	Carcinoma in situ of prostate (disorder)	83	110030002	Concussion injury of brain	1095	23	7	0	23	7	1065	0.00000	-0.01175	0.00000	0.00000	0.00000	1.0000000000	1.0000000000	0.14703	-0.19791	0	1	0	23	6	0	0.00000	0.00000
54	5602001	Opioid abuse (disorder)	83	110030002	Concussion injury of brain	1095	7	7	0	7	7	1081	0.00000	-0.00643	0.00000	0.00000	0.00000	1.0000000000	1.0000000000	0.04475	-0.06316	0	1	0	7	6	0	0.00000	0.00000
53	7200002	Alcoholism	83	110030002	Concussion injury of brain	1095	5	7	0	5	7	1083	0.00000	-0.00543	0.00000	0.00000	0.00000	1.0000000000	1.0000000000	0.03196	-0.04539	0	1	0	5	6	0	0.00000	0.00000
52	124171000119105	Chronic intractable migraine without aura	83	110030002	Concussion injury of brain	1095	51	7	1	50	6	1038	3.06723	0.03665	3.46000	29.28892	0.40874	0.2845222606	0.9659403678	0.32603	0.59289	21	1	1	30	6	0	0.69315	3.09104
50	446096008	Perennial allergic rhinitis	83	110030002	Concussion injury of brain	1095	26	7	0	26	7	1062	0.00000	-0.01251	0.00000	0.00000	0.00000	1.0000000000	1.0000000000	0.16621	-0.22183	14	1	0	12	6	0	0.00000	0.00000
49	88805009	Chronic congestive heart failure (disorder)	83	110030002	Concussion injury of brain	1095	10	7	0	10	7	1078	0.00000	-0.00770	0.00000	0.00000	0.00000	1.0000000000	1.0000000000	0.06393	-0.08940	5	1	0	5	6	0	0.00000	0.00000
47	359817006	Closed fracture of hip	83	110030002	Concussion injury of brain	1095	29	7	0	29	7	1059	0.00000	-0.01323	0.00000	0.00000	0.00000	1.0000000000	1.0000000000	0.18539	-0.24536	11	1	0	18	6	0	0.00000	0.00000
46	62564004	Concussion with loss of consciousness	83	110030002	Concussion injury of brain	1095	67	7	1	66	6	1022	2.33475	0.02733	2.58081	21.75171	0.30621	0.3580400999	1.0000000000	0.42831	0.48569	36	1	1	31	6	0	0.69315	3.61092
45	263102004	Fracture subluxation of wrist	83	110030002	Concussion injury of brain	1095	109	7	0	109	7	979	0.00000	-0.02667	0.00000	0.00000	0.00000	1.0000000000	1.0000000000	0.69680	-0.76282	51	1	0	58	6	0	0.00000	0.00000
44	58150001	Fracture of clavicle	83	110030002	Concussion injury of brain	1095	112	7	1	111	6	977	1.39668	0.01074	1.46697	12.29614	0.17501	0.5311619735	1.0000000000	0.71598	0.22097	55	1	0	57	6	1	-1.94591	-4.06044
43	307731004	Injury of tendon of the rotator cuff of shoulder	83	110030002	Concussion injury of brain	1095	51	7	0	51	7	1037	0.00000	-0.01773	0.00000	0.00000	0.00000	1.0000000000	1.0000000000	0.32603	-0.40711	26	1	0	25	6	0	0.00000	0.00000
42	16114001	Fracture of ankle	83	110030002	Concussion injury of brain	1095	108	7	0	108	7	980	0.00000	-0.02653	0.00000	0.00000	0.00000	1.0000000000	1.0000000000	0.69041	-0.75737	48	1	0	60	6	0	0.00000	0.00000
41	283385000	Laceration of thigh	83	110030002	Concussion injury of brain	1095	105	7	1	104	6	984	1.48980	0.01279	1.57692	13.22495	0.18803	0.5072116212	1.0000000000	0.67123	0.25909	50	1	0	55	6	1	-1.94591	-4.02535
40	428251008	History of appendectomy	83	110030002	Concussion injury of brain	1095	51	7	0	51	7	1037	0.00000	-0.01773	0.00000	0.00000	0.00000	1.0000000000	1.0000000000	0.32603	-0.40711	27	1	0	24	6	0	0.00000	0.00000
39	74400008	Appendicitis	83	110030002	Concussion injury of brain	1095	51	7	0	51	7	1037	0.00000	-0.01773	0.00000	0.00000	0.00000	1.0000000000	1.0000000000	0.32603	-0.40711	27	1	0	24	6	0	0.00000	0.00000
38	398254007	Preeclampsia	83	110030002	Concussion injury of brain	1095	101	7	0	101	7	987	0.00000	-0.02557	0.00000	0.00000	0.00000	1.0000000000	1.0000000000	0.64566	-0.71867	101	1	0	0	6	0	0.00000	0.00000
35	19169002	Miscarriage in first trimester	83	110030002	Concussion injury of brain	1095	174	7	1	173	6	915	0.89901	-0.00352	0.88150	7.36770	0.10547	1.0000000000	1.0000000000	1.11233	-0.07883	174	1	1	0	6	0	0.69315	5.16479
33	429007001	History of cardiac arrest (situation)	83	110030002	Concussion injury of brain	1095	42	7	1	41	6	1047	3.72449	0.04364	4.25610	36.17001	0.50081	0.2400829148	0.9095097439	0.26849	0.65688	24	1	0	18	6	1	-1.94591	-2.94444
32	410429000	Cardiac Arrest	83	110030002	Concussion injury of brain	1095	42	7	1	41	6	1047	3.72449	0.04364	4.25610	36.17001	0.50081	0.2400829148	0.9095097439	0.26849	0.65688	24	1	0	18	6	1	-1.94591	-2.94444
30	399211009	History of myocardial infarction (situation)	83	110030002	Concussion injury of brain	1095	31	7	0	31	7	1057	0.00000	-0.01369	0.00000	0.00000	0.00000	1.0000000000	1.0000000000	0.19817	-0.26084	2	1	0	29	6	0	0.00000	0.00000
29	22298006	Myocardial Infarction	83	110030002	Concussion injury of brain	1095	31	7	0	31	7	1057	0.00000	-0.01369	0.00000	0.00000	0.00000	1.0000000000	1.0000000000	0.19817	-0.26084	2	1	0	29	6	0	0.00000	0.00000
28	53741008	Coronary Heart Disease	83	110030002	Concussion injury of brain	1095	80	7	0	80	7	1008	0.00000	-0.02252	0.00000	0.00000	0.00000	1.0000000000	1.0000000000	0.51142	-0.59590	24	1	0	56	6	0	0.00000	0.00000
27	408512008	Body mass index 40+ - severely obese (finding)	83	110030002	Concussion injury of brain	1095	97	7	0	97	7	991	0.00000	-0.02501	0.00000	0.00000	0.00000	1.0000000000	1.0000000000	0.62009	-0.69608	67	1	0	30	6	0	0.00000	0.00000
26	33737001	Fracture of rib	83	110030002	Concussion injury of brain	1095	54	7	0	54	7	1034	0.00000	-0.01827	0.00000	0.00000	0.00000	1.0000000000	1.0000000000	0.34521	-0.42783	32	1	0	22	6	0	0.00000	0.00000
24	162864005	Body mass index 30+ - obesity (finding)	83	110030002	Concussion injury of brain	1095	439	7	5	434	2	654	1.78165	0.05129	3.76728	19.50484	0.72764	0.1237735138	0.6913144812	2.80639	0.65654	226	1	0	213	6	5	-0.78846	-3.77506
23	36971009	Sinusitis (disorder)	83	110030002	Concussion injury of brain	1095	190	7	0	190	7	898	0.00000	-0.03675	0.00000	0.00000	0.00000	0.6118703066	1.0000000000	1.21461	-1.14705	84	1	0	106	6	0	0.00000	0.00000
21	15777000	Prediabetes	83	110030002	Concussion injury of brain	1095	333	7	1	332	6	756	0.46976	-0.02812	0.37952	3.16477	0.04551	0.6820839571	1.0000000000	2.12877	-0.64559	159	1	1	174	6	0	0.69315	5.07517
20	80394007	Hyperglycemia (disorder)	83	110030002	Concussion injury of brain	1095	55	7	0	55	7	1033	0.00000	-0.01845	0.00000	0.00000	0.00000	1.0000000000	1.0000000000	0.35160	-0.43467	23	1	0	32	6	0	0.00000	0.00000
19	237602007	Metabolic syndrome X (disorder)	83	110030002	Concussion injury of brain	1095	64	7	0	64	7	1024	0.00000	-0.01998	0.00000	0.00000	0.00000	1.0000000000	1.0000000000	0.40913	-0.49481	28	1	0	36	6	0	0.00000	0.00000
18	302870006	Hypertriglyceridemia (disorder)	83	110030002	Concussion injury of brain	1095	64	7	0	64	7	1024	0.00000	-0.01998	0.00000	0.00000	0.00000	1.0000000000	1.0000000000	0.40913	-0.49481	28	1	0	36	6	0	0.00000	0.00000
17	368581000119106	Neuropathy due to type 2 diabetes mellitus (disorder)	83	110030002	Concussion injury of brain	1095	28	7	0	28	7	1060	0.00000	-0.01299	0.00000	0.00000	0.00000	1.0000000000	1.0000000000	0.17900	-0.23756	7	1	0	21	6	0	0.00000	0.00000
129	47505003	Posttraumatic stress disorder	57	192127007	Child attention deficit disorder	1095	4	76	0	4	76	1015	0.00000	-0.01654	0.00000	0.00000	0.00000	1.0000000000	1.0000000000	0.27763	-0.35347	1	24	0	3	52	0	0.00000	0.00000
15	40055000	Chronic sinusitis (disorder)	83	110030002	Concussion injury of brain	1095	216	7	4	212	3	876	2.89683	0.07542	5.50943	24.80163	1.22387	0.0313355464	0.3268117118	1.38082	1.07047	104	1	1	112	6	3	-0.40547	1.00764
14	10509002	Acute bronchitis (disorder)	83	110030002	Concussion injury of brain	1095	863	7	7	856	0	232	1.26883	0.04159	0.00000	0.00000	0.00000	0.3563388735	1.0000000000	5.51689	0.29582	418	1	1	445	6	6	0.00000	1.71816
13	370247008	Facial laceration	83	110030002	Concussion injury of brain	1095	109	7	0	109	7	979	0.00000	-0.02667	0.00000	0.00000	0.00000	1.0000000000	1.0000000000	0.69680	-0.76282	55	1	0	54	6	0	0.00000	0.00000
125	1734006	Fracture of the vertebral column with spinal cord injury	57	192127007	Child attention deficit disorder	1095	5	76	0	5	76	1014	0.00000	-0.01850	0.00000	0.00000	0.00000	1.0000000000	1.0000000000	0.34703	-0.42978	3	24	0	2	52	0	0.00000	0.00000
10	62106007	Concussion with no loss of consciousness	83	110030002	Concussion injury of brain	1095	206	7	2	204	5	884	1.51872	0.02003	1.73333	8.99729	0.33393	0.6220107099	1.0000000000	1.31689	0.37277	96	1	0	110	6	2	-1.38629	-4.02535
9	44465007	Sprain of ankle	83	110030002	Concussion injury of brain	1095	362	7	2	360	5	728	0.86425	-0.00765	0.80889	4.18952	0.15618	1.0000000000	1.0000000000	2.31416	-0.14368	185	1	0	177	6	2	-1.38629	-4.49424
8	233678006	Childhood asthma	83	110030002	Concussion injury of brain	1095	45	7	0	45	7	1043	0.00000	-0.01661	0.00000	0.00000	0.00000	1.0000000000	1.0000000000	0.28767	-0.36476	25	1	0	20	6	0	0.00000	0.00000
7	75498004	Acute bacterial sinusitis (disorder)	83	110030002	Concussion injury of brain	1095	187	7	3	184	4	904	2.50955	0.05495	3.68478	16.60211	0.81783	0.1009932667	0.6283150080	1.19543	0.86549	89	1	1	98	6	2	-0.69315	0.58779
6	39848009	Whiplash injury to neck	83	110030002	Concussion injury of brain	1095	182	7	1	181	6	907	0.85950	-0.00503	0.83517	6.97893	0.09995	1.0000000000	1.0000000000	1.16347	-0.11335	92	1	0	90	6	1	-1.94591	-4.51086
5	284549007	Laceration of hand	83	110030002	Concussion injury of brain	1095	104	7	1	103	6	985	1.50412	0.01310	1.59385	13.36803	0.19003	0.5037060128	1.0000000000	0.66484	0.26462	54	1	1	50	6	0	0.69315	4.00733
117	230265002	Familial Alzheimer's disease of early onset (disorder)	57	192127007	Child attention deficit disorder	1095	6	76	0	6	76	1013	0.00000	-0.02027	0.00000	0.00000	0.00000	1.0000000000	1.0000000000	0.41644	-0.50227	2	24	0	4	52	0	0.00000	0.00000
1	444814009	Viral sinusitis (disorder)	83	110030002	Concussion injury of brain	1095	993	7	7	986	0	102	1.10272	0.02571	0.00000	0.00000	0.00000	1.0000000000	1.0000000000	6.34795	0.12266	478	1	1	515	6	6	0.00000	1.70771
109	90560007	Gout	57	192127007	Child attention deficit disorder	1095	4	76	1	3	75	1016	3.60197	0.04303	4.51556	43.93983	0.46405	0.2503433784	0.9133257124	0.27763	0.64653	0	24	0	4	52	1	-3.97029	-1.60944
102	90781000119102	Microalbuminuria due to type 2 diabetes mellitus (disorder)	57	192127007	Child attention deficit disorder	1095	6	76	0	6	76	1013	0.00000	-0.02027	0.00000	0.00000	0.00000	1.0000000000	1.0000000000	0.41644	-0.50227	3	24	0	3	52	0	0.00000	0.00000
98	1551000119108	Nonproliferative diabetic retinopathy due to type 2 diabetes mellitus (disorder)	57	192127007	Child attention deficit disorder	1095	12	76	1	11	75	1008	1.20066	0.00577	1.22182	9.59129	0.15565	0.5800919980	1.0000000000	0.83288	0.12589	7	24	0	5	52	1	-3.97029	-1.79176
97	403192003	Third degree burn	57	192127007	Child attention deficit disorder	1095	8	76	1	7	75	1012	1.80099	0.01877	1.92762	15.87373	0.23408	0.4386311466	1.0000000000	0.55525	0.36285	3	24	0	5	52	1	-3.97029	-1.79176
96	283371005	Laceration of forearm	57	192127007	Child attention deficit disorder	1095	75	76	5	70	71	949	0.96053	-0.00292	0.95473	2.44113	0.37340	1.0000000000	1.0000000000	5.20548	-0.04858	39	24	4	36	52	1	-2.02438	-1.23601
94	703151001	History of single seizure (situation)	57	192127007	Child attention deficit disorder	1095	39	76	3	36	73	983	1.10830	0.00568	1.12215	3.73144	0.33746	0.7481814190	1.0000000000	2.70685	0.10981	14	24	2	25	52	1	-1.40534	-1.17865
93	128613002	Seizure disorder	57	192127007	Child attention deficit disorder	1095	39	76	3	36	73	983	1.10830	0.00568	1.12215	3.73144	0.33746	0.7481814190	1.0000000000	2.70685	0.10981	14	24	2	25	52	1	-1.40534	-1.17865
89	47693006	Rupture of appendix	57	192127007	Child attention deficit disorder	1095	20	76	3	17	73	1002	2.16118	0.04325	2.42224	8.45585	0.69387	0.1565786445	0.7747075658	1.38813	0.74412	10	24	2	10	52	1	-1.40534	-0.60614
86	713197008	Recurrent rectal polyp	57	192127007	Child attention deficit disorder	1095	22	76	0	22	76	997	0.00000	-0.03910	0.00000	0.00000	0.00000	0.3941887838	1.0000000000	1.52694	-1.33739	12	24	0	10	52	0	0.00000	0.00000
130	314994000	Metastasis from malignant tumor of prostate (disorder)	59	262574004	Bullet wound	1095	1	20	0	1	20	1074	0.00000	-0.00412	0.00000	0.00000	0.00000	1.0000000000	1.0000000000	0.01826	-0.02611	0	9	0	1	11	0	0.00000	0.00000
75	431855005	Chronic kidney disease stage 1 (disorder)	57	192127007	Child attention deficit disorder	1095	28	76	5	23	71	996	2.57284	0.06958	3.04960	8.26181	1.12567	0.0392853481	0.3768817329	1.94338	1.02749	10	24	1	18	52	4	0.57982	0.69315
72	35999006	Blighted ovum	57	192127007	Child attention deficit disorder	1095	53	76	6	47	70	972	1.63108	0.03887	1.77264	4.28922	0.73260	0.2585472663	0.9233229877	3.67854	0.58130	53	24	6	0	52	0	1.60944	2.28578
69	233604007	Pneumonia	57	192127007	Child attention deficit disorder	1095	7	76	0	7	76	1012	0.00000	-0.02191	0.00000	0.00000	0.00000	1.0000000000	1.0000000000	0.48584	-0.57128	3	24	0	4	52	0	0.00000	0.00000
67	403191005	Second degree burn	57	192127007	Child attention deficit disorder	1095	49	76	3	46	73	973	0.88212	-0.00697	0.86927	2.86272	0.26395	1.0000000000	1.0000000000	3.40091	-0.13780	23	24	2	26	52	1	-1.40534	-0.77011
64	444448004	Injury of medial collateral ligament of knee	57	192127007	Child attention deficit disorder	1095	32	76	4	28	72	991	1.80099	0.03795	1.96627	5.75893	0.67134	0.2731715806	0.9485364456	2.22100	0.63442	17	24	1	15	52	3	0.31015	1.09861
63	68496003	Polyp of colon	57	192127007	Child attention deficit disorder	1095	91	76	3	88	73	931	0.47499	-0.04317	0.43478	1.40803	0.13425	0.1962698818	0.8342357389	6.31598	-0.87105	43	24	0	48	52	3	-2.90872	-2.83321
58	239720000	Tear of meniscus of knee	57	192127007	Child attention deficit disorder	1095	20	76	3	17	73	1002	2.16118	0.04325	2.42224	8.45585	0.69387	0.1565786445	0.7747075658	1.38813	0.74412	10	24	1	10	52	2	-0.07696	0.60614
50	446096008	Perennial allergic rhinitis	57	192127007	Child attention deficit disorder	1095	26	76	2	24	74	995	1.10830	0.00461	1.12050	4.83302	0.25978	0.7005041510	1.0000000000	1.80457	0.09718	14	24	2	12	52	0	2.56495	2.07944
49	88805009	Chronic congestive heart failure (disorder)	57	192127007	Child attention deficit disorder	1095	10	76	0	10	76	1009	0.00000	-0.02622	0.00000	0.00000	0.00000	1.0000000000	1.0000000000	0.69406	-0.76049	5	24	0	5	52	0	0.00000	0.00000
47	359817006	Closed fracture of hip	57	192127007	Child attention deficit disorder	1095	29	76	1	28	75	991	0.49682	-0.02267	0.47190	3.51642	0.06333	0.7157980771	1.0000000000	2.01279	-0.59110	11	24	0	18	52	1	-3.97029	-2.94444
44	58150001	Fracture of clavicle	57	192127007	Child attention deficit disorder	1095	112	76	8	104	68	915	1.02914	0.00269	1.03507	2.21357	0.48400	0.8459278111	1.0000000000	7.77352	0.03677	55	24	3	57	52	5	-0.23639	0.44413
43	307731004	Injury of tendon of the rotator cuff of shoulder	57	192127007	Child attention deficit disorder	1095	51	76	3	48	73	971	0.84752	-0.00920	0.83134	2.73381	0.25280	1.0000000000	1.0000000000	3.53973	-0.18261	26	24	0	25	52	3	-2.90872	-2.23359
42	16114001	Fracture of ankle	57	192127007	Child attention deficit disorder	1095	108	76	5	103	71	916	0.66703	-0.03008	0.62628	1.58645	0.24724	0.4250977302	1.0000000000	7.49589	-0.50180	48	24	1	60	52	4	0.57982	1.11923
41	283385000	Laceration of thigh	57	192127007	Child attention deficit disorder	1095	105	76	2	103	74	916	0.27444	-0.06453	0.24036	0.99359	0.05814	0.0263916455	0.2963541316	7.28767	-1.46600	50	24	0	55	52	2	-3.29584	-3.34990
39	74400008	Appendicitis	57	192127007	Child attention deficit disorder	1095	51	76	6	45	70	974	1.69505	0.04195	1.85524	4.49828	0.76516	0.1588551376	0.7768414475	3.53973	0.62475	27	24	3	24	52	3	-0.71150	0.10536
38	398254007	Preeclampsia	57	192127007	Child attention deficit disorder	1095	101	76	6	95	70	924	0.85591	-0.01254	0.83368	1.97026	0.35276	0.8379321788	1.0000000000	7.01005	-0.19446	101	24	6	0	52	0	1.60944	2.88107
35	19169002	Miscarriage in first trimester	57	192127007	Child attention deficit disorder	1095	174	76	9	165	67	854	0.74524	-0.03024	0.69525	1.42194	0.33994	0.4153765792	1.0000000000	12.07671	-0.38700	174	24	9	0	52	0	1.29928	3.01226
33	429007001	History of cardiac arrest (situation)	57	192127007	Child attention deficit disorder	1095	42	76	2	40	74	979	0.68609	-0.01712	0.66149	2.79097	0.15678	0.7631536597	1.0000000000	2.91507	-0.38408	24	24	1	18	52	1	-0.75142	0.27444
32	410429000	Cardiac Arrest	57	192127007	Child attention deficit disorder	1095	42	76	2	40	74	979	0.68609	-0.01712	0.66149	2.79097	0.15678	0.7631536597	1.0000000000	2.91507	-0.38408	24	24	1	18	52	1	-0.75142	0.27444
30	399211009	History of myocardial infarction (situation)	57	192127007	Child attention deficit disorder	1095	31	76	6	25	70	994	2.78862	0.08338	3.40800	8.58069	1.35356	0.0166908951	0.2196591865	2.15160	1.15127	2	24	0	29	52	6	-2.26868	-1.76359
27	408512008	Body mass index 40+ - severely obese (finding)	57	192127007	Child attention deficit disorder	1095	97	76	5	92	71	927	0.74267	-0.02191	0.70958	1.80173	0.27946	0.6740520785	1.0000000000	6.73242	-0.36596	67	24	3	30	52	2	-1.09861	0.37729
24	162864005	Body mass index 30+ - obesity (finding)	57	192127007	Child attention deficit disorder	1095	439	76	27	412	49	607	0.88613	-0.02544	0.81182	1.32003	0.49927	0.4669589469	1.0000000000	30.46941	-0.16852	226	24	10	213	52	17	-0.17712	0.55638
21	15777000	Prediabetes	57	192127007	Child attention deficit disorder	1095	333	76	18	315	58	704	0.77881	-0.03993	0.69360	1.19648	0.40207	0.1987812929	0.8417280218	23.11233	-0.34377	159	24	3	174	52	15	0.70058	1.45529
20	80394007	Hyperglycemia (disorder)	57	192127007	Child attention deficit disorder	1095	55	76	5	50	71	969	1.30981	0.01946	1.36479	3.53023	0.52763	0.5811036411	1.0000000000	3.81735	0.31672	23	24	1	32	52	4	0.57982	0.98083
132	69896004	Rheumatoid arthritis	31	230690007	Stroke	1095	3	62	0	3	62	1030	0.00000	-0.01284	0.00000	0.00000	0.00000	1.0000000000	1.0000000000	0.16986	-0.22634	2	32	0	1	30	0	0.00000	0.00000
18	302870006	Hypertriglyceridemia (disorder)	57	192127007	Child attention deficit disorder	1095	64	76	6	58	70	961	1.35074	0.02387	1.42020	3.40634	0.59212	0.4421125672	1.0000000000	4.44201	0.36322	28	24	1	36	52	5	0.78526	1.26316
17	368581000119106	Neuropathy due to type 2 diabetes mellitus (disorder)	57	192127007	Child attention deficit disorder	1095	28	76	5	23	71	996	2.57284	0.06958	3.04960	8.26181	1.12567	0.0392853481	0.3768817329	1.94338	1.02749	7	24	1	21	52	4	0.57982	0.24686
129	47505003	Posttraumatic stress disorder	31	230690007	Stroke	1095	4	62	1	3	61	1030	4.41532	0.05066	5.62842	54.90978	0.57693	0.2082252145	0.8610424124	0.22648	0.70547	1	32	1	3	30	0	3.49651	0.69315
15	40055000	Chronic sinusitis (disorder)	57	192127007	Child attention deficit disorder	1095	216	76	18	198	58	821	1.20066	0.02716	1.28683	2.23290	0.74161	0.3709263266	1.0000000000	14.99178	0.24867	104	24	5	112	52	13	0.14842	0.81855
14	10509002	Acute bronchitis (disorder)	57	192127007	Child attention deficit disorder	1095	863	76	59	804	17	215	0.98501	-0.00789	0.92808	1.62494	0.53007	0.7721055282	1.0000000000	59.89772	-0.02143	418	24	17	445	52	42	0.07473	0.79154
13	370247008	Facial laceration	57	192127007	Child attention deficit disorder	1095	109	76	7	102	69	917	0.92528	-0.00678	0.91205	2.03780	0.40820	1.0000000000	1.0000000000	7.56530	-0.09850	55	24	2	54	52	5	0.13134	0.88180
125	1734006	Fracture of the vertebral column with spinal cord injury	31	230690007	Stroke	1095	5	62	0	5	62	1028	0.00000	-0.01659	0.00000	0.00000	0.00000	1.0000000000	1.0000000000	0.28311	-0.35964	3	32	0	2	30	0	0.00000	0.00000
124	1501000119109	Proliferative diabetic retinopathy due to type II diabetes mellitus (disorder)	31	230690007	Stroke	1095	1	62	0	1	62	1032	0.00000	-0.00741	0.00000	0.00000	0.00000	1.0000000000	1.0000000000	0.05662	-0.07946	1	32	0	0	30	0	0.00000	0.00000
10	62106007	Concussion with no loss of consciousness	57	192127007	Child attention deficit disorder	1095	206	76	16	190	60	829	1.11906	0.01565	1.16351	2.06473	0.65566	0.6476980929	1.0000000000	14.29772	0.15222	96	24	4	110	52	12	0.27193	0.89976
121	254637007	Non-small cell lung cancer (disorder)	31	230690007	Stroke	1095	8	62	0	8	62	1025	0.00000	-0.02102	0.00000	0.00000	0.00000	1.0000000000	1.0000000000	0.45297	-0.53900	0	32	0	8	30	0	0.00000	0.00000
7	75498004	Acute bacterial sinusitis (disorder)	57	192127007	Child attention deficit disorder	1095	187	76	10	177	66	842	0.77048	-0.02845	0.72077	1.42920	0.36349	0.4298419513	1.0000000000	12.97900	-0.34576	89	24	3	98	52	7	0.06560	0.71513
6	39848009	Whiplash injury to neck	57	192127007	Child attention deficit disorder	1095	182	76	10	172	66	847	0.79164	-0.02541	0.74612	1.48013	0.37612	0.5223056707	1.0000000000	12.63196	-0.30949	92	24	2	90	52	8	0.55005	1.34462
5	284549007	Laceration of hand	57	192127007	Child attention deficit disorder	1095	104	76	5	99	71	920	0.69269	-0.02719	0.65443	1.65909	0.25814	0.5408099556	1.0000000000	7.21826	-0.45387	54	24	2	50	52	3	-0.34377	0.46052
117	230265002	Familial Alzheimer's disease of early onset (disorder)	31	230690007	Stroke	1095	6	62	2	4	60	1029	5.88710	0.08887	8.57500	47.75459	1.53976	0.0408338819	0.3862498006	0.33973	1.16302	2	32	1	4	30	1	0.06252	-0.51083
116	370143000	Major depression disorder	31	230690007	Stroke	1095	8	62	1	7	61	1026	2.20766	0.02538	2.40281	19.84183	0.29098	0.3736458814	1.0000000000	0.45297	0.46100	3	32	0	5	30	1	-3.43399	-1.79176
115	36923009	Major depression  single episode	31	230690007	Stroke	1095	6	62	0	6	62	1027	0.00000	-0.01818	0.00000	0.00000	0.00000	1.0000000000	1.0000000000	0.33973	-0.42194	3	32	0	3	30	0	0.00000	0.00000
114	449868002	Smokes tobacco daily	31	230690007	Stroke	1095	9	62	3	6	59	1027	5.88710	0.10899	8.70339	35.66746	2.12376	0.0113736338	0.1677945500	0.50959	1.40584	2	32	0	7	30	3	-2.39790	-1.20397
113	443165006	Pathological fracture due to osteoporosis (disorder)	31	230690007	Stroke	1095	10	62	3	7	59	1026	5.29839	0.10110	7.45278	29.55675	1.87923	0.0155982619	0.2122814615	0.56621	1.35272	7	32	2	3	30	1	-0.60077	0.11778
112	49436004	Atrial Fibrillation	31	230690007	Stroke	1095	35	62	14	21	48	1012	7.06452	0.26997	14.05556	29.33093	6.73550	0.0000000007	0.0000000565	1.98174	2.33074	9	32	4	26	30	10	0.81093	-0.10228
111	235919008	Cholelithiasis	31	230690007	Stroke	1095	9	62	3	6	59	1027	5.88710	0.10899	8.70339	35.66746	2.12376	0.0113736338	0.1677945500	0.50959	1.40584	7	32	2	2	30	1	-0.60077	0.40547
110	65275009	Acute Cholecystitis	31	230690007	Stroke	1095	9	62	3	6	59	1027	5.88710	0.10899	8.70339	35.66746	2.12376	0.0113736338	0.1677945500	0.50959	1.40584	7	32	2	2	30	1	-0.60077	0.40547
109	90560007	Gout	31	230690007	Stroke	1095	4	62	0	4	62	1029	0.00000	-0.01483	0.00000	0.00000	0.00000	1.0000000000	1.0000000000	0.22648	-0.29453	0	32	0	4	30	0	0.00000	0.00000
108	40930008	Hypothyroidism (disorder)	31	230690007	Stroke	1095	13	62	2	11	60	1022	2.71712	0.04611	3.09697	14.28759	0.67130	0.1648547987	0.7915572889	0.73607	0.78913	11	32	1	2	30	1	0.06252	1.38629
107	40275004	Contact dermatitis	31	230690007	Stroke	1095	18	62	1	17	61	1016	0.98118	-0.00060	0.97975	7.48434	0.12826	1.0000000000	1.0000000000	1.01918	-0.01377	9	32	1	9	30	0	3.49651	2.30259
106	24079001	Atopic dermatitis	31	230690007	Stroke	1095	20	62	0	20	62	1013	0.00000	-0.03342	0.00000	0.00000	0.00000	0.6228372302	1.0000000000	1.13242	-1.09249	13	32	0	7	30	0	0.00000	0.00000
105	363406005	Malignant tumor of colon	31	230690007	Stroke	1095	6	62	1	5	61	1028	2.94355	0.03534	3.37049	29.29961	0.38773	0.2956980218	0.9835684864	0.33973	0.57806	4	32	0	2	30	1	-3.43399	-1.09861
104	367498001	Seasonal allergic rhinitis	31	230690007	Stroke	1095	20	62	0	20	62	1013	0.00000	-0.03342	0.00000	0.00000	0.00000	0.6228372302	1.0000000000	1.13242	-1.09249	9	32	0	11	30	0	0.00000	0.00000
102	90781000119102	Microalbuminuria due to type 2 diabetes mellitus (disorder)	31	230690007	Stroke	1095	6	62	0	6	62	1027	0.00000	-0.01818	0.00000	0.00000	0.00000	1.0000000000	1.0000000000	0.33973	-0.42194	3	32	0	3	30	0	0.00000	0.00000
101	433144002	Chronic kidney disease stage 3 (disorder)	31	230690007	Stroke	1095	3	62	0	3	62	1030	0.00000	-0.01284	0.00000	0.00000	0.00000	1.0000000000	1.0000000000	0.16986	-0.22634	1	32	0	2	30	0	0.00000	0.00000
100	161622006	History of lower limb amputation (situation)	31	230690007	Stroke	1095	1	62	0	1	62	1032	0.00000	-0.00741	0.00000	0.00000	0.00000	1.0000000000	1.0000000000	0.05662	-0.07946	0	32	0	1	30	0	0.00000	0.00000
99	30832001	Rupture of patellar tendon	31	230690007	Stroke	1095	23	62	1	22	61	1011	0.76788	-0.00833	0.75335	5.68247	0.09988	1.0000000000	1.0000000000	1.30228	-0.20307	14	32	0	9	30	1	-3.43399	-2.30259
98	1551000119108	Nonproliferative diabetic retinopathy due to type 2 diabetes mellitus (disorder)	31	230690007	Stroke	1095	12	62	1	11	61	1022	1.47177	0.01217	1.52310	11.99033	0.19348	0.5049467690	1.0000000000	0.67945	0.25201	7	32	1	5	30	0	3.49651	2.07944
97	403192003	Third degree burn	31	230690007	Stroke	1095	8	62	3	5	59	1028	6.62298	0.11818	10.45424	44.80031	2.43952	0.0078990451	0.1296033984	0.45297	1.46100	3	32	1	5	30	2	0.72392	0.13353
96	283371005	Laceration of forearm	31	230690007	Stroke	1095	75	62	7	68	55	965	1.64839	0.04307	1.80615	4.11761	0.79225	0.1873139540	0.8181443419	4.24658	0.60862	39	32	5	36	30	2	-0.77111	-0.76969
95	84757009	Epilepsy	31	230690007	Stroke	1095	30	62	1	29	61	1004	0.58871	-0.01691	0.56755	4.23649	0.07603	1.0000000000	1.0000000000	1.69863	-0.43223	13	32	1	17	30	0	3.49651	2.63906
94	703151001	History of single seizure (situation)	31	230690007	Stroke	1095	39	62	2	37	60	996	0.90571	-0.00444	0.89730	3.81202	0.21121	1.0000000000	1.0000000000	2.20822	-0.09681	14	32	1	25	30	1	0.06252	-0.55005
93	128613002	Seizure disorder	31	230690007	Stroke	1095	39	62	2	37	60	996	0.90571	-0.00444	0.89730	3.81202	0.21121	1.0000000000	1.0000000000	2.20822	-0.09681	14	32	1	25	30	1	0.06252	-0.55005
92	82423001	Chronic pain	31	230690007	Stroke	1095	52	62	2	50	60	983	0.67928	-0.01754	0.65533	2.75818	0.15570	0.7635906941	1.0000000000	2.94429	-0.39480	24	32	1	28	30	1	0.06252	-0.14842
91	64859006	Osteoporosis (disorder)	31	230690007	Stroke	1095	37	62	14	23	48	1010	6.68265	0.26035	12.80797	26.43808	6.20484	0.0000000018	0.0000001318	2.09498	2.27696	24	32	9	13	30	5	-0.42956	0.01835
89	47693006	Rupture of appendix	31	230690007	Stroke	1095	20	62	1	19	61	1014	0.88306	-0.00391	0.87489	6.64431	0.11520	1.0000000000	1.0000000000	1.13242	-0.09249	10	32	1	10	30	0	3.49651	2.39790
88	197927001	Recurrent urinary tract infection	31	230690007	Stroke	1095	8	62	1	7	61	1026	2.20766	0.02538	2.40281	19.84183	0.29098	0.3736458814	1.0000000000	0.45297	0.46100	8	32	1	0	30	0	3.49651	2.19722
128	86849004	Suicidal deliberate poisoning	4	195662009	Acute viral pharyngitis (disorder)	1095	1	890	1	0	889	205	1.23034	0.01451	0.00000	0.00000	0.00000	1.0000000000	1.0000000000	0.81279	0.14179	0	430	0	1	460	1	-6.13340	-0.69315
86	713197008	Recurrent rectal polyp	31	230690007	Stroke	1095	22	62	3	19	59	1014	2.40836	0.04940	2.71365	9.43017	0.78089	0.1236524955	0.6913144812	1.24566	0.83286	12	32	0	10	30	3	-2.39790	-1.46634
85	241929008	Acute allergic reaction	31	230690007	Stroke	1095	47	62	0	47	62	986	0.00000	-0.05188	0.00000	0.00000	0.00000	0.1053516752	0.6378432720	2.66119	-1.87231	25	32	0	22	30	0	0.00000	0.00000
131	93761005	Primary malignant neoplasm of colon	4	195662009	Acute viral pharyngitis (disorder)	1095	5	890	4	1	886	204	0.98427	-0.00222	0.92099	8.28367	0.10240	1.0000000000	1.0000000000	4.06393	-0.01833	3	430	3	2	460	1	-1.16127	-0.40547
83	110030002	Concussion injury of brain	31	230690007	Stroke	1095	7	62	0	7	62	1026	0.00000	-0.01965	0.00000	0.00000	0.00000	1.0000000000	1.0000000000	0.39635	-0.48166	1	32	0	6	30	0	0.00000	0.00000
82	94260004	Secondary malignant neoplasm of colon	31	230690007	Stroke	1095	4	62	0	4	62	1029	0.00000	-0.01483	0.00000	0.00000	0.00000	1.0000000000	1.0000000000	0.22648	-0.29453	2	32	0	2	30	0	0.00000	0.00000
81	236077008	Protracted diarrhea	31	230690007	Stroke	1095	4	62	0	4	62	1029	0.00000	-0.01483	0.00000	0.00000	0.00000	1.0000000000	1.0000000000	0.22648	-0.29453	2	32	0	2	30	0	0.00000	0.00000
80	6072007	Bleeding from anus	31	230690007	Stroke	1095	4	62	0	4	62	1029	0.00000	-0.01483	0.00000	0.00000	0.00000	1.0000000000	1.0000000000	0.22648	-0.29453	2	32	0	2	30	0	0.00000	0.00000
79	45816000	Pyelonephritis	31	230690007	Stroke	1095	1	62	0	1	62	1032	0.00000	-0.00741	0.00000	0.00000	0.00000	1.0000000000	1.0000000000	0.05662	-0.07946	1	32	0	0	30	0	0.00000	0.00000
78	239872002	Osteoarthritis of hip	31	230690007	Stroke	1095	21	62	3	18	59	1015	2.52304	0.05218	2.86723	10.00882	0.82138	0.1110983703	0.6576004682	1.18904	0.86970	13	32	2	8	30	1	-0.60077	-0.18232
76	127013003	Diabetic renal disease (disorder)	31	230690007	Stroke	1095	28	62	4	24	58	1009	2.52304	0.06044	2.89943	8.63305	0.97378	0.0686236911	0.5135368799	1.58539	0.95155	10	32	1	18	30	3	1.09861	0.45199
75	431855005	Chronic kidney disease stage 1 (disorder)	31	230690007	Stroke	1095	28	62	4	24	58	1009	2.52304	0.06044	2.89943	8.63305	0.97378	0.0686236911	0.5135368799	1.58539	0.95155	10	32	1	18	30	3	1.09861	0.45199
73	196416002	Impacted molars	31	230690007	Stroke	1095	49	62	2	47	60	986	0.72087	-0.01480	0.69929	2.94820	0.16587	1.0000000000	1.0000000000	2.77443	-0.33130	25	32	0	24	30	2	-2.77259	-2.56495
72	35999006	Blighted ovum	31	230690007	Stroke	1095	53	62	4	49	58	984	1.33293	0.01839	1.38494	3.96974	0.48317	0.5357392157	1.0000000000	3.00091	0.32160	53	32	4	0	30	0	2.19722	2.65676
71	201834006	Localized  primary osteoarthritis of the hand	31	230690007	Stroke	1095	28	62	4	24	58	1009	2.52304	0.06044	2.89943	8.63305	0.97378	0.0686236911	0.5135368799	1.58539	0.95155	19	32	3	9	30	1	-0.97725	-0.31015
70	87433001	Pulmonary emphysema (disorder)	31	230690007	Stroke	1095	17	62	0	17	62	1016	0.00000	-0.03077	0.00000	0.00000	0.00000	0.6181315535	1.0000000000	0.96256	-0.97273	9	32	0	8	30	0	0.00000	0.00000
69	233604007	Pneumonia	31	230690007	Stroke	1095	7	62	3	4	59	1029	7.56912	0.12909	13.08051	59.79324	2.86152	0.0051435409	0.0930988016	0.39635	1.51834	3	32	1	4	30	2	0.72392	0.28768
68	26929004	Alzheimer's disease (disorder)	31	230690007	Stroke	1095	23	62	7	16	55	1017	5.37518	0.15700	8.08977	20.47709	3.19598	0.0001590913	0.0052500144	1.30228	1.79693	15	32	4	8	30	3	-0.20067	0.25886
67	403191005	Second degree burn	31	230690007	Stroke	1095	49	62	2	47	60	986	0.72087	-0.01480	0.69929	2.94820	0.16587	1.0000000000	1.0000000000	2.77443	-0.33130	23	32	2	26	30	0	2.83321	2.52573
65	239873007	Osteoarthritis of knee	31	230690007	Stroke	1095	57	62	8	49	54	984	2.47878	0.08490	2.97506	6.59471	1.34213	0.0121347031	0.1751947754	3.22740	1.09016	30	32	4	27	30	4	0.05716	0.09237
64	444448004	Injury of medial collateral ligament of knee	31	230690007	Stroke	1095	32	62	3	29	59	1004	1.65575	0.02787	1.76037	5.94681	0.52111	0.4205896398	1.0000000000	1.81187	0.50847	17	32	1	15	30	2	0.72392	0.75031
63	68496003	Polyp of colon	31	230690007	Stroke	1095	91	62	12	79	50	954	2.32896	0.09802	2.89823	5.66680	1.48227	0.0034722479	0.0680343568	5.15251	1.07926	43	32	4	48	30	8	0.63908	0.51794
62	185086009	Chronic obstructive bronchitis (disorder)	31	230690007	Stroke	1095	6	62	1	5	61	1028	2.94355	0.03534	3.37049	29.29961	0.38773	0.2956980218	0.9835684864	0.33973	0.57806	4	32	1	2	30	0	3.49651	1.60944
60	301011002	Escherichia coli urinary tract infection	31	230690007	Stroke	1095	92	62	3	89	59	944	0.57591	-0.03147	0.53933	1.75549	0.16569	0.4757891839	1.0000000000	5.20913	-0.63439	85	32	3	7	30	0	2.45674	3.37872
59	262574004	Bullet wound	31	230690007	Stroke	1095	20	62	1	19	61	1014	0.88306	-0.00391	0.87489	6.64431	0.11520	1.0000000000	1.0000000000	1.13242	-0.09249	9	32	1	11	30	0	3.49651	2.30259
58	239720000	Tear of meniscus of knee	31	230690007	Stroke	1095	20	62	1	19	61	1014	0.88306	-0.00391	0.87489	6.64431	0.11520	1.0000000000	1.0000000000	1.13242	-0.09249	10	32	1	10	30	0	3.49651	2.39790
57	192127007	Child attention deficit disorder	31	230690007	Stroke	1095	76	62	1	75	61	958	0.23239	-0.05136	0.20940	1.53170	0.02863	0.1184564161	0.6831868727	4.30320	-1.40686	24	32	1	52	30	0	3.49651	3.21888
56	92691004	Carcinoma in situ of prostate (disorder)	31	230690007	Stroke	1095	23	62	9	14	53	1019	6.91094	0.21211	12.35984	29.85031	5.11772	0.0000014627	0.0000729504	1.30228	2.11886	0	32	0	23	30	9	-1.46634	-1.26851
54	5602001	Opioid abuse (disorder)	31	230690007	Stroke	1095	7	62	1	6	61	1027	2.52304	0.02993	2.80601	23.67615	0.33256	0.3357960224	1.0000000000	0.39635	0.51834	0	32	0	7	30	1	-3.43399	-2.07944
53	7200002	Alcoholism	31	230690007	Stroke	1095	5	62	1	4	61	1029	3.53226	0.04202	4.21721	38.30774	0.46426	0.2532206652	0.9133257124	0.28311	0.64036	0	32	0	5	30	1	-3.43399	-1.79176
52	124171000119105	Chronic intractable migraine without aura	31	230690007	Stroke	1095	51	62	2	49	60	984	0.69260	-0.01665	0.66939	2.81887	0.15896	1.0000000000	1.0000000000	2.88767	-0.37394	21	32	0	30	30	2	-2.77259	-2.77259
50	446096008	Perennial allergic rhinitis	31	230690007	Stroke	1095	26	62	0	26	62	1007	0.00000	-0.03821	0.00000	0.00000	0.00000	0.3941944243	1.0000000000	1.47215	-1.30576	14	32	0	12	30	0	0.00000	0.00000
49	88805009	Chronic congestive heart failure (disorder)	31	230690007	Stroke	1095	10	62	3	7	59	1026	5.29839	0.10110	7.45278	29.55675	1.87923	0.0155982619	0.2122814615	0.56621	1.35272	5	32	2	5	30	1	-0.60077	-0.53900
47	359817006	Closed fracture of hip	31	230690007	Stroke	1095	29	62	3	26	59	1007	1.82703	0.03342	1.96936	6.69456	0.57933	0.2231915591	0.8794911525	1.64201	0.59836	11	32	2	18	30	1	-0.60077	-1.07264
46	62564004	Concussion with loss of consciousness	31	230690007	Stroke	1095	67	62	1	66	61	967	0.26360	-0.04606	0.24019	1.75999	0.03278	0.1717493595	0.7972585288	3.79361	-1.26111	36	32	1	31	30	0	3.49651	3.61092
45	263102004	Fracture subluxation of wrist	31	230690007	Stroke	1095	109	62	8	101	54	932	1.29624	0.02413	1.36707	2.95366	0.63273	0.3855812845	1.0000000000	6.17169	0.32761	51	32	4	58	30	4	0.05716	-0.11980
44	58150001	Fracture of clavicle	31	230690007	Stroke	1095	112	62	6	106	56	927	0.94614	-0.00445	0.93699	2.22666	0.39429	1.0000000000	1.0000000000	6.34155	-0.06873	55	32	1	57	30	5	1.55060	1.50766
43	307731004	Injury of tendon of the rotator cuff of shoulder	31	230690007	Stroke	1095	51	62	2	49	60	984	0.69260	-0.01665	0.66939	2.81887	0.15896	1.0000000000	1.0000000000	2.88767	-0.37394	26	32	0	25	30	2	-2.77259	-2.60269
42	16114001	Fracture of ankle	31	230690007	Stroke	1095	108	62	8	100	54	933	1.30824	0.02498	1.38222	2.98713	0.63959	0.3816757292	1.0000000000	6.11507	0.33905	48	32	4	60	30	4	0.05716	-0.20764
41	283385000	Laceration of thigh	31	230690007	Stroke	1095	105	62	17	88	45	945	2.85945	0.14836	4.05682	7.38617	2.22819	0.0000269125	0.0010361314	5.94521	1.37391	50	32	10	55	30	7	-0.22992	-0.38946
40	428251008	History of appendectomy	31	230690007	Stroke	1095	51	62	2	49	60	984	0.69260	-0.01665	0.66939	2.81887	0.15896	1.0000000000	1.0000000000	2.88767	-0.37394	27	32	1	24	30	1	0.06252	0.11333
39	74400008	Appendicitis	31	230690007	Stroke	1095	51	62	2	49	60	984	0.69260	-0.01665	0.66939	2.81887	0.15896	1.0000000000	1.0000000000	2.88767	-0.37394	27	32	1	24	30	1	0.06252	0.11333
38	398254007	Preeclampsia	31	230690007	Stroke	1095	101	62	9	92	53	941	1.57378	0.04481	1.73687	3.63434	0.83006	0.1695239135	0.7970438739	5.71872	0.57374	101	32	9	0	30	0	1.51635	2.50326
37	38822007	Cystitis	31	230690007	Stroke	1095	71	62	5	66	57	967	1.24375	0.01572	1.28522	3.31510	0.49826	0.5918891516	1.0000000000	4.02009	0.25725	68	32	5	3	30	0	2.00148	2.68102
35	19169002	Miscarriage in first trimester	31	230690007	Stroke	1095	174	62	16	158	46	875	1.62403	0.06645	1.92625	3.48731	1.06399	0.0466919339	0.4138417772	9.85205	0.64757	174	32	16	0	30	0	1.09861	2.47444
33	429007001	History of cardiac arrest (situation)	31	230690007	Stroke	1095	42	62	2	40	60	993	0.84101	-0.00778	0.82750	3.50605	0.19531	1.0000000000	1.0000000000	2.37808	-0.17124	24	32	2	18	30	0	2.83321	2.56495
32	410429000	Cardiac Arrest	31	230690007	Stroke	1095	42	62	2	40	60	993	0.84101	-0.00778	0.82750	3.50605	0.19531	1.0000000000	1.0000000000	2.37808	-0.17124	24	32	2	18	30	0	2.83321	2.56495
30	399211009	History of myocardial infarction (situation)	31	230690007	Stroke	1095	31	62	1	30	61	1003	0.56972	-0.01799	0.54809	4.08671	0.07351	1.0000000000	1.0000000000	1.75525	-0.46218	2	32	0	29	30	1	-3.43399	-3.40120
29	22298006	Myocardial Infarction	31	230690007	Stroke	1095	31	62	1	30	61	1003	0.56972	-0.01799	0.54809	4.08671	0.07351	1.0000000000	1.0000000000	1.75525	-0.46218	2	32	0	29	30	1	-3.43399	-3.40120
28	53741008	Coronary Heart Disease	31	230690007	Stroke	1095	80	62	9	71	53	962	1.98690	0.06788	2.30082	4.85430	1.09054	0.0390811563	0.3768817329	4.52968	0.85473	24	32	5	56	30	4	-0.13859	-0.95019
27	408512008	Body mass index 40+ - severely obese (finding)	31	230690007	Stroke	1095	97	62	6	91	56	942	1.09245	0.00706	1.10911	2.64465	0.46513	0.8169579559	1.0000000000	5.49224	0.10864	67	32	5	30	30	1	-1.43251	-0.76676
26	33737001	Fracture of rib	31	230690007	Stroke	1095	54	62	5	49	57	984	1.63530	0.03545	1.76155	4.59197	0.67575	0.2248299614	0.8806400682	3.05753	0.56436	32	32	3	22	30	2	-0.31585	-0.02817
24	162864005	Body mass index 30+ - obesity (finding)	31	230690007	Stroke	1095	439	62	38	401	24	632	1.52877	0.10597	2.49543	4.22318	1.47452	0.0007270925	0.0192822308	24.85662	0.59294	226	32	23	213	30	15	-0.22677	-0.33934
23	36971009	Sinusitis (disorder)	31	230690007	Stroke	1095	190	62	23	167	39	866	2.13795	0.12774	3.05819	5.25447	1.77992	0.0001783192	0.0058406180	10.75799	1.02939	84	32	10	106	30	13	0.23883	0.02654
22	70704007	Sprain of wrist	31	230690007	Stroke	1095	195	62	14	181	48	852	1.26799	0.03056	1.37293	2.54343	0.74110	0.3068830874	0.9977249576	11.04110	0.31700	90	32	6	105	30	8	0.28768	0.12464
21	15777000	Prediabetes	31	230690007	Stroke	1095	333	62	36	297	26	736	1.90933	0.14727	3.43124	5.78368	2.03562	0.0000055491	0.0002497945	18.85479	0.89804	159	32	17	174	30	19	0.11123	0.01902
20	80394007	Hyperglycemia (disorder)	31	230690007	Stroke	1095	55	62	8	47	54	986	2.56891	0.08839	3.10796	6.90371	1.39916	0.0097903017	0.1523745890	3.11416	1.12933	23	32	3	32	30	5	0.51083	0.15800
19	237602007	Metabolic syndrome X (disorder)	31	230690007	Stroke	1095	64	62	10	54	52	979	2.75958	0.10740	3.48647	7.23561	1.67995	0.0021838649	0.0463042664	3.62374	1.25037	28	32	4	36	30	6	0.40547	0.13353
18	302870006	Hypertriglyceridemia (disorder)	31	230690007	Stroke	1095	64	62	10	54	52	979	2.75958	0.10740	3.48647	7.23561	1.67995	0.0021838649	0.0463042664	3.62374	1.25037	28	32	4	36	30	6	0.40547	0.13353
17	368581000119106	Neuropathy due to type 2 diabetes mellitus (disorder)	31	230690007	Stroke	1095	28	62	6	22	56	1011	3.78456	0.11051	4.92370	12.62908	1.91960	0.0036472151	0.0707538718	1.58539	1.43697	7	32	1	21	30	5	1.55060	0.43078
129	47505003	Posttraumatic stress disorder	5	284549007	Laceration of hand	1095	4	104	0	4	104	987	0.00000	-0.01962	0.00000	0.00000	0.00000	1.0000000000	1.0000000000	0.37991	-0.46457	1	54	0	3	50	0	0.00000	0.00000
15	40055000	Chronic sinusitis (disorder)	31	230690007	Stroke	1095	216	62	31	185	31	848	2.53472	0.18638	4.58378	7.73028	2.71802	0.0000000321	0.0000020129	12.23014	1.27424	104	32	15	112	30	16	0.08604	-0.00837
14	10509002	Acute bronchitis (disorder)	31	230690007	Stroke	1095	863	62	59	804	3	229	1.20743	0.09801	5.60158	18.03475	1.73984	0.0003712523	0.0109725669	48.86393	0.26697	418	32	30	445	30	29	0.01570	-0.09032
13	370247008	Facial laceration	31	230690007	Stroke	1095	109	62	8	101	54	932	1.29624	0.02413	1.36707	2.95366	0.63273	0.3855812845	1.0000000000	6.17169	0.32761	55	32	2	54	30	6	1.04145	1.04732
12	65966004	Fracture of forearm	31	230690007	Stroke	1095	123	62	13	110	49	923	1.86664	0.07553	2.22616	4.23301	1.17075	0.0205692373	0.2546639839	6.96438	0.81379	55	32	8	68	30	5	-0.33647	-0.61733
11	38341003	Hypertension	31	230690007	Stroke	1095	278	62	26	252	36	781	1.65178	0.09314	2.23832	3.78015	1.32536	0.0038461083	0.0733937795	15.74064	0.68960	131	32	14	147	30	12	-0.06318	-0.24632
10	62106007	Concussion with no loss of consciousness	31	230690007	Stroke	1095	206	62	19	187	43	846	1.62895	0.07417	1.99901	3.50897	1.13880	0.0188248327	0.2387924584	11.66393	0.65928	96	32	9	110	30	10	0.13005	-0.02817
9	44465007	Sprain of ankle	31	230690007	Stroke	1095	362	62	22	340	40	693	1.07334	0.01263	1.12103	1.91636	0.65578	0.6783337326	1.0000000000	20.49680	0.09751	185	32	9	177	30	13	0.32010	0.38856
8	233678006	Childhood asthma	31	230690007	Stroke	1095	45	62	1	44	61	989	0.39247	-0.03081	0.36848	2.71975	0.04992	0.5096665751	1.0000000000	2.54795	-0.82698	25	32	1	20	30	0	3.49651	3.25810
7	75498004	Acute bacterial sinusitis (disorder)	31	230690007	Stroke	1095	187	62	16	171	46	862	1.51113	0.05683	1.75337	3.16955	0.96995	0.0799302367	0.5595116571	10.58813	0.55289	89	32	7	98	30	9	0.25131	0.14283
6	39848009	Whiplash injury to neck	31	230690007	Stroke	1095	182	62	10	172	52	861	0.97040	-0.00324	0.96266	1.93137	0.47982	1.0000000000	1.0000000000	10.30502	-0.03946	92	32	5	90	30	5	0.05557	0.02083
5	284549007	Laceration of hand	31	230690007	Stroke	1095	104	62	7	97	55	936	1.18874	0.01498	1.22812	2.77131	0.54424	0.6533201628	1.0000000000	5.88858	0.21579	54	32	4	50	30	3	-0.20067	-0.19753
4	195662009	Acute viral pharyngitis (disorder)	31	230690007	Stroke	1095	890	62	58	832	4	201	1.15096	0.07706	3.50300	9.76180	1.25705	0.0072092315	0.1207683861	50.39269	0.19915	430	32	29	460	30	29	0.03334	-0.06331
3	65363002	Otitis media	31	230690007	Stroke	1095	580	62	9	571	53	462	0.27405	-0.18874	0.13740	0.28148	0.06707	0.0000000002	0.0000000166	32.84018	-1.75874	277	32	4	303	30	5	0.25131	0.13140
1	444814009	Viral sinusitis (disorder)	31	230690007	Stroke	1095	993	62	62	931	0	102	1.10272	0.07852	0.00000	0.00000	0.00000	0.0029323059	0.0589011015	56.22466	0.13871	478	32	32	515	30	30	0.00000	-0.13091
109	90560007	Gout	5	284549007	Laceration of hand	1095	4	104	0	4	104	987	0.00000	-0.01962	0.00000	0.00000	0.00000	1.0000000000	1.0000000000	0.37991	-0.46457	0	54	0	4	50	0	0.00000	0.00000
102	90781000119102	Microalbuminuria due to type 2 diabetes mellitus (disorder)	5	284549007	Laceration of hand	1095	6	104	1	5	103	986	1.75481	0.01815	1.91456	16.54521	0.22155	0.4513054294	1.0000000000	0.56986	0.34936	3	54	1	3	50	0	4.00733	1.38629
98	1551000119108	Nonproliferative diabetic retinopathy due to type 2 diabetes mellitus (disorder)	5	284549007	Laceration of hand	1095	12	104	1	11	103	980	0.87740	-0.00418	0.86496	6.76721	0.11056	1.0000000000	1.0000000000	1.13973	-0.09743	7	54	1	5	50	0	4.00733	2.07944
97	403192003	Third degree burn	5	284549007	Laceration of hand	1095	8	104	0	8	104	983	0.00000	-0.02779	0.00000	0.00000	0.00000	1.0000000000	1.0000000000	0.75982	-0.81543	3	54	0	5	50	0	0.00000	0.00000
96	283371005	Laceration of forearm	5	284549007	Laceration of hand	1095	75	104	7	68	97	923	0.98269	-0.00152	0.97953	2.19230	0.43766	1.0000000000	1.0000000000	7.12329	-0.02206	39	54	5	36	50	2	-0.79000	-0.76969
94	703151001	History of single seizure (situation)	5	284549007	Laceration of hand	1095	39	104	5	34	99	957	1.34985	0.02178	1.42157	3.71753	0.54360	0.4087278672	1.0000000000	3.70411	0.35104	14	54	2	25	50	3	0.46052	-0.15415
93	128613002	Seizure disorder	5	284549007	Laceration of hand	1095	39	104	5	34	99	957	1.34985	0.02178	1.42157	3.71753	0.54360	0.4087278672	1.0000000000	3.70411	0.35104	14	54	2	25	50	3	0.46052	-0.15415
89	47693006	Rupture of appendix	5	284549007	Laceration of hand	1095	20	104	2	18	102	973	1.05288	0.00234	1.05991	4.63313	0.24247	1.0000000000	1.0000000000	1.89954	0.04914	10	54	2	10	50	0	3.33220	1.79176
86	713197008	Recurrent rectal polyp	5	284549007	Laceration of hand	1095	22	104	2	20	102	971	0.95717	-0.00199	0.95196	4.13119	0.21936	1.0000000000	1.0000000000	2.08950	-0.04241	12	54	1	10	50	1	0.07551	0.16705
75	431855005	Chronic kidney disease stage 1 (disorder)	5	284549007	Laceration of hand	1095	28	104	4	24	100	967	1.50412	0.02646	1.61167	4.73797	0.54822	0.3305764698	1.0000000000	2.65936	0.45034	10	54	2	18	50	2	0.07411	-0.51083
72	35999006	Blighted ovum	5	284549007	Laceration of hand	1095	53	104	6	47	98	944	1.19194	0.01402	1.22970	2.94926	0.51273	0.6292957510	1.0000000000	5.03379	0.21429	53	54	6	0	50	0	2.30259	2.28578
69	233604007	Pneumonia	5	284549007	Laceration of hand	1095	7	104	0	7	104	984	0.00000	-0.02598	0.00000	0.00000	0.00000	1.0000000000	1.0000000000	0.66484	-0.73538	3	54	0	4	50	0	0.00000	0.00000
67	403191005	Second degree burn	5	284549007	Laceration of hand	1095	49	104	1	48	103	943	0.21487	-0.05505	0.19074	1.39631	0.02605	0.0786431174	0.5540363441	4.65388	-1.49924	23	54	0	26	50	1	-3.93183	-3.29584
64	444448004	Injury of medial collateral ligament of knee	5	284549007	Laceration of hand	1095	32	104	1	31	103	960	0.32903	-0.03771	0.30066	2.22529	0.04062	0.3547226459	1.0000000000	3.03927	-1.01409	17	54	0	15	50	1	-3.93183	-2.77259
63	68496003	Polyp of colon	5	284549007	Laceration of hand	1095	91	104	9	82	95	909	1.04131	0.00403	1.05019	2.15746	0.51121	0.8522543852	1.0000000000	8.64292	0.05246	43	54	5	48	50	4	-0.13459	-0.30319
58	239720000	Tear of meniscus of knee	5	284549007	Laceration of hand	1095	20	104	0	20	104	971	0.00000	-0.04419	0.00000	0.00000	0.00000	0.2470285935	0.9133257124	1.89954	-1.53583	10	54	0	10	50	0	0.00000	0.00000
50	446096008	Perennial allergic rhinitis	5	284549007	Laceration of hand	1095	26	104	1	25	103	966	0.40496	-0.03006	0.37515	2.79725	0.05031	0.5031043564	1.0000000000	2.46941	-0.79469	14	54	1	12	50	0	4.00733	2.70805
49	88805009	Chronic congestive heart failure (disorder)	5	284549007	Laceration of hand	1095	10	104	3	7	101	984	3.15865	0.06713	4.17539	16.39750	1.06320	0.0609600476	0.4820786466	0.94977	1.03669	5	54	2	5	50	1	-0.59962	-0.53900
47	359817006	Closed fracture of hip	5	284549007	Laceration of hand	1095	29	104	1	28	103	963	0.36306	-0.03403	0.33391	2.47961	0.04497	0.5136724057	1.0000000000	2.75434	-0.90856	11	54	0	18	50	1	-3.93183	-2.94444
44	58150001	Fracture of clavicle	5	284549007	Laceration of hand	1095	112	104	6	106	98	885	0.56405	-0.04767	0.51117	1.19421	0.21880	0.1273174887	0.6998077121	10.63744	-0.73335	55	54	3	57	50	3	0.07276	-0.03390
43	307731004	Injury of tendon of the rotator cuff of shoulder	5	284549007	Laceration of hand	1095	51	104	6	45	98	946	1.23869	0.01709	1.28707	3.09326	0.53554	0.6214713615	1.0000000000	4.84384	0.26044	26	54	2	25	50	4	0.72951	0.65806
42	16114001	Fracture of ankle	5	284549007	Laceration of hand	1095	108	104	13	95	91	896	1.26736	0.02865	1.34737	2.50069	0.72596	0.3853534045	1.0000000000	10.25753	0.31454	48	54	9	60	50	4	-0.65678	-0.92676
41	283385000	Laceration of thigh	5	284549007	Laceration of hand	1095	105	104	11	94	93	897	1.10302	0.01087	1.12869	2.18391	0.58333	0.7257914088	1.0000000000	9.97260	0.12913	50	54	7	55	50	4	-0.43773	-0.59410
39	74400008	Appendicitis	5	284549007	Laceration of hand	1095	51	104	3	48	101	943	0.61934	-0.02726	0.58354	1.90729	0.17854	0.4700225459	1.0000000000	4.84384	-0.54692	27	54	3	24	50	0	2.94444	2.30259
38	398254007	Preeclampsia	5	284549007	Laceration of hand	1095	101	104	14	87	90	904	1.45944	0.04744	1.61635	2.95860	0.88305	0.1510368857	0.7644354026	9.59269	0.50189	101	54	14	0	50	0	1.58045	2.10587
35	19169002	Miscarriage in first trimester	5	284549007	Laceration of hand	1095	174	104	27	147	77	844	1.63379	0.08924	2.01325	3.22787	1.25569	0.0047460286	0.0869741935	16.52603	0.67593	174	54	27	0	50	0	1.09861	2.00747
33	429007001	History of cardiac arrest (situation)	5	284549007	Laceration of hand	1095	42	104	7	35	97	956	1.75481	0.04883	1.97113	4.55651	0.85271	0.1087308439	0.6488370819	3.98904	0.68124	24	54	3	18	50	4	0.34175	0.49248
32	410429000	Cardiac Arrest	5	284549007	Laceration of hand	1095	42	104	7	35	97	956	1.75481	0.04883	1.97113	4.55651	0.85271	0.1087308439	0.6488370819	3.98904	0.68124	24	54	3	18	50	4	0.34175	0.49248
127	431856006	Chronic kidney disease stage 2 (disorder)	11	38341003	Hypertension	1095	5	278	1	4	277	813	0.78777	-0.00838	0.73375	6.59272	0.08167	1.0000000000	1.0000000000	1.26941	-0.18231	3	131	0	2	147	1	-4.99721	-1.09861
30	399211009	History of myocardial infarction (situation)	5	284549007	Laceration of hand	1095	31	104	4	27	100	964	1.35856	0.01983	1.42815	4.16387	0.48983	0.5275945651	1.0000000000	2.94429	0.34216	2	54	0	29	50	4	-2.60269	-2.11021
27	408512008	Body mass index 40+ - severely obese (finding)	5	284549007	Laceration of hand	1095	97	104	10	87	94	904	1.08545	0.00863	1.10540	2.19958	0.55552	0.7184556872	1.0000000000	9.21279	0.10713	67	54	7	30	50	3	-0.70672	-0.03974
24	162864005	Body mass index 30+ - obesity (finding)	5	284549007	Laceration of hand	1095	439	104	51	388	53	603	1.22317	0.05914	1.49548	2.24231	0.99739	0.0581441157	0.4685406893	41.69498	0.28445	226	54	29	213	50	22	-0.13408	-0.19458
21	15777000	Prediabetes	5	284549007	Laceration of hand	1095	333	104	49	284	55	707	1.54929	0.11763	2.21786	3.33825	1.47350	0.0001890560	0.0061165372	31.62740	0.61584	159	54	31	174	50	18	-0.32047	-0.55409
20	80394007	Hyperglycemia (disorder)	5	284549007	Laceration of hand	1095	55	104	7	48	97	943	1.34003	0.02533	1.41774	3.21915	0.62438	0.3513116067	1.0000000000	5.22374	0.36222	23	54	2	32	50	5	0.93431	0.52425
18	302870006	Hypertriglyceridemia (disorder)	5	284549007	Laceration of hand	1095	64	104	8	56	96	935	1.31611	0.02551	1.39137	3.00504	0.64422	0.3795683378	1.0000000000	6.07854	0.34647	28	54	3	36	50	5	0.54654	0.23124
17	368581000119106	Neuropathy due to type 2 diabetes mellitus (disorder)	5	284549007	Laceration of hand	1095	28	104	3	25	101	966	1.12809	0.00672	1.14772	3.86806	0.34055	0.7434282846	1.0000000000	2.65936	0.12841	7	54	0	21	50	3	-2.87168	-2.07944
15	40055000	Chronic sinusitis (disorder)	5	284549007	Laceration of hand	1095	216	104	20	196	84	795	0.97489	-0.00403	0.96574	1.61161	0.57871	1.0000000000	1.0000000000	20.51507	-0.03496	104	54	12	112	50	8	-0.27625	-0.43937
14	10509002	Acute bronchitis (disorder)	5	284549007	Laceration of hand	1095	863	104	97	766	7	225	1.18343	0.11461	4.07031	8.89106	1.86338	0.0000426296	0.0015991566	81.96530	0.24027	418	54	50	445	50	47	0.00780	-0.11189
13	370247008	Facial laceration	5	284549007	Laceration of hand	1095	109	104	12	97	92	894	1.15914	0.01714	1.20215	2.27304	0.63579	0.6043862179	1.0000000000	10.35251	0.19550	55	54	5	54	50	7	0.37096	0.31994
10	62106007	Concussion with no loss of consciousness	5	284549007	Laceration of hand	1095	206	104	12	194	92	797	0.61333	-0.06030	0.53586	0.99781	0.28778	0.0478022774	0.4208710036	19.56530	-0.66170	96	54	9	110	50	3	-0.92577	-1.17204
7	75498004	Acute bacterial sinusitis (disorder)	5	284549007	Laceration of hand	1095	187	104	18	169	86	822	1.01347	0.00198	1.01803	1.73703	0.59664	0.8919568241	1.0000000000	17.76073	0.01828	89	54	10	98	50	8	-0.12470	-0.29146
6	39848009	Whiplash injury to neck	5	284549007	Laceration of hand	1095	182	104	21	161	83	830	1.21487	0.03108	1.30435	2.16700	0.78511	0.3316610492	1.0000000000	17.28584	0.26678	92	54	10	90	50	11	0.14332	0.10516
128	86849004	Suicidal deliberate poisoning	68	26929004	Alzheimer's disease (disorder)	1095	1	23	0	1	23	1071	0.00000	-0.00443	0.00000	0.00000	0.00000	1.0000000000	1.0000000000	0.02100	-0.02999	0	15	0	1	8	0	0.00000	0.00000
130	314994000	Metastasis from malignant tumor of prostate (disorder)	20	80394007	Hyperglycemia (disorder)	1095	1	55	1	0	54	1040	19.90909	0.13147	0.00000	0.00000	0.00000	0.0502283105	0.4320205543	0.05023	0.92930	0	23	0	1	32	1	-3.49651	-0.69315
124	1501000119109	Proliferative diabetic retinopathy due to type II diabetes mellitus (disorder)	29	22298006	Myocardial Infarction	1095	1	31	0	1	31	1063	0.00000	-0.00516	0.00000	0.00000	0.00000	1.0000000000	1.0000000000	0.02831	-0.04028	1	2	0	0	29	0	0.00000	0.00000
125	1734006	Fracture of the vertebral column with spinal cord injury	29	22298006	Myocardial Infarction	1095	5	31	0	5	31	1059	0.00000	-0.01156	0.00000	0.00000	0.00000	1.0000000000	1.0000000000	0.14155	-0.19100	3	2	0	2	29	0	0.00000	0.00000
130	314994000	Metastasis from malignant tumor of prostate (disorder)	29	22298006	Myocardial Infarction	1095	1	31	0	1	31	1063	0.00000	-0.00516	0.00000	0.00000	0.00000	1.0000000000	1.0000000000	0.02831	-0.04028	0	2	0	1	29	0	0.00000	0.00000
132	69896004	Rheumatoid arthritis	92	82423001	Chronic pain	1095	3	52	0	3	52	1040	0.00000	-0.01170	0.00000	0.00000	0.00000	1.0000000000	1.0000000000	0.14247	-0.19215	2	24	0	1	28	0	0.00000	0.00000
131	93761005	Primary malignant neoplasm of colon	92	82423001	Chronic pain	1095	5	52	1	4	51	1039	4.21154	0.04857	5.09314	46.39352	0.55913	0.2162949384	0.8693392717	0.23744	0.69264	3	24	0	2	28	1	-3.36730	-1.09861
130	314994000	Metastasis from malignant tumor of prostate (disorder)	92	82423001	Chronic pain	1095	1	52	1	0	51	1043	21.05769	0.13540	0.00000	0.00000	0.00000	0.0474885845	0.4185289102	0.04749	0.93307	0	24	0	1	28	1	-3.36730	-0.69315
129	47505003	Posttraumatic stress disorder	92	82423001	Chronic pain	1095	4	52	1	3	51	1040	5.26442	0.05766	6.79739	66.49339	0.69487	0.1770719710	0.8029498763	0.18995	0.74909	1	24	0	3	28	1	-3.36730	-1.38629
128	86849004	Suicidal deliberate poisoning	92	82423001	Chronic pain	1095	1	52	1	0	51	1043	21.05769	0.13540	0.00000	0.00000	0.00000	0.0474885845	0.4185289102	0.04749	0.93307	0	24	0	1	28	1	-3.36730	-0.69315
127	431856006	Chronic kidney disease stage 2 (disorder)	92	82423001	Chronic pain	1095	5	52	0	5	52	1038	0.00000	-0.01512	0.00000	0.00000	0.00000	1.0000000000	1.0000000000	0.23744	-0.30736	3	24	0	2	28	0	0.00000	0.00000
126	698754002	Chronic paralysis due to lesion of spinal cord	92	82423001	Chronic pain	1095	2	52	0	2	52	1041	0.00000	-0.00955	0.00000	0.00000	0.00000	1.0000000000	1.0000000000	0.09498	-0.13090	2	24	0	0	28	0	0.00000	0.00000
125	1734006	Fracture of the vertebral column with spinal cord injury	92	82423001	Chronic pain	1095	5	52	0	5	52	1038	0.00000	-0.01512	0.00000	0.00000	0.00000	1.0000000000	1.0000000000	0.23744	-0.30736	3	24	0	2	28	0	0.00000	0.00000
124	1501000119109	Proliferative diabetic retinopathy due to type II diabetes mellitus (disorder)	92	82423001	Chronic pain	1095	1	52	0	1	52	1042	0.00000	-0.00675	0.00000	0.00000	0.00000	1.0000000000	1.0000000000	0.04749	-0.06693	1	24	0	0	28	0	0.00000	0.00000
123	195967001	Asthma	92	82423001	Chronic pain	1095	2	52	0	2	52	1041	0.00000	-0.00955	0.00000	0.00000	0.00000	1.0000000000	1.0000000000	0.09498	-0.13090	1	24	0	1	28	0	0.00000	0.00000
121	254637007	Non-small cell lung cancer (disorder)	92	82423001	Chronic pain	1095	8	52	0	8	52	1035	0.00000	-0.01916	0.00000	0.00000	0.00000	1.0000000000	1.0000000000	0.37991	-0.46457	0	24	0	8	28	0	0.00000	0.00000
120	162573006	Suspected lung cancer (situation)	92	82423001	Chronic pain	1095	8	52	0	8	52	1035	0.00000	-0.01916	0.00000	0.00000	0.00000	1.0000000000	1.0000000000	0.37991	-0.46457	0	24	0	8	28	0	0.00000	0.00000
119	275272006	Brain damage - traumatic	92	82423001	Chronic pain	1095	4	52	0	4	52	1039	0.00000	-0.01352	0.00000	0.00000	0.00000	1.0000000000	1.0000000000	0.18995	-0.25091	0	24	0	4	28	0	0.00000	0.00000
118	48333001	Burn injury(morphologic abnormality)	92	82423001	Chronic pain	1095	1	52	0	1	52	1042	0.00000	-0.00675	0.00000	0.00000	0.00000	1.0000000000	1.0000000000	0.04749	-0.06693	0	24	0	1	28	0	0.00000	0.00000
117	230265002	Familial Alzheimer's disease of early onset (disorder)	92	82423001	Chronic pain	1095	6	52	1	5	51	1038	3.50962	0.04159	4.07059	35.48634	0.46693	0.2536827028	0.9133257124	0.28493	0.63831	2	24	0	4	28	1	-3.36730	-1.60944
116	370143000	Major depression disorder	92	82423001	Chronic pain	1095	8	52	0	8	52	1035	0.00000	-0.01916	0.00000	0.00000	0.00000	1.0000000000	1.0000000000	0.37991	-0.46457	3	24	0	5	28	0	0.00000	0.00000
115	36923009	Major depression  single episode	92	82423001	Chronic pain	1095	6	52	0	6	52	1037	0.00000	-0.01657	0.00000	0.00000	0.00000	1.0000000000	1.0000000000	0.28493	-0.36169	3	24	0	3	28	0	0.00000	0.00000
114	449868002	Smokes tobacco daily	92	82423001	Chronic pain	1095	9	52	1	8	51	1035	2.33974	0.02723	2.53676	20.66974	0.31133	0.3556585803	1.0000000000	0.42740	0.48661	2	24	0	7	28	1	-3.36730	-2.07944
113	443165006	Pathological fracture due to osteoporosis (disorder)	92	82423001	Chronic pain	1095	10	52	2	8	50	1035	4.21154	0.06884	5.17500	25.00570	1.07098	0.0779865873	0.5525151441	0.47489	1.02436	7	24	1	3	28	1	-0.14842	0.69315
112	49436004	Atrial Fibrillation	92	82423001	Chronic pain	1095	35	52	1	34	51	1009	0.60165	-0.01616	0.58189	4.33580	0.07809	1.0000000000	1.0000000000	1.66210	-0.41257	9	24	0	26	28	1	-3.36730	-3.29584
111	235919008	Cholelithiasis	92	82423001	Chronic pain	1095	9	52	0	9	52	1034	0.00000	-0.02033	0.00000	0.00000	0.00000	1.0000000000	1.0000000000	0.42740	-0.51339	7	24	0	2	28	0	0.00000	0.00000
110	65275009	Acute Cholecystitis	92	82423001	Chronic pain	1095	9	52	0	9	52	1034	0.00000	-0.02033	0.00000	0.00000	0.00000	1.0000000000	1.0000000000	0.42740	-0.51339	7	24	0	2	28	0	0.00000	0.00000
109	90560007	Gout	92	82423001	Chronic pain	1095	4	52	0	4	52	1039	0.00000	-0.01352	0.00000	0.00000	0.00000	1.0000000000	1.0000000000	0.18995	-0.25091	0	24	0	4	28	0	0.00000	0.00000
108	40930008	Hypothyroidism (disorder)	92	82423001	Chronic pain	1095	13	52	1	12	51	1031	1.61982	0.01517	1.68464	13.20814	0.21487	0.4706316522	1.0000000000	0.61735	0.30637	11	24	1	2	28	0	3.21888	2.48491
107	40275004	Contact dermatitis	92	82423001	Chronic pain	1095	18	52	0	18	52	1025	0.00000	-0.02887	0.00000	0.00000	0.00000	1.0000000000	1.0000000000	0.85479	-0.89126	9	24	0	9	28	0	0.00000	0.00000
106	24079001	Atopic dermatitis	92	82423001	Chronic pain	1095	20	52	0	20	52	1023	0.00000	-0.03046	0.00000	0.00000	0.00000	0.6195182740	1.0000000000	0.94977	-0.96331	13	24	0	7	28	0	0.00000	0.00000
105	363406005	Malignant tumor of colon	92	82423001	Chronic pain	1095	6	52	0	6	52	1037	0.00000	-0.01657	0.00000	0.00000	0.00000	1.0000000000	1.0000000000	0.28493	-0.36169	4	24	0	2	28	0	0.00000	0.00000
104	367498001	Seasonal allergic rhinitis	92	82423001	Chronic pain	1095	20	52	1	19	51	1024	1.05288	0.00161	1.05676	8.04988	0.13873	1.0000000000	1.0000000000	0.94977	0.03669	9	24	1	11	28	0	3.21888	2.30259
102	90781000119102	Microalbuminuria due to type 2 diabetes mellitus (disorder)	92	82423001	Chronic pain	1095	6	52	0	6	52	1037	0.00000	-0.01657	0.00000	0.00000	0.00000	1.0000000000	1.0000000000	0.28493	-0.36169	3	24	0	3	28	0	0.00000	0.00000
101	433144002	Chronic kidney disease stage 3 (disorder)	92	82423001	Chronic pain	1095	3	52	0	3	52	1040	0.00000	-0.01170	0.00000	0.00000	0.00000	1.0000000000	1.0000000000	0.14247	-0.19215	1	24	0	2	28	0	0.00000	0.00000
100	161622006	History of lower limb amputation (situation)	92	82423001	Chronic pain	1095	1	52	0	1	52	1042	0.00000	-0.00675	0.00000	0.00000	0.00000	1.0000000000	1.0000000000	0.04749	-0.06693	0	24	0	1	28	0	0.00000	0.00000
99	30832001	Rupture of patellar tendon	92	82423001	Chronic pain	1095	23	52	1	22	51	1021	0.91555	-0.00276	0.90998	6.88484	0.12027	1.0000000000	1.0000000000	1.09224	-0.06505	14	24	1	9	28	0	3.21888	2.70805
98	1551000119108	Nonproliferative diabetic retinopathy due to type 2 diabetes mellitus (disorder)	92	82423001	Chronic pain	1095	12	52	0	12	52	1031	0.00000	-0.02350	0.00000	0.00000	0.00000	1.0000000000	1.0000000000	0.56986	-0.65064	7	24	0	5	28	0	0.00000	0.00000
97	403192003	Third degree burn	92	82423001	Chronic pain	1095	8	52	0	8	52	1035	0.00000	-0.01916	0.00000	0.00000	0.00000	1.0000000000	1.0000000000	0.37991	-0.46457	3	24	0	5	28	0	0.00000	0.00000
96	283371005	Laceration of forearm	92	82423001	Chronic pain	1095	75	52	8	67	44	976	2.24615	0.07545	2.64858	5.85307	1.19851	0.0213469311	0.2617086048	3.56164	0.98037	39	24	4	36	28	4	-0.13353	0.07232
95	84757009	Epilepsy	92	82423001	Chronic pain	1095	30	52	0	30	52	1013	0.00000	-0.03748	0.00000	0.00000	0.00000	0.3944968957	1.0000000000	1.42466	-1.27778	13	24	0	17	28	0	0.00000	0.00000
94	703151001	History of single seizure (situation)	92	82423001	Chronic pain	1095	39	52	0	39	52	1004	0.00000	-0.04291	0.00000	0.00000	0.00000	0.2537417436	0.9133257124	1.85205	-1.51200	14	24	0	25	28	0	0.00000	0.00000
93	128613002	Seizure disorder	92	82423001	Chronic pain	1095	39	52	0	39	52	1004	0.00000	-0.04291	0.00000	0.00000	0.00000	0.2537417436	0.9133257124	1.85205	-1.51200	14	24	0	25	28	0	0.00000	0.00000
91	64859006	Osteoporosis (disorder)	92	82423001	Chronic pain	1095	37	52	4	33	48	1010	2.27651	0.05330	2.55051	7.49029	0.86847	0.0936889338	0.6064907526	1.75708	0.85879	24	24	2	13	28	2	-0.14310	0.55005
89	47693006	Rupture of appendix	92	82423001	Chronic pain	1095	20	52	2	18	50	1025	2.10577	0.03368	2.27778	10.08850	0.51428	0.2448901130	0.9133257124	0.94977	0.62166	10	24	1	10	28	1	-0.14842	0.00000
88	197927001	Recurrent urinary tract infection	92	82423001	Chronic pain	1095	8	52	0	8	52	1035	0.00000	-0.01916	0.00000	0.00000	0.00000	1.0000000000	1.0000000000	0.37991	-0.46457	8	24	0	0	28	0	0.00000	0.00000
86	713197008	Recurrent rectal polyp	92	82423001	Chronic pain	1095	22	52	2	20	50	1023	1.91434	0.02923	2.04600	8.99705	0.46528	0.2810118034	0.9613100586	1.04475	0.55304	12	24	0	10	28	2	-2.70805	-1.79176
85	241929008	Acute allergic reaction	92	82423001	Chronic pain	1095	47	52	0	47	52	996	0.00000	-0.04729	0.00000	0.00000	0.00000	0.1634809386	0.7879650300	2.23196	-1.69241	25	24	0	22	28	0	0.00000	0.00000
83	110030002	Concussion injury of brain	92	82423001	Chronic pain	1095	7	52	0	7	52	1036	0.00000	-0.01791	0.00000	0.00000	0.00000	1.0000000000	1.0000000000	0.33242	-0.41405	1	24	0	6	28	0	0.00000	0.00000
82	94260004	Secondary malignant neoplasm of colon	92	82423001	Chronic pain	1095	4	52	0	4	52	1039	0.00000	-0.01352	0.00000	0.00000	0.00000	1.0000000000	1.0000000000	0.18995	-0.25091	2	24	0	2	28	0	0.00000	0.00000
81	236077008	Protracted diarrhea	92	82423001	Chronic pain	1095	4	52	0	4	52	1039	0.00000	-0.01352	0.00000	0.00000	0.00000	1.0000000000	1.0000000000	0.18995	-0.25091	2	24	0	2	28	0	0.00000	0.00000
80	6072007	Bleeding from anus	92	82423001	Chronic pain	1095	4	52	0	4	52	1039	0.00000	-0.01352	0.00000	0.00000	0.00000	1.0000000000	1.0000000000	0.18995	-0.25091	2	24	0	2	28	0	0.00000	0.00000
79	45816000	Pyelonephritis	92	82423001	Chronic pain	1095	1	52	0	1	52	1042	0.00000	-0.00675	0.00000	0.00000	0.00000	1.0000000000	1.0000000000	0.04749	-0.06693	1	24	0	0	28	0	0.00000	0.00000
78	239872002	Osteoarthritis of hip	92	82423001	Chronic pain	1095	21	52	1	20	51	1023	1.00275	0.00009	1.00294	7.62091	0.13199	1.0000000000	1.0000000000	0.99726	0.00198	13	24	1	8	28	0	3.21888	2.63906
76	127013003	Diabetic renal disease (disorder)	92	82423001	Chronic pain	1095	28	52	2	26	50	1017	1.50412	0.01823	1.56462	6.77756	0.36120	0.3877697477	1.0000000000	1.32968	0.36483	10	24	1	18	28	1	-0.14842	-0.54654
75	431855005	Chronic kidney disease stage 1 (disorder)	92	82423001	Chronic pain	1095	28	52	2	26	50	1017	1.50412	0.01823	1.56462	6.77756	0.36120	0.3877697477	1.0000000000	1.32968	0.36483	10	24	1	18	28	1	-0.14842	-0.54654
73	196416002	Impacted molars	92	82423001	Chronic pain	1095	49	52	39	10	13	1033	16.76020	0.76165	309.90000	750.30474	127.99867	0.0000000000	0.0000000000	2.32694	3.58773	25	24	20	24	28	19	-0.11725	-0.00583
72	35999006	Blighted ovum	92	82423001	Chronic pain	1095	53	52	3	50	49	993	1.19194	0.00967	1.21592	4.03629	0.36629	0.7356481888	1.0000000000	2.51689	0.18570	53	24	3	0	28	0	2.19722	2.92674
71	201834006	Localized  primary osteoarthritis of the hand	92	82423001	Chronic pain	1095	28	52	1	27	51	1016	0.75206	-0.00897	0.73784	5.53791	0.09830	1.0000000000	1.0000000000	1.32968	-0.22013	19	24	1	9	28	0	3.21888	2.99573
70	87433001	Pulmonary emphysema (disorder)	92	82423001	Chronic pain	1095	17	52	0	17	52	1026	0.00000	-0.02804	0.00000	0.00000	0.00000	1.0000000000	1.0000000000	0.80731	-0.85384	9	24	0	8	28	0	0.00000	0.00000
69	233604007	Pneumonia	92	82423001	Chronic pain	1095	7	52	1	6	51	1037	3.00824	0.03597	3.38889	28.67687	0.40048	0.2893195251	0.9726720763	0.33242	0.58595	3	24	0	4	28	1	-3.36730	-1.60944
68	26929004	Alzheimer's disease (disorder)	92	82423001	Chronic pain	1095	23	52	0	23	52	1020	0.00000	-0.03271	0.00000	0.00000	0.00000	0.6218660582	1.0000000000	1.09224	-1.06505	15	24	0	8	28	0	0.00000	0.00000
67	403191005	Second degree burn	92	82423001	Chronic pain	1095	49	52	3	46	49	997	1.28925	0.01398	1.32697	4.41719	0.39864	0.5021177068	1.0000000000	2.32694	0.26580	23	24	2	26	28	1	-0.80235	-0.77011
65	239873007	Osteoarthritis of knee	92	82423001	Chronic pain	1095	57	52	1	56	51	987	0.36943	-0.03299	0.34559	2.54673	0.04690	0.5155308992	1.0000000000	2.70685	-0.89019	30	24	0	27	28	1	-3.36730	-3.33220
64	444448004	Injury of medial collateral ligament of knee	92	82423001	Chronic pain	1095	32	52	1	31	51	1012	0.65805	-0.01325	0.64010	4.78251	0.08567	1.0000000000	1.0000000000	1.51963	-0.33321	17	24	1	15	28	0	3.21888	2.89037
63	68496003	Polyp of colon	92	82423001	Chronic pain	1095	91	52	6	85	46	958	1.38842	0.02611	1.47008	3.54130	0.61026	0.4340858402	1.0000000000	4.32146	0.39553	43	24	1	48	28	5	1.33181	1.42334
62	185086009	Chronic obstructive bronchitis (disorder)	92	82423001	Chronic pain	1095	6	52	0	6	52	1037	0.00000	-0.01657	0.00000	0.00000	0.00000	1.0000000000	1.0000000000	0.28493	-0.36169	4	24	0	2	28	0	0.00000	0.00000
60	301011002	Escherichia coli urinary tract infection	92	82423001	Chronic pain	1095	92	52	5	87	47	956	1.14444	0.00977	1.16899	3.01583	0.45312	0.7958539960	1.0000000000	4.36895	0.16032	85	24	4	7	28	1	-1.42139	1.02290
59	262574004	Bullet wound	92	82423001	Chronic pain	1095	20	52	2	18	50	1025	2.10577	0.03368	2.27778	10.08850	0.51428	0.2448901130	0.9133257124	0.94977	0.62166	9	24	1	11	28	1	-0.14842	-0.18232
58	239720000	Tear of meniscus of knee	92	82423001	Chronic pain	1095	20	52	2	18	50	1025	2.10577	0.03368	2.27778	10.08850	0.51428	0.2448901130	0.9133257124	0.94977	0.62166	10	24	0	10	28	2	-2.70805	-1.79176
57	192127007	Child attention deficit disorder	92	82423001	Chronic pain	1095	76	52	2	74	50	969	0.55415	-0.02719	0.52378	2.19527	0.12497	0.5743812597	1.0000000000	3.60913	-0.61953	24	24	2	52	28	0	2.56495	2.56495
56	92691004	Carcinoma in situ of prostate (disorder)	92	82423001	Chronic pain	1095	23	52	1	22	51	1021	0.91555	-0.00276	0.90998	6.88484	0.12027	1.0000000000	1.0000000000	1.09224	-0.06505	0	24	0	23	28	1	-3.36730	-3.17805
54	5602001	Opioid abuse (disorder)	92	82423001	Chronic pain	1095	7	52	1	6	51	1037	3.00824	0.03597	3.38889	28.67687	0.40048	0.2893195251	0.9726720763	0.33242	0.58595	0	24	0	7	28	1	-3.36730	-2.07944
53	7200002	Alcoholism	92	82423001	Chronic pain	1095	5	52	1	4	51	1039	4.21154	0.04857	5.09314	46.39352	0.55913	0.2162949384	0.8693392717	0.23744	0.69264	0	24	0	5	28	1	-3.36730	-1.79176
52	124171000119105	Chronic intractable migraine without aura	92	82423001	Chronic pain	1095	51	52	38	13	14	1030	15.69005	0.72497	215.05495	488.96957	94.58386	0.0000000000	0.0000000000	2.42192	3.51060	21	24	18	30	28	20	-0.02817	-0.14310
50	446096008	Perennial allergic rhinitis	92	82423001	Chronic pain	1095	26	52	2	24	50	1019	1.61982	0.02158	1.69833	7.38769	0.39042	0.3527159697	1.0000000000	1.23470	0.42488	14	24	0	12	28	2	-2.70805	-1.94591
49	88805009	Chronic congestive heart failure (disorder)	92	82423001	Chronic pain	1095	10	52	1	9	51	1034	2.10577	0.02370	2.25272	18.12272	0.28002	0.3865110240	1.0000000000	0.47489	0.43940	5	24	0	5	28	1	-3.36730	-1.79176
47	359817006	Closed fracture of hip	92	82423001	Chronic pain	1095	29	52	2	27	50	1016	1.45225	0.01666	1.50519	6.50797	0.34812	0.6443711795	1.0000000000	1.37717	0.33572	11	24	0	18	28	2	-2.70805	-2.30259
46	62564004	Concussion with loss of consciousness	92	82423001	Chronic pain	1095	67	52	3	64	49	979	0.94288	-0.00326	0.93654	3.08721	0.28411	1.0000000000	1.0000000000	3.18174	-0.06410	36	24	2	31	28	1	-0.80235	-0.52130
45	263102004	Fracture subluxation of wrist	92	82423001	Chronic pain	1095	109	52	6	103	46	940	1.15914	0.01181	1.19038	2.85477	0.49636	0.6363635816	1.0000000000	5.17626	0.18062	51	24	2	58	28	4	0.48551	0.53630
44	58150001	Fracture of clavicle	92	82423001	Chronic pain	1095	112	52	4	108	48	935	0.75206	-0.01869	0.72145	2.03964	0.25519	0.8133119694	1.0000000000	5.31872	-0.33770	55	24	2	57	28	2	-0.14310	-0.03449
43	307731004	Injury of tendon of the rotator cuff of shoulder	92	82423001	Chronic pain	1095	51	52	2	49	50	994	0.82579	-0.00860	0.81143	3.43220	0.19184	1.0000000000	1.0000000000	2.42192	-0.18984	26	24	0	25	28	2	-2.70805	-2.60269
42	16114001	Fracture of ankle	92	82423001	Chronic pain	1095	108	52	7	101	45	942	1.36485	0.02695	1.45083	3.30185	0.63749	0.3424675236	1.0000000000	5.12877	0.38440	48	24	3	60	28	4	0.11778	0.06062
41	283385000	Laceration of thigh	92	82423001	Chronic pain	1095	105	52	4	101	48	942	0.80220	-0.01438	0.77723	2.19991	0.27459	0.8109225763	1.0000000000	4.98630	-0.25974	50	24	0	55	28	4	-2.07944	-2.69124
40	428251008	History of appendectomy	92	82423001	Chronic pain	1095	51	52	3	48	49	995	1.23869	0.01178	1.26913	4.21855	0.38181	0.7301686341	1.0000000000	2.42192	0.22519	27	24	2	24	28	1	-0.80235	-0.54473
39	74400008	Appendicitis	92	82423001	Chronic pain	1095	51	52	3	48	49	995	1.23869	0.01178	1.26913	4.21855	0.38181	0.7301686341	1.0000000000	2.42192	0.22519	27	24	2	24	28	1	-0.80235	-0.54473
38	398254007	Preeclampsia	92	82423001	Chronic pain	1095	101	52	3	98	49	945	0.62548	-0.02666	0.59038	1.92925	0.18066	0.6201714933	1.0000000000	4.79635	-0.53514	101	24	3	0	28	0	2.19722	3.54578
37	38822007	Cystitis	92	82423001	Chronic pain	1095	71	52	4	67	48	976	1.18635	0.01096	1.21393	3.46762	0.42497	0.7697008582	1.0000000000	3.37169	0.19374	68	24	3	3	28	1	-1.17007	1.77777
35	19169002	Miscarriage in first trimester	92	82423001	Chronic pain	1095	174	52	10	164	42	879	1.21021	0.02040	1.27613	2.59437	0.62771	0.5583989372	1.0000000000	8.26301	0.24795	174	24	10	0	28	0	1.22378	2.91235
33	429007001	History of cardiac arrest (situation)	92	82423001	Chronic pain	1095	42	52	3	39	49	1004	1.50412	0.02248	1.57614	5.27925	0.47056	0.4458994973	1.0000000000	1.99452	0.41767	24	24	2	18	28	1	-0.80235	-0.37949
32	410429000	Cardiac Arrest	92	82423001	Chronic pain	1095	42	52	3	39	49	1004	1.50412	0.02248	1.57614	5.27925	0.47056	0.4458994973	1.0000000000	1.99452	0.41767	24	24	2	18	28	1	-0.80235	-0.37949
30	399211009	History of myocardial infarction (situation)	92	82423001	Chronic pain	1095	31	52	0	31	52	1012	0.00000	-0.03811	0.00000	0.00000	0.00000	0.3953614638	1.0000000000	1.47215	-1.30576	2	24	0	29	28	0	0.00000	0.00000
29	22298006	Myocardial Infarction	92	82423001	Chronic pain	1095	31	52	0	31	52	1012	0.00000	-0.03811	0.00000	0.00000	0.00000	0.3953614638	1.0000000000	1.47215	-1.30576	2	24	0	29	28	0	0.00000	0.00000
28	53741008	Coronary Heart Disease	92	82423001	Chronic pain	1095	80	52	1	79	51	964	0.26322	-0.04619	0.23927	1.75445	0.03263	0.1711517246	0.7972585288	3.79909	-1.26276	24	24	0	56	28	1	-3.36730	-4.04305
27	408512008	Body mass index 40+ - severely obese (finding)	92	82423001	Chronic pain	1095	97	52	7	90	45	953	1.51963	0.03617	1.64716	3.75916	0.72174	0.2141392768	0.8672161313	4.60639	0.51293	67	24	2	30	28	5	0.67788	1.59505
26	33737001	Fracture of rib	92	82423001	Chronic pain	1095	54	52	2	52	50	991	0.77991	-0.01119	0.76231	3.21938	0.18050	1.0000000000	1.0000000000	2.56438	-0.24869	32	24	0	22	28	2	-2.70805	-2.48491
121	254637007	Non-small cell lung cancer (disorder)	77	422034002	Diabetic retinopathy associated with type II diabetes mellitus (disorder)	1095	8	20	0	8	20	1067	0.00000	-0.01170	0.00000	0.00000	0.00000	1.0000000000	1.0000000000	0.14612	-0.19676	0	8	0	8	12	0	0.00000	0.00000
24	162864005	Body mass index 30+ - obesity (finding)	92	82423001	Chronic pain	1095	439	52	21	418	31	625	1.00732	0.00134	1.01289	1.78678	0.57418	1.0000000000	1.0000000000	20.84749	0.01004	226	24	6	213	28	15	0.55629	0.93368
23	36971009	Sinusitis (disorder)	92	82423001	Chronic pain	1095	190	52	9	181	43	862	0.99747	-0.00026	0.99679	2.08108	0.47744	1.0000000000	1.0000000000	9.02283	-0.00329	84	24	2	106	28	7	0.95551	0.97972
22	70704007	Sprain of wrist	92	82423001	Chronic pain	1095	195	52	15	180	37	863	1.61982	0.06442	1.94369	3.61701	1.04449	0.0406122794	0.3849833570	9.26027	0.64100	90	24	8	105	28	7	-0.22314	-0.26706
21	15777000	Prediabetes	92	82423001	Chronic pain	1095	333	52	19	314	33	729	1.20149	0.02974	1.33671	2.38679	0.74862	0.3544811389	1.0000000000	15.81370	0.25036	159	24	9	174	28	10	-0.03572	0.01439
20	80394007	Hyperglycemia (disorder)	92	82423001	Chronic pain	1095	55	52	2	53	50	990	0.76573	-0.01203	0.74717	3.15393	0.17701	1.0000000000	1.0000000000	2.61187	-0.26778	23	24	1	32	28	1	-0.14842	-0.31845
19	237602007	Metabolic syndrome X (disorder)	92	82423001	Chronic pain	1095	64	52	3	61	49	982	0.98708	-0.00072	0.98561	3.25297	0.29863	1.0000000000	1.0000000000	3.03927	-0.01409	28	24	2	36	28	1	-0.80235	-0.90287
18	302870006	Hypertriglyceridemia (disorder)	92	82423001	Chronic pain	1095	64	52	3	61	49	982	0.98708	-0.00072	0.98561	3.25297	0.29863	1.0000000000	1.0000000000	3.03927	-0.01409	28	24	2	36	28	1	-0.80235	-0.90287
17	368581000119106	Neuropathy due to type 2 diabetes mellitus (disorder)	92	82423001	Chronic pain	1095	28	52	0	28	52	1015	0.00000	-0.03617	0.00000	0.00000	0.00000	0.6393983627	1.0000000000	1.32968	-1.22013	7	24	0	21	28	0	0.00000	0.00000
129	47505003	Posttraumatic stress disorder	66	55822004	Hyperlipidemia	1095	4	119	1	3	118	973	2.30042	0.02749	2.74859	26.63728	0.28362	0.3692576541	1.0000000000	0.43470	0.47925	1	64	1	3	55	0	4.17439	0.69315
15	40055000	Chronic sinusitis (disorder)	92	82423001	Chronic pain	1095	216	52	7	209	45	834	0.68243	-0.03515	0.62073	1.39624	0.27596	0.2874650427	0.9705262095	10.25753	-0.49282	104	24	2	112	28	5	0.67788	0.81756
14	10509002	Acute bronchitis (disorder)	92	82423001	Chronic pain	1095	863	52	45	818	7	225	1.09803	0.04221	1.76825	3.97441	0.78671	0.2220421663	0.8794911525	40.98265	0.13184	418	24	19	445	28	26	0.08587	0.23873
13	370247008	Facial laceration	92	82423001	Chronic pain	1095	109	52	7	102	45	941	1.35233	0.02616	1.43508	3.26527	0.63071	0.3465176628	1.0000000000	5.17626	0.37327	55	24	3	54	28	4	0.11778	0.28768
12	65966004	Fracture of forearm	92	82423001	Chronic pain	1095	123	52	2	121	50	922	0.34240	-0.05223	0.30479	1.26856	0.07323	0.1115733749	0.6583985495	5.84110	-1.18926	55	24	0	68	28	2	-2.70805	-3.55535
11	38341003	Hypertension	92	82423001	Chronic pain	1095	278	52	19	259	33	784	1.43919	0.05720	1.74283	3.11792	0.97420	0.0714921662	0.5260337259	13.20183	0.49392	131	24	10	147	28	9	-0.18992	-0.20646
10	62106007	Concussion with no loss of consciousness	92	82423001	Chronic pain	1095	206	52	10	196	42	847	1.02222	0.00239	1.02891	2.08637	0.50742	1.0000000000	1.0000000000	9.78265	0.02879	96	24	3	110	28	7	0.58779	0.68024
9	44465007	Sprain of ankle	92	82423001	Chronic pain	1095	362	52	22	340	30	703	1.27975	0.04390	1.51627	2.66828	0.86164	0.1734725831	0.7996618359	17.19087	0.33842	185	24	9	177	28	13	0.15066	0.38856
8	233678006	Childhood asthma	92	82423001	Chronic pain	1095	45	52	4	41	48	1002	1.87179	0.04030	2.03659	5.91807	0.70085	0.1605319172	0.7819917697	2.13699	0.67255	25	24	1	20	28	3	0.88350	1.22121
7	75498004	Acute bacterial sinusitis (disorder)	92	82423001	Chronic pain	1095	187	52	5	182	47	861	0.56304	-0.04428	0.50327	1.28288	0.19743	0.1852842987	0.8181443419	8.88037	-0.71960	89	24	1	98	28	4	1.13943	1.26113
6	39848009	Whiplash injury to neck	92	82423001	Chronic pain	1095	182	52	6	176	46	867	0.69421	-0.03048	0.64254	1.52761	0.27026	0.4437572522	1.0000000000	8.64292	-0.46212	92	24	3	90	28	3	-0.13815	0.02128
5	284549007	Laceration of hand	92	82423001	Chronic pain	1095	104	52	8	96	44	947	1.61982	0.04483	1.79356	3.92053	0.82052	0.1441452769	0.7404942507	4.93881	0.59975	54	24	4	50	28	4	-0.13353	0.07146
4	195662009	Acute viral pharyngitis (disorder)	92	82423001	Chronic pain	1095	890	52	46	844	6	199	1.08838	0.04112	1.80766	4.29168	0.76139	0.2046447462	0.8533859271	42.26484	0.11947	430	24	20	460	28	26	0.05757	0.18540
3	65363002	Otitis media	92	82423001	Chronic pain	1095	580	52	28	552	24	491	1.01658	0.00393	1.03774	1.81421	0.59359	1.0000000000	1.0000000000	27.54338	0.02290	277	24	14	303	28	14	-0.10008	-0.08558
115	36923009	Major depression  single episode	66	55822004	Hyperlipidemia	1095	6	119	0	6	119	970	0.00000	-0.02592	0.00000	0.00000	0.00000	1.0000000000	1.0000000000	0.65205	-0.72426	3	64	0	3	55	0	0.00000	0.00000
1	444814009	Viral sinusitis (disorder)	92	82423001	Chronic pain	1095	993	52	51	942	1	101	1.08151	0.05679	5.46815	39.99043	0.74770	0.0812619626	0.5629813232	47.15616	0.11079	478	24	23	515	28	28	0.02151	0.11621
113	443165006	Pathological fracture due to osteoporosis (disorder)	66	55822004	Hyperlipidemia	1095	10	119	4	6	115	970	3.68067	0.08986	5.62319	20.22123	1.56372	0.0165724236	0.2190854429	1.08676	1.26066	7	64	4	3	55	0	2.83321	1.01160
112	49436004	Atrial Fibrillation	66	55822004	Hyperlipidemia	1095	35	119	11	24	108	952	2.89196	0.12004	4.04012	8.47522	1.92592	0.0006823144	0.0182047297	3.80365	1.32083	9	64	5	26	55	6	0.30555	-0.64436
111	235919008	Cholelithiasis	66	55822004	Hyperlipidemia	1095	9	119	1	8	118	968	1.02241	0.00071	1.02542	8.27079	0.12713	1.0000000000	1.0000000000	0.97808	0.01590	7	64	0	2	55	1	-4.02535	-1.09861
110	65275009	Acute Cholecystitis	66	55822004	Hyperlipidemia	1095	9	119	1	8	118	968	1.02241	0.00071	1.02542	8.27079	0.12713	1.0000000000	1.0000000000	0.97808	0.01590	7	64	0	2	55	1	-4.02535	-1.09861
109	90560007	Gout	66	55822004	Hyperlipidemia	1095	4	119	0	4	119	972	0.00000	-0.02114	0.00000	0.00000	0.00000	1.0000000000	1.0000000000	0.43470	-0.52075	0	64	0	4	55	0	0.00000	0.00000
108	40930008	Hypothyroidism (disorder)	66	55822004	Hyperlipidemia	1095	13	119	3	10	116	966	2.12346	0.04300	2.49828	9.20829	0.67780	0.1597641952	0.7791167255	1.41279	0.72930	11	64	2	2	55	1	-0.52884	0.77319
107	40275004	Contact dermatitis	66	55822004	Hyperlipidemia	1095	18	119	1	17	118	959	0.51120	-0.02207	0.47807	3.62490	0.06305	0.7108057453	1.0000000000	1.95616	-0.56373	9	64	1	9	55	0	4.17439	2.30259
106	24079001	Atopic dermatitis	66	55822004	Hyperlipidemia	1095	20	119	1	19	118	957	0.46008	-0.02571	0.42685	3.21760	0.05663	0.7146921661	1.0000000000	2.17352	-0.66608	13	64	0	7	55	1	-4.02535	-2.07944
105	363406005	Malignant tumor of colon	66	55822004	Hyperlipidemia	1095	6	119	3	3	116	973	4.60084	0.09333	8.38793	42.04071	1.67355	0.0195883843	0.2449385150	0.65205	1.27574	4	64	2	2	55	1	-0.52884	0.00000
104	367498001	Seasonal allergic rhinitis	66	55822004	Hyperlipidemia	1095	20	119	1	19	118	957	0.46008	-0.02571	0.42685	3.21760	0.05663	0.7146921661	1.0000000000	2.17352	-0.66608	9	64	1	11	55	0	4.17439	2.30259
103	157141000119108	Proteinuria due to type 2 diabetes mellitus (disorder)	66	55822004	Hyperlipidemia	1095	3	119	1	2	118	974	3.06723	0.03783	4.12712	45.86162	0.37140	0.2921165039	0.9783965127	0.32603	0.59289	1	64	0	2	55	1	-4.02535	-1.09861
102	90781000119102	Microalbuminuria due to type 2 diabetes mellitus (disorder)	66	55822004	Hyperlipidemia	1095	6	119	1	5	118	971	1.53361	0.01383	1.64576	14.20687	0.19065	0.4994053137	1.0000000000	0.65205	0.27574	3	64	0	3	55	1	-4.02535	-1.38629
101	433144002	Chronic kidney disease stage 3 (disorder)	66	55822004	Hyperlipidemia	1095	3	119	1	2	118	974	3.06723	0.03783	4.12712	45.86162	0.37140	0.2921165039	0.9783965127	0.32603	0.59289	1	64	0	2	55	1	-4.02535	-1.09861
100	161622006	History of lower limb amputation (situation)	66	55822004	Hyperlipidemia	1095	1	119	1	0	118	976	9.20168	0.08659	0.00000	0.00000	0.00000	0.1086757991	0.6488370819	0.10868	0.85116	0	64	0	1	55	1	-4.02535	-0.69315
99	30832001	Rupture of patellar tendon	66	55822004	Hyperlipidemia	1095	23	119	7	16	112	960	2.80051	0.09209	3.75000	9.31147	1.51023	0.0083468391	0.1349328791	2.49954	1.19283	14	64	3	9	55	4	0.41484	0.55595
98	1551000119108	Nonproliferative diabetic retinopathy due to type 2 diabetes mellitus (disorder)	66	55822004	Hyperlipidemia	1095	12	119	3	9	116	967	2.30042	0.04780	2.77874	10.40989	0.74173	0.1329577811	0.7164538997	1.30411	0.79579	7	64	2	5	55	1	-0.52884	-0.28768
97	403192003	Third degree burn	66	55822004	Hyperlipidemia	1095	8	119	1	7	118	969	1.15021	0.00450	1.17312	9.61821	0.14308	0.6028770632	1.0000000000	0.86941	0.09742	3	64	0	5	55	1	-4.02535	-1.79176
96	283371005	Laceration of forearm	66	55822004	Hyperlipidemia	1095	75	119	13	62	106	914	1.59496	0.05633	1.80797	3.39736	0.96215	0.0805297914	0.5619161441	8.15068	0.61348	39	64	6	36	55	7	0.27551	0.19961
95	84757009	Epilepsy	66	55822004	Hyperlipidemia	1095	30	119	3	27	116	949	0.92017	-0.00468	0.90900	3.04308	0.27153	1.0000000000	1.0000000000	3.26027	-0.09095	13	64	2	17	55	1	-0.52884	-0.87547
94	703151001	History of single seizure (situation)	66	55822004	Hyperlipidemia	1095	39	119	4	35	115	941	0.94376	-0.00377	0.93516	2.67885	0.32645	1.0000000000	1.0000000000	4.23836	-0.06719	14	64	2	25	55	2	0.14660	-0.52325
93	128613002	Seizure disorder	66	55822004	Hyperlipidemia	1095	39	119	4	35	115	941	0.94376	-0.00377	0.93516	2.67885	0.32645	1.0000000000	1.0000000000	4.23836	-0.06719	14	64	2	25	55	2	0.14660	-0.52325
92	82423001	Chronic pain	66	55822004	Hyperlipidemia	1095	52	119	8	44	111	932	1.41564	0.03241	1.52662	3.32562	0.70079	0.2582038347	0.9228474191	5.65114	0.43632	24	64	4	28	55	4	0.14197	-0.13353
91	64859006	Osteoporosis (disorder)	66	55822004	Hyperlipidemia	1095	37	119	17	20	102	956	4.22780	0.21077	7.96667	15.69424	4.04402	0.0000000340	0.0000021165	4.02100	1.84195	24	64	12	13	55	5	-0.63908	-0.18232
89	47693006	Rupture of appendix	66	55822004	Hyperlipidemia	1095	20	119	2	18	117	958	0.92017	-0.00380	0.90978	3.97044	0.20847	1.0000000000	1.0000000000	2.17352	-0.08112	10	64	0	10	55	2	-3.34990	-1.79176
88	197927001	Recurrent urinary tract infection	66	55822004	Hyperlipidemia	1095	8	119	0	8	119	968	0.00000	-0.02996	0.00000	0.00000	0.00000	1.0000000000	1.0000000000	0.86941	-0.90258	8	64	0	0	55	0	0.00000	0.00000
86	713197008	Recurrent rectal polyp	66	55822004	Hyperlipidemia	1095	22	119	7	15	112	961	2.92781	0.09639	4.00417	10.03001	1.59854	0.0063717018	0.1098836909	2.39087	1.23835	12	64	5	10	55	2	-0.72524	-0.56798
85	241929008	Acute allergic reaction	66	55822004	Hyperlipidemia	1095	47	119	1	46	118	930	0.19578	-0.05947	0.17133	1.25389	0.02341	0.0524153402	0.4428314306	5.10776	-1.61064	25	64	0	22	55	1	-4.02535	-3.13549
84	232353008	Perennial allergic rhinitis with seasonal variation	66	55822004	Hyperlipidemia	1095	29	119	3	26	116	950	0.95190	-0.00277	0.94496	3.17061	0.28163	1.0000000000	1.0000000000	3.15160	-0.05367	14	64	0	15	55	3	-2.96183	-1.79176
83	110030002	Concussion injury of brain	66	55822004	Hyperlipidemia	1095	7	119	0	7	119	969	0.00000	-0.02801	0.00000	0.00000	0.00000	1.0000000000	1.0000000000	0.76073	-0.81617	1	64	0	6	55	0	0.00000	0.00000
82	94260004	Secondary malignant neoplasm of colon	66	55822004	Hyperlipidemia	1095	4	119	0	4	119	972	0.00000	-0.02114	0.00000	0.00000	0.00000	1.0000000000	1.0000000000	0.43470	-0.52075	2	64	0	2	55	0	0.00000	0.00000
81	236077008	Protracted diarrhea	66	55822004	Hyperlipidemia	1095	4	119	0	4	119	972	0.00000	-0.02114	0.00000	0.00000	0.00000	1.0000000000	1.0000000000	0.43470	-0.52075	2	64	0	2	55	0	0.00000	0.00000
80	6072007	Bleeding from anus	66	55822004	Hyperlipidemia	1095	4	119	0	4	119	972	0.00000	-0.02114	0.00000	0.00000	0.00000	1.0000000000	1.0000000000	0.43470	-0.52075	2	64	0	2	55	0	0.00000	0.00000
79	45816000	Pyelonephritis	66	55822004	Hyperlipidemia	1095	1	119	0	1	119	975	0.00000	-0.01056	0.00000	0.00000	0.00000	1.0000000000	1.0000000000	0.10868	-0.14884	1	64	0	0	55	0	0.00000	0.00000
78	239872002	Osteoarthritis of hip	66	55822004	Hyperlipidemia	1095	21	119	8	13	111	963	3.50540	0.12233	5.33888	13.16272	2.16548	0.0009308118	0.0235465868	2.28219	1.45527	13	64	4	8	55	4	0.14197	0.34831
77	422034002	Diabetic retinopathy associated with type II diabetes mellitus (disorder)	66	55822004	Hyperlipidemia	1095	20	119	4	16	115	960	1.84034	0.04002	2.08696	6.34902	0.68599	0.2620208666	0.9281913645	2.17352	0.65585	8	64	2	12	55	2	0.14660	-0.33647
76	127013003	Diabetic renal disease (disorder)	66	55822004	Hyperlipidemia	1095	28	119	6	22	113	954	1.97179	0.05497	2.30249	5.79797	0.91437	0.1121072728	0.6586865067	3.04292	0.79196	10	64	3	18	55	3	0.14425	-0.47957
75	431855005	Chronic kidney disease stage 1 (disorder)	66	55822004	Hyperlipidemia	1095	28	119	6	22	113	954	1.97179	0.05497	2.30249	5.79797	0.91437	0.1121072728	0.6586865067	3.04292	0.79196	10	64	3	18	55	3	0.14425	-0.47957
73	196416002	Impacted molars	66	55822004	Hyperlipidemia	1095	49	119	7	42	112	934	1.31453	0.02377	1.38988	3.16776	0.60982	0.4772023194	1.0000000000	5.32511	0.33891	25	64	3	24	55	4	0.41484	0.28768
72	35999006	Blighted ovum	66	55822004	Hyperlipidemia	1095	53	119	12	41	107	935	2.08340	0.08532	2.55756	5.01643	1.30393	0.0104341765	0.1590125021	5.75982	0.94346	53	64	12	0	55	0	1.84583	1.68948
71	201834006	Localized  primary osteoarthritis of the hand	66	55822004	Hyperlipidemia	1095	28	119	6	22	113	954	1.97179	0.05497	2.30249	5.79797	0.91437	0.1121072728	0.6586865067	3.04292	0.79196	19	64	5	9	55	1	-1.40068	-0.73397
70	87433001	Pulmonary emphysema (disorder)	66	55822004	Hyperlipidemia	1095	17	119	5	12	114	964	2.70638	0.07482	3.52339	10.18180	1.21926	0.0295060830	0.3166312918	1.84749	1.07527	9	64	2	8	55	3	0.53468	0.40547
69	233604007	Pneumonia	66	55822004	Hyperlipidemia	1095	7	119	5	2	114	974	6.57263	0.15608	21.35965	111.35980	4.09694	0.0002459038	0.0076544094	0.76073	1.76879	3	64	2	4	55	3	0.53468	0.06899
68	26929004	Alzheimer's disease (disorder)	66	55822004	Hyperlipidemia	1095	23	119	11	12	108	964	4.40080	0.17394	8.18210	18.98997	3.52537	0.0000069828	0.0003080173	2.49954	1.77780	15	64	6	8	55	5	-0.02817	0.29725
67	403191005	Second degree burn	66	55822004	Hyperlipidemia	1095	49	119	7	42	112	934	1.31453	0.02377	1.38988	3.16776	0.60982	0.4772023194	1.0000000000	5.32511	0.33891	23	64	2	26	55	5	1.01160	0.70118
65	239873007	Osteoarthritis of knee	66	55822004	Hyperlipidemia	1095	57	119	20	37	99	939	3.22866	0.18236	5.12695	9.17578	2.86467	0.0000004504	0.0000244052	6.19452	1.54542	30	64	12	27	55	8	-0.21787	-0.22314
64	444448004	Injury of medial collateral ligament of knee	66	55822004	Hyperlipidemia	1095	32	119	2	30	117	946	0.57511	-0.02574	0.53903	2.28463	0.12718	0.5676027489	1.0000000000	3.47763	-0.57777	17	64	2	15	55	0	3.49651	2.25129
63	68496003	Polyp of colon	66	55822004	Hyperlipidemia	1095	91	119	34	57	85	919	3.43799	0.25629	6.44912	10.41523	3.99331	0.0000000000	0.0000000001	9.88950	1.68442	43	64	16	48	55	18	0.20935	0.00567
62	185086009	Chronic obstructive bronchitis (disorder)	66	55822004	Hyperlipidemia	1095	6	119	3	3	116	973	4.60084	0.09333	8.38793	42.04071	1.67355	0.0195883843	0.2449385150	0.65205	1.27574	4	64	2	2	55	1	-0.52884	0.00000
61	198992004	Antepartum eclampsia	66	55822004	Hyperlipidemia	1095	96	119	16	80	103	896	1.53361	0.05776	1.73981	3.08936	0.97979	0.0601984248	0.4782097489	10.43288	0.57235	96	64	16	0	55	0	1.60944	1.94591
60	301011002	Escherichia coli urinary tract infection	66	55822004	Hyperlipidemia	1095	92	119	20	72	99	904	2.00037	0.10579	2.53648	4.34002	1.48242	0.0013266322	0.0308890646	9.99817	0.93313	85	64	18	7	55	2	-1.83356	0.24028
59	262574004	Bullet wound	66	55822004	Hyperlipidemia	1095	20	119	1	19	118	957	0.46008	-0.02571	0.42685	3.21760	0.05663	0.7146921661	1.0000000000	2.17352	-0.66608	9	64	1	11	55	0	4.17439	2.30259
58	239720000	Tear of meniscus of knee	66	55822004	Hyperlipidemia	1095	20	119	3	17	116	959	1.38025	0.01811	1.45892	5.05364	0.42117	0.4708697710	1.0000000000	2.17352	0.33392	10	64	2	10	55	1	-0.52884	-0.60614
57	192127007	Child attention deficit disorder	66	55822004	Hyperlipidemia	1095	76	119	4	72	115	904	0.48430	-0.04918	0.43671	1.21761	0.15663	0.1255769763	0.6945902319	8.25936	-0.88898	24	64	1	52	55	3	1.21256	0.31015
56	92691004	Carcinoma in situ of prostate (disorder)	66	55822004	Hyperlipidemia	1095	23	119	8	15	111	961	3.20058	0.11255	4.61742	11.13521	1.91470	0.0018571024	0.0403506070	2.49954	1.36276	0	64	0	23	55	8	-2.06369	-1.35455
55	126906006	Neoplasm of prostate	66	55822004	Hyperlipidemia	1095	24	119	8	16	111	960	3.06723	0.10806	4.32432	10.33355	1.80962	0.0025351346	0.0525246358	2.60822	1.31864	0	64	0	24	55	8	-2.06369	-1.38629
54	5602001	Opioid abuse (disorder)	66	55822004	Hyperlipidemia	1095	7	119	1	6	118	970	1.31453	0.00881	1.37006	11.47837	0.16353	0.5541075797	1.0000000000	0.76073	0.18383	0	64	0	7	55	1	-4.02535	-2.07944
53	7200002	Alcoholism	66	55822004	Hyperlipidemia	1095	5	119	1	4	118	972	1.84034	0.01987	2.05932	18.57841	0.22827	0.4380553985	1.0000000000	0.54338	0.37391	0	64	0	5	55	1	-4.02535	-1.79176
52	124171000119105	Chronic intractable migraine without aura	66	55822004	Hyperlipidemia	1095	51	119	7	44	112	932	1.26298	0.02030	1.32386	3.00969	0.58232	0.4882940709	1.0000000000	5.54247	0.29017	21	64	3	30	55	4	0.41484	-0.06062
51	403190006	First degree burn	66	55822004	Hyperlipidemia	1095	79	119	14	65	105	911	1.63068	0.06141	1.86872	3.44542	1.01355	0.0577894394	0.4685406893	8.58539	0.64605	43	64	11	36	55	3	-1.04224	-0.97386
50	446096008	Perennial allergic rhinitis	66	55822004	Hyperlipidemia	1095	26	119	2	24	117	952	0.70782	-0.01591	0.67806	2.90579	0.15823	1.0000000000	1.0000000000	2.82557	-0.35071	14	64	1	12	55	1	0.14904	0.14310
49	88805009	Chronic congestive heart failure (disorder)	66	55822004	Hyperlipidemia	1095	10	119	4	6	115	970	3.68067	0.08986	5.62319	20.22123	1.56372	0.0165724236	0.2190854429	1.08676	1.26066	5	64	1	5	55	3	1.21256	0.81093
48	55680006	Drug overdose	66	55822004	Hyperlipidemia	1095	50	119	10	40	109	936	1.84034	0.06418	2.14679	4.41390	1.04413	0.0572718048	0.4672229578	5.43379	0.77376	24	64	6	26	55	4	-0.23451	-0.40547
47	359817006	Closed fracture of hip	66	55822004	Hyperlipidemia	1095	29	119	4	25	115	951	1.26920	0.01550	1.32313	3.86927	0.45246	0.5461935638	1.0000000000	3.15160	0.26826	11	64	1	18	55	3	1.21256	0.53900
46	62564004	Concussion with loss of consciousness	66	55822004	Hyperlipidemia	1095	67	119	7	60	112	916	0.96137	-0.00344	0.95417	2.13852	0.42573	1.0000000000	1.0000000000	7.28128	-0.04985	36	64	6	31	55	1	-1.56862	-1.51983
45	263102004	Fracture subluxation of wrist	66	55822004	Hyperlipidemia	1095	109	119	16	93	103	883	1.35071	0.04072	1.47489	2.60376	0.83545	0.1931937680	0.8313014192	11.84566	0.40425	51	64	9	58	55	7	-0.08799	-0.33136
44	58150001	Fracture of clavicle	66	55822004	Hyperlipidemia	1095	112	119	14	98	105	878	1.15021	0.01770	1.19456	2.16673	0.65858	0.5238225783	1.0000000000	12.17169	0.18752	55	64	7	57	55	7	0.13555	-0.03175
43	307731004	Injury of tendon of the rotator cuff of shoulder	66	55822004	Hyperlipidemia	1095	51	119	11	40	108	936	1.98468	0.07599	2.38333	4.78206	1.18783	0.0193359772	0.2435167979	5.54247	0.87513	26	64	7	25	55	4	-0.37447	-0.43040
42	16114001	Fracture of ankle	66	55822004	Hyperlipidemia	1095	108	119	22	86	97	890	1.87442	0.10100	2.34716	3.92056	1.40519	0.0018200906	0.0396445550	11.73699	0.85261	48	64	8	60	55	14	0.60218	0.28090
41	283385000	Laceration of thigh	66	55822004	Hyperlipidemia	1095	105	119	21	84	98	892	1.84034	0.09556	2.27551	3.83396	1.35055	0.0043191926	0.0813602408	11.41096	0.82589	50	64	9	55	55	12	0.37345	0.16053
40	428251008	History of appendectomy	66	55822004	Hyperlipidemia	1095	51	119	10	41	109	935	1.80425	0.06207	2.09219	4.29466	1.01923	0.0601314515	0.4781103994	5.54247	0.74960	27	64	6	24	55	4	-0.23451	-0.24116
39	74400008	Appendicitis	66	55822004	Hyperlipidemia	1095	51	119	10	41	109	935	1.80425	0.06207	2.09219	4.29466	1.01923	0.0601314515	0.4781103994	5.54247	0.74960	27	64	6	24	55	4	-0.23451	-0.24116
38	398254007	Preeclampsia	66	55822004	Hyperlipidemia	1095	101	119	22	79	97	897	2.00433	0.11179	2.57523	4.31795	1.53587	0.0006634149	0.0178633629	10.97626	0.94146	101	64	22	0	55	0	1.36330	1.72114
37	38822007	Cystitis	66	55822004	Hyperlipidemia	1095	71	119	11	60	108	916	1.42561	0.03913	1.55494	3.04804	0.79324	0.2330193497	0.8937472100	7.71598	0.46130	68	64	10	3	55	1	-2.02387	0.66783
116	370143000	Major depression disorder	22	70704007	Sprain of wrist	1095	8	195	1	7	194	893	0.70192	-0.01190	0.65758	5.37551	0.08044	1.0000000000	1.0000000000	1.42466	-0.27778	3	90	0	5	105	1	-4.66344	-1.79176
35	19169002	Miscarriage in first trimester	66	55822004	Hyperlipidemia	1095	174	119	32	142	87	834	1.69226	0.10507	2.16027	3.36287	1.38774	0.0012461630	0.0293265925	18.90959	0.72900	174	64	32	0	55	0	1.09861	1.86214
118	48333001	Burn injury(morphologic abnormality)	22	70704007	Sprain of wrist	1095	1	195	0	1	195	899	0.00000	-0.01407	0.00000	0.00000	0.00000	1.0000000000	1.0000000000	0.17808	-0.23644	0	90	0	1	105	0	0.00000	0.00000
33	429007001	History of cardiac arrest (situation)	66	55822004	Hyperlipidemia	1095	42	119	8	34	111	942	1.75270	0.05249	1.99682	4.42136	0.90182	0.1217871456	0.6889733259	4.56438	0.69370	24	64	4	18	55	4	0.14197	0.24116
32	410429000	Cardiac Arrest	66	55822004	Hyperlipidemia	1095	42	119	8	34	111	942	1.75270	0.05249	1.99682	4.42136	0.90182	0.1217871456	0.6889733259	4.56438	0.69370	24	64	4	18	55	4	0.14197	0.24116
31	230690007	Stroke	66	55822004	Hyperlipidemia	1095	62	119	21	41	98	935	3.11670	0.18107	4.88676	8.60335	2.77571	0.0000004442	0.0000242182	6.73790	1.50749	32	64	10	30	55	11	0.20972	0.11941
30	399211009	History of myocardial infarction (situation)	66	55822004	Hyperlipidemia	1095	31	119	3	28	116	948	0.89049	-0.00653	0.87562	2.92515	0.26211	1.0000000000	1.0000000000	3.36895	-0.12729	2	64	0	29	55	3	-2.96183	-2.36712
29	22298006	Myocardial Infarction	66	55822004	Hyperlipidemia	1095	31	119	3	28	116	948	0.89049	-0.00653	0.87562	2.92515	0.26211	1.0000000000	1.0000000000	3.36895	-0.12729	2	64	0	29	55	3	-2.96183	-2.36712
28	53741008	Coronary Heart Disease	66	55822004	Hyperlipidemia	1095	80	119	22	58	97	918	2.53046	0.15003	3.58976	6.12020	2.10555	0.0000124735	0.0005238875	8.69406	1.24646	24	64	7	56	55	15	0.77632	-0.06655
27	408512008	Body mass index 40+ - severely obese (finding)	66	55822004	Hyperlipidemia	1095	97	119	26	71	93	905	2.46643	0.15964	3.56353	5.86000	2.16702	0.0000028970	0.0001367176	10.54155	1.22612	67	64	20	30	55	6	-0.88403	-0.32158
26	33737001	Fracture of rib	66	55822004	Hyperlipidemia	1095	54	119	12	42	107	934	2.04482	0.08309	2.49399	4.88367	1.27363	0.0116490108	0.1704250285	5.86849	0.92045	32	64	6	22	55	6	0.13762	0.30538
25	284551006	Laceration of foot	66	55822004	Hyperlipidemia	1095	118	119	21	97	98	879	1.63759	0.07737	1.94183	3.25267	1.15926	0.0175821421	0.2282402808	12.82374	0.67036	53	64	12	65	55	9	-0.11583	-0.41736
24	162864005	Body mass index 30+ - obesity (finding)	66	55822004	Hyperlipidemia	1095	439	119	85	354	34	622	1.78165	0.22327	4.39266	6.67594	2.89029	0.0000000000	0.0000000000	47.70868	0.82016	226	64	46	213	55	39	-0.00789	-0.08871
23	36971009	Sinusitis (disorder)	66	55822004	Hyperlipidemia	1095	190	119	35	155	84	821	1.69505	0.11120	2.20699	3.39291	1.43558	0.0004919832	0.0137535938	20.64840	0.73374	84	64	18	106	55	17	0.07289	-0.24437
22	70704007	Sprain of wrist	66	55822004	Hyperlipidemia	1095	195	119	23	172	96	804	1.08533	0.01387	1.11991	1.81691	0.69029	0.6138611378	1.0000000000	21.19178	0.11301	90	64	12	105	55	11	0.05407	-0.21563
21	15777000	Prediabetes	66	55822004	Hyperlipidemia	1095	333	119	68	265	51	711	1.87902	0.20291	3.57736	5.28107	2.42327	0.0000000002	0.0000000124	36.18904	0.89172	159	64	35	174	55	33	0.05894	-0.12370
20	80394007	Hyperglycemia (disorder)	66	55822004	Hyperlipidemia	1095	55	119	9	46	110	930	1.50573	0.04061	1.65415	3.47119	0.78826	0.1816343869	0.8142934871	5.97717	0.51929	23	64	3	32	55	6	0.78697	0.31366
19	237602007	Metabolic syndrome X (disorder)	66	55822004	Hyperlipidemia	1095	64	119	10	54	109	922	1.43776	0.03808	1.56643	3.16497	0.77527	0.2130612236	0.8671354646	6.95525	0.46752	28	64	4	36	55	6	0.51410	0.13353
18	302870006	Hypertriglyceridemia (disorder)	66	55822004	Hyperlipidemia	1095	64	119	10	54	109	922	1.43776	0.03808	1.56643	3.16497	0.77527	0.2130612236	0.8671354646	6.95525	0.46752	28	64	4	36	55	6	0.51410	0.13353
17	368581000119106	Neuropathy due to type 2 diabetes mellitus (disorder)	66	55822004	Hyperlipidemia	1095	28	119	7	21	112	955	2.30042	0.07356	2.84226	6.83539	1.18186	0.0253880178	0.2905941929	3.04292	0.98460	7	64	2	21	55	5	1.01160	-0.14458
16	44054006	Diabetes	66	55822004	Hyperlipidemia	1095	68	119	10	58	109	918	1.35319	0.03173	1.45207	2.92371	0.72118	0.3118266210	1.0000000000	7.38995	0.39077	29	64	4	39	55	6	0.51410	0.09531
15	40055000	Chronic sinusitis (disorder)	66	55822004	Hyperlipidemia	1095	216	119	35	181	84	795	1.49101	0.08499	1.83011	2.80234	1.19518	0.0070292095	0.1189073325	23.47397	0.55675	104	64	18	112	55	17	0.07289	-0.11295
14	10509002	Acute bronchitis (disorder)	66	55822004	Hyperlipidemia	1095	863	119	109	754	10	222	1.16221	0.10924	3.20928	6.23837	1.65099	0.0001240624	0.0042047085	93.78721	0.21474	418	64	59	445	55	50	-0.00729	-0.20256
13	370247008	Facial laceration	66	55822004	Hyperlipidemia	1095	109	119	19	90	100	886	1.60396	0.07012	1.87044	3.19784	1.09404	0.0331621209	0.3365284359	11.84566	0.63872	55	64	8	54	55	11	0.40547	0.28720
12	65966004	Fracture of forearm	66	55822004	Hyperlipidemia	1095	123	119	13	110	106	866	0.97254	-0.00341	0.96552	1.77552	0.52505	1.0000000000	1.0000000000	13.36712	-0.03734	55	64	7	68	55	6	-0.00234	-0.33108
11	38341003	Hypertension	66	55822004	Hyperlipidemia	1095	278	119	37	241	82	735	1.22468	0.04576	1.37613	2.08299	0.90914	0.1466332070	0.7496483932	30.21187	0.28390	131	64	21	147	55	16	-0.09196	-0.34180
10	62106007	Concussion with no loss of consciousness	66	55822004	Hyperlipidemia	1095	206	119	25	181	94	795	1.11671	0.01962	1.16816	1.86841	0.73035	0.5345560067	1.0000000000	22.38721	0.15279	96	64	15	110	55	10	-0.21040	-0.48343
9	44465007	Sprain of ankle	66	55822004	Hyperlipidemia	1095	362	119	50	312	69	664	1.27095	0.06649	1.54218	2.27338	1.04616	0.0303872350	0.3209857386	39.34064	0.33826	185	64	25	177	55	25	0.10661	0.03884
8	233678006	Childhood asthma	66	55822004	Hyperlipidemia	1095	45	119	3	42	116	934	0.61345	-0.02794	0.57512	1.88498	0.17547	0.4678157505	1.0000000000	4.89041	-0.55837	25	64	2	20	55	1	-0.52884	-0.44183
7	75498004	Acute bacterial sinusitis (disorder)	66	55822004	Hyperlipidemia	1095	187	119	19	168	100	808	0.93493	-0.01031	0.91381	1.53382	0.54442	0.7974674964	1.0000000000	20.32237	-0.09237	89	64	9	98	55	10	0.22143	0.00820
6	39848009	Whiplash injury to neck	66	55822004	Hyperlipidemia	1095	182	119	27	155	92	821	1.36508	0.05692	1.55449	2.46749	0.97931	0.0675817015	0.5101371685	19.77900	0.43030	92	64	12	90	55	15	0.30538	0.21357
5	284549007	Laceration of hand	66	55822004	Hyperlipidemia	1095	104	119	9	95	110	881	0.79630	-0.02304	0.75876	1.54596	0.37240	0.5115124497	1.0000000000	11.30228	-0.29893	54	64	5	50	55	4	-0.06657	-0.13459
4	195662009	Acute viral pharyngitis (disorder)	66	55822004	Hyperlipidemia	1095	890	119	110	780	9	196	1.13729	0.09988	3.07123	6.16823	1.52919	0.0004511849	0.0128028349	96.72146	0.18381	430	64	58	460	55	52	0.02199	-0.15721
3	65363002	Otitis media	66	55822004	Hyperlipidemia	1095	580	119	25	555	94	421	0.39662	-0.22359	0.20174	0.31922	0.12750	0.0000000000	0.0000000000	63.03196	-1.30028	277	64	15	303	55	10	-0.21040	-0.47491
115	36923009	Major depression  single episode	40	428251008	History of appendectomy	1095	6	51	0	6	51	1038	0.00000	-0.01641	0.00000	0.00000	0.00000	1.0000000000	1.0000000000	0.27945	-0.35553	3	27	0	3	24	0	0.00000	0.00000
1	444814009	Viral sinusitis (disorder)	66	55822004	Hyperlipidemia	1095	993	119	118	875	1	101	1.09345	0.10182	13.62057	98.55186	1.88246	0.0001494169	0.0049681114	107.91507	0.12776	478	64	63	515	55	55	0.00791	-0.18802
112	49436004	Atrial Fibrillation	40	428251008	History of appendectomy	1095	35	51	5	30	46	1014	3.06723	0.08302	3.67391	9.90504	1.36270	0.0201577923	0.2499224584	1.63014	1.18982	9	27	3	26	24	2	-0.26236	-1.25276
111	235919008	Cholelithiasis	40	428251008	History of appendectomy	1095	9	51	0	9	51	1035	0.00000	-0.02012	0.00000	0.00000	0.00000	1.0000000000	1.0000000000	0.41918	-0.50506	7	27	0	2	24	0	0.00000	0.00000
110	65275009	Acute Cholecystitis	40	428251008	History of appendectomy	1095	9	51	0	9	51	1035	0.00000	-0.02012	0.00000	0.00000	0.00000	1.0000000000	1.0000000000	0.41918	-0.50506	7	27	0	2	24	0	0.00000	0.00000
109	90560007	Gout	40	428251008	History of appendectomy	1095	4	51	0	4	51	1040	0.00000	-0.01338	0.00000	0.00000	0.00000	1.0000000000	1.0000000000	0.18630	-0.24647	0	27	0	4	24	0	0.00000	0.00000
108	40930008	Hypothyroidism (disorder)	40	428251008	History of appendectomy	1095	13	51	0	13	51	1031	0.00000	-0.02423	0.00000	0.00000	0.00000	1.0000000000	1.0000000000	0.60548	-0.68300	11	27	0	2	24	0	0.00000	0.00000
107	40275004	Contact dermatitis	40	428251008	History of appendectomy	1095	18	51	0	18	51	1026	0.00000	-0.02857	0.00000	0.00000	0.00000	1.0000000000	1.0000000000	0.83836	-0.87842	9	27	0	9	24	0	0.00000	0.00000
106	24079001	Atopic dermatitis	40	428251008	History of appendectomy	1095	20	51	1	19	50	1025	1.07353	0.00222	1.07895	8.22193	0.14159	0.6180548828	1.0000000000	0.93151	0.05027	13	27	0	7	24	1	-3.21888	-2.07944
105	363406005	Malignant tumor of colon	40	428251008	History of appendectomy	1095	6	51	1	5	50	1039	3.57843	0.04230	4.15600	36.24351	0.47656	0.2493687300	0.9133257124	0.27945	0.64447	4	27	1	2	24	0	3.33220	1.60944
104	367498001	Seasonal allergic rhinitis	40	428251008	History of appendectomy	1095	20	51	1	19	50	1025	1.07353	0.00222	1.07895	8.22193	0.14159	0.6180548828	1.0000000000	0.93151	0.05027	9	27	0	11	24	1	-3.21888	-2.48491
102	90781000119102	Microalbuminuria due to type 2 diabetes mellitus (disorder)	40	428251008	History of appendectomy	1095	6	51	0	6	51	1038	0.00000	-0.01641	0.00000	0.00000	0.00000	1.0000000000	1.0000000000	0.27945	-0.35553	3	27	0	3	24	0	0.00000	0.00000
101	433144002	Chronic kidney disease stage 3 (disorder)	40	428251008	History of appendectomy	1095	3	51	0	3	51	1041	0.00000	-0.01158	0.00000	0.00000	0.00000	1.0000000000	1.0000000000	0.13973	-0.18869	1	27	0	2	24	0	0.00000	0.00000
100	161622006	History of lower limb amputation (situation)	40	428251008	History of appendectomy	1095	1	51	0	1	51	1043	0.00000	-0.00668	0.00000	0.00000	0.00000	1.0000000000	1.0000000000	0.04658	-0.06568	0	27	0	1	24	0	0.00000	0.00000
99	30832001	Rupture of patellar tendon	40	428251008	History of appendectomy	1095	23	51	3	20	48	1024	2.80051	0.05829	3.20000	11.14160	0.91908	0.0873973862	0.5838464658	1.07123	0.94951	14	27	2	9	24	1	-0.54473	-0.22314
98	1551000119108	Nonproliferative diabetic retinopathy due to type 2 diabetes mellitus (disorder)	40	428251008	History of appendectomy	1095	12	51	0	12	51	1032	0.00000	-0.02327	0.00000	0.00000	0.00000	1.0000000000	1.0000000000	0.55890	-0.64053	7	27	0	5	24	0	0.00000	0.00000
97	403192003	Third degree burn	40	428251008	History of appendectomy	1095	8	51	0	8	51	1036	0.00000	-0.01896	0.00000	0.00000	0.00000	1.0000000000	1.0000000000	0.37260	-0.45691	3	27	0	5	24	0	0.00000	0.00000
96	283371005	Laceration of forearm	40	428251008	History of appendectomy	1095	75	51	3	72	48	972	0.85882	-0.00846	0.84375	2.77549	0.25650	1.0000000000	1.0000000000	3.49315	-0.16773	39	27	0	36	24	3	-2.19722	-2.56495
95	84757009	Epilepsy	40	428251008	History of appendectomy	1095	30	51	2	28	49	1016	1.43137	0.01600	1.48105	6.39593	0.34295	0.6466294661	1.0000000000	1.39726	0.32358	13	27	1	17	24	1	0.11333	-0.25131
94	703151001	History of single seizure (situation)	40	428251008	History of appendectomy	1095	39	51	2	37	49	1007	1.10106	0.00429	1.11087	4.74272	0.26019	0.7024948712	1.0000000000	1.81644	0.09109	14	27	1	25	24	1	0.11333	-0.55005
93	128613002	Seizure disorder	40	428251008	History of appendectomy	1095	39	51	2	37	49	1007	1.10106	0.00429	1.11087	4.74272	0.26019	0.7024948712	1.0000000000	1.81644	0.09109	14	27	1	25	24	1	0.11333	-0.55005
89	47693006	Rupture of appendix	40	428251008	History of appendectomy	1095	20	51	20	0	31	1044	21.47059	0.61713	0.00000	0.00000	0.00000	0.0000000000	0.0000000000	0.93151	3.44259	10	27	10	10	24	10	0.08456	0.00000
86	713197008	Recurrent rectal polyp	40	428251008	History of appendectomy	1095	22	51	4	18	47	1026	3.90374	0.09190	4.85106	14.90006	1.57938	0.0163942262	0.2183740785	1.02466	1.30425	12	27	1	10	24	3	1.13498	1.09861
85	241929008	Acute allergic reaction	40	428251008	History of appendectomy	1095	47	51	5	42	46	1002	2.28411	0.06010	2.59317	6.86250	0.97989	0.0624371316	0.4854500809	2.18904	0.91184	25	27	4	22	24	1	-1.17118	-1.15449
82	94260004	Secondary malignant neoplasm of colon	40	428251008	History of appendectomy	1095	4	51	0	4	51	1040	0.00000	-0.01338	0.00000	0.00000	0.00000	1.0000000000	1.0000000000	0.18630	-0.24647	2	27	0	2	24	0	0.00000	0.00000
81	236077008	Protracted diarrhea	40	428251008	History of appendectomy	1095	4	51	0	4	51	1040	0.00000	-0.01338	0.00000	0.00000	0.00000	1.0000000000	1.0000000000	0.18630	-0.24647	2	27	0	2	24	0	0.00000	0.00000
80	6072007	Bleeding from anus	40	428251008	History of appendectomy	1095	4	51	0	4	51	1040	0.00000	-0.01338	0.00000	0.00000	0.00000	1.0000000000	1.0000000000	0.18630	-0.24647	2	27	0	2	24	0	0.00000	0.00000
78	239872002	Osteoarthritis of hip	40	428251008	History of appendectomy	1095	21	51	2	19	49	1025	2.04482	0.03229	2.20193	9.72093	0.49877	0.2556511436	0.9170844866	0.97808	0.60086	13	27	1	8	24	1	0.11333	0.44183
76	127013003	Diabetic renal disease (disorder)	40	428251008	History of appendectomy	1095	28	51	1	27	50	1017	0.76681	-0.00835	0.75333	5.65634	0.10033	1.0000000000	1.0000000000	1.30411	-0.20421	10	27	0	18	24	1	-3.21888	-2.94444
75	431855005	Chronic kidney disease stage 1 (disorder)	40	428251008	History of appendectomy	1095	28	51	1	27	50	1017	0.76681	-0.00835	0.75333	5.65634	0.10033	1.0000000000	1.0000000000	1.30411	-0.20421	10	27	0	18	24	1	-3.21888	-2.94444
73	196416002	Impacted molars	40	428251008	History of appendectomy	1095	49	51	3	46	48	998	1.31453	0.01505	1.35598	4.51679	0.40708	0.4939703825	1.0000000000	2.28219	0.28534	25	27	2	24	24	1	-0.54473	-0.61619
72	35999006	Blighted ovum	40	428251008	History of appendectomy	1095	53	51	2	51	49	993	0.81021	-0.00946	0.79472	3.35976	0.18798	1.0000000000	1.0000000000	2.46849	-0.20935	53	27	2	0	24	0	2.67415	3.31419
71	201834006	Localized  primary osteoarthritis of the hand	40	428251008	History of appendectomy	1095	28	51	3	25	48	1019	2.30042	0.04656	2.54750	8.73347	0.74309	0.1376504409	0.7296699408	1.30411	0.79579	19	27	2	9	24	1	-0.54473	0.04879
70	87433001	Pulmonary emphysema (disorder)	40	428251008	History of appendectomy	1095	17	51	0	17	51	1027	0.00000	-0.02776	0.00000	0.00000	0.00000	1.0000000000	1.0000000000	0.79178	-0.84139	9	27	0	8	24	0	0.00000	0.00000
69	233604007	Pneumonia	40	428251008	History of appendectomy	1095	7	51	1	6	50	1038	3.06723	0.03665	3.46000	29.28892	0.40874	0.2845222606	0.9659403678	0.32603	0.59289	3	27	0	4	24	1	-3.21888	-1.60944
68	26929004	Alzheimer's disease (disorder)	40	428251008	History of appendectomy	1095	23	51	1	22	50	1022	0.93350	-0.00215	0.92909	7.03202	0.12275	1.0000000000	1.0000000000	1.07123	-0.05049	15	27	1	8	24	0	3.33220	2.77259
67	403191005	Second degree burn	40	428251008	History of appendectomy	1095	49	51	3	46	48	998	1.31453	0.01505	1.35598	4.51679	0.40708	0.4939703825	1.0000000000	2.28219	0.28534	23	27	1	26	24	2	0.76726	0.53900
65	239873007	Osteoarthritis of knee	40	428251008	History of appendectomy	1095	57	51	4	53	47	991	1.50671	0.02624	1.59133	4.58202	0.55267	0.3329404031	1.0000000000	2.65479	0.45214	30	27	2	27	24	2	0.10920	0.09844
64	444448004	Injury of medial collateral ligament of knee	40	428251008	History of appendectomy	1095	32	51	2	30	49	1014	1.34191	0.01311	1.37959	5.93918	0.32046	0.6576488290	1.0000000000	1.49041	0.26858	17	27	1	15	24	1	0.11333	0.11778
63	68496003	Polyp of colon	40	428251008	History of appendectomy	1095	91	51	9	82	42	962	2.12346	0.07476	2.51394	5.34552	1.18228	0.0313855403	0.3268117118	4.23836	0.93281	43	27	4	48	24	5	0.28983	0.10300
62	185086009	Chronic obstructive bronchitis (disorder)	40	428251008	History of appendectomy	1095	6	51	0	6	51	1038	0.00000	-0.01641	0.00000	0.00000	0.00000	1.0000000000	1.0000000000	0.27945	-0.35553	4	27	0	2	24	0	0.00000	0.00000
59	262574004	Bullet wound	40	428251008	History of appendectomy	1095	20	51	1	19	50	1025	1.07353	0.00222	1.07895	8.22193	0.14159	0.6180548828	1.0000000000	0.93151	0.05027	9	27	1	11	24	0	3.33220	2.30259
58	239720000	Tear of meniscus of knee	40	428251008	History of appendectomy	1095	20	51	2	18	49	1026	2.14706	0.03458	2.32653	10.30984	0.52501	0.2379729124	0.9062586661	0.93151	0.63524	10	27	1	10	24	1	0.11333	0.00000
57	192127007	Child attention deficit disorder	40	428251008	History of appendectomy	1095	76	51	6	70	45	974	1.69505	0.04195	1.85524	4.49828	0.76516	0.1588551376	0.7768414475	3.53973	0.62475	24	27	3	52	24	3	0.10536	-0.71150
56	92691004	Carcinoma in situ of prostate (disorder)	40	428251008	History of appendectomy	1095	23	51	1	22	50	1022	0.93350	-0.00215	0.92909	7.03202	0.12275	1.0000000000	1.0000000000	1.07123	-0.05049	0	27	0	23	24	1	-3.21888	-3.17805
54	5602001	Opioid abuse (disorder)	40	428251008	History of appendectomy	1095	7	51	0	7	51	1037	0.00000	-0.01773	0.00000	0.00000	0.00000	1.0000000000	1.0000000000	0.32603	-0.40711	0	27	0	7	24	0	0.00000	0.00000
53	7200002	Alcoholism	40	428251008	History of appendectomy	1095	5	51	0	5	51	1039	0.00000	-0.01497	0.00000	0.00000	0.00000	1.0000000000	1.0000000000	0.23288	-0.30203	0	27	0	5	24	0	0.00000	0.00000
52	124171000119105	Chronic intractable migraine without aura	40	428251008	History of appendectomy	1095	51	51	4	47	47	997	1.68397	0.03341	1.80534	5.22093	0.62427	0.2923243186	0.9783965127	2.37534	0.56689	21	27	2	30	24	2	0.10920	-0.33024
50	446096008	Perennial allergic rhinitis	40	428251008	History of appendectomy	1095	26	51	3	23	48	1021	2.47738	0.05092	2.77446	9.56311	0.80493	0.1164803352	0.6771287302	1.21096	0.85533	14	27	2	12	24	1	-0.54473	-0.48551
49	88805009	Chronic congestive heart failure (disorder)	40	428251008	History of appendectomy	1095	10	51	1	9	50	1035	2.14706	0.02434	2.30000	18.50972	0.28580	0.3805778618	1.0000000000	0.46575	0.44836	5	27	0	5	24	1	-3.21888	-1.79176
47	359817006	Closed fracture of hip	40	428251008	History of appendectomy	1095	29	51	1	28	50	1016	0.74037	-0.00946	0.72571	5.44210	0.09678	1.0000000000	1.0000000000	1.35068	-0.23308	11	27	0	18	24	1	-3.21888	-2.94444
46	62564004	Concussion with loss of consciousness	40	428251008	History of appendectomy	1095	67	51	6	61	45	983	1.92274	0.05207	2.14863	5.23336	0.88215	0.1220498430	0.6889733259	3.12055	0.76452	36	27	4	31	24	2	-0.51726	-0.50078
45	263102004	Fracture subluxation of wrist	40	428251008	History of appendectomy	1095	109	51	8	101	43	943	1.57582	0.04232	1.73705	3.79716	0.79463	0.1541569681	0.7722801598	5.07671	0.56663	51	27	3	58	24	5	0.54473	0.35667
44	58150001	Fracture of clavicle	40	428251008	History of appendectomy	1095	112	51	8	104	43	940	1.53361	0.03981	1.68157	3.67335	0.76979	0.2305544970	0.8899459402	5.21644	0.53384	55	27	4	57	24	4	0.10178	-0.03334
43	307731004	Injury of tendon of the rotator cuff of shoulder	40	428251008	History of appendectomy	1095	51	51	2	49	49	995	0.84198	-0.00772	0.82882	3.50767	0.19584	1.0000000000	1.0000000000	2.37534	-0.17007	26	27	1	25	24	1	0.11333	0.03774
42	16114001	Fracture of ankle	40	428251008	History of appendectomy	1095	108	51	2	106	49	938	0.39760	-0.04404	0.36119	1.50642	0.08660	0.2242111777	0.8794911525	5.03014	-1.00723	48	27	1	60	24	1	0.11333	-0.21905
41	283385000	Laceration of thigh	40	428251008	History of appendectomy	1095	105	51	9	96	42	948	1.84034	0.06049	2.11607	4.47931	0.99965	0.0526790739	0.4433527430	4.89041	0.76356	50	27	5	55	24	4	-0.08961	-0.29335
39	74400008	Appendicitis	40	428251008	History of appendectomy	1095	51	51	51	0	0	1044	21.47059	1.00000	0.00000	0.00000	0.00000	0.0000000000	0.0000000000	2.37534	3.94541	27	27	27	24	24	24	0.00000	0.00000
38	398254007	Preeclampsia	40	428251008	History of appendectomy	1095	101	51	5	96	46	948	1.06290	0.00443	1.07337	2.76574	0.41657	0.8051124427	1.0000000000	4.70411	0.07296	101	27	5	0	24	0	1.85630	3.05400
35	19169002	Miscarriage in first trimester	40	428251008	History of appendectomy	1095	174	51	10	164	41	880	1.23394	0.02247	1.30874	2.66484	0.64274	0.4349709406	1.0000000000	8.10411	0.27291	174	27	10	0	24	0	1.30833	2.91235
33	429007001	History of cardiac arrest (situation)	40	428251008	History of appendectomy	1095	42	51	4	38	47	1006	2.04482	0.04612	2.25308	6.57506	0.77206	0.1267807618	0.6972941899	1.95616	0.75820	24	27	2	18	24	2	0.10920	0.26236
32	410429000	Cardiac Arrest	40	428251008	History of appendectomy	1095	42	51	4	38	47	1006	2.04482	0.04612	2.25308	6.57506	0.77206	0.1267807618	0.6972941899	1.95616	0.75820	24	27	2	18	24	2	0.10920	0.26236
30	399211009	History of myocardial infarction (situation)	40	428251008	History of appendectomy	1095	31	51	0	31	51	1013	0.00000	-0.03773	0.00000	0.00000	0.00000	0.3948460482	1.0000000000	1.44384	-1.28915	2	27	0	29	24	0	0.00000	0.00000
29	22298006	Myocardial Infarction	40	428251008	History of appendectomy	1095	31	51	0	31	51	1013	0.00000	-0.03773	0.00000	0.00000	0.00000	0.3948460482	1.0000000000	1.44384	-1.28915	2	27	0	29	24	0	0.00000	0.00000
28	53741008	Coronary Heart Disease	40	428251008	History of appendectomy	1095	80	51	2	78	49	966	0.53676	-0.02874	0.50549	2.11782	0.12065	0.5773495999	1.0000000000	3.72603	-0.65567	24	27	0	56	24	2	-2.56495	-3.36730
27	408512008	Body mass index 40+ - severely obese (finding)	40	428251008	History of appendectomy	1095	97	51	12	85	39	959	2.65616	0.11412	3.47149	6.87959	1.75174	0.0010133584	0.0252592497	4.51781	1.23634	67	27	8	30	24	4	-0.47000	0.09798
26	33737001	Fracture of rib	40	428251008	History of appendectomy	1095	54	51	2	52	49	992	0.79521	-0.01031	0.77865	3.29019	0.18427	1.0000000000	1.0000000000	2.51507	-0.22859	32	27	2	22	24	0	2.67415	2.83321
24	162864005	Body mass index 30+ - obesity (finding)	40	428251008	History of appendectomy	1095	439	51	29	410	22	634	1.41833	0.07564	2.03836	3.59679	1.15517	0.0183593407	0.2349246247	20.44658	0.48422	226	27	16	213	24	13	-0.05736	-0.13924
23	36971009	Sinusitis (disorder)	40	428251008	History of appendectomy	1095	190	51	11	179	40	865	1.24303	0.02461	1.32891	2.63998	0.66894	0.4474462508	1.0000000000	8.84932	0.28494	84	27	7	106	24	4	-0.36546	-0.74924
21	15777000	Prediabetes	40	428251008	History of appendectomy	1095	333	51	20	313	31	731	1.28952	0.04230	1.50675	2.68443	0.84573	0.1635518853	0.7879650300	15.50959	0.34709	159	27	6	174	24	14	0.70622	0.71680
20	80394007	Hyperglycemia (disorder)	40	428251008	History of appendectomy	1095	55	51	1	54	50	990	0.39037	-0.03099	0.36667	2.70480	0.04971	0.5102482171	1.0000000000	2.56164	-0.83254	23	27	0	32	24	1	-3.21888	-3.49651
19	237602007	Metabolic syndrome X (disorder)	40	428251008	History of appendectomy	1095	64	51	1	63	50	981	0.33548	-0.03659	0.31143	2.29150	0.04232	0.3580233069	1.0000000000	2.98082	-0.99307	28	27	0	36	24	1	-3.21888	-3.61092
18	302870006	Hypertriglyceridemia (disorder)	40	428251008	History of appendectomy	1095	64	51	1	63	50	981	0.33548	-0.03659	0.31143	2.29150	0.04232	0.3580233069	1.0000000000	2.98082	-0.99307	28	27	0	36	24	1	-3.21888	-3.61092
17	368581000119106	Neuropathy due to type 2 diabetes mellitus (disorder)	40	428251008	History of appendectomy	1095	28	51	0	28	51	1016	0.00000	-0.03580	0.00000	0.00000	0.00000	0.6369436204	1.0000000000	1.30411	-1.20421	7	27	0	21	24	0	0.00000	0.00000
15	40055000	Chronic sinusitis (disorder)	40	428251008	History of appendectomy	1095	216	51	13	203	38	841	1.29221	0.03202	1.41729	2.70983	0.74127	0.2823525312	0.9647685943	10.06027	0.34004	104	27	7	112	24	6	-0.02899	-0.21531
14	10509002	Acute bronchitis (disorder)	40	428251008	History of appendectomy	1095	863	51	46	817	5	227	1.14443	0.06157	2.55618	6.50837	1.00395	0.0515965443	0.4397227827	40.19452	0.19021	418	27	24	445	24	22	0.01617	-0.14203
13	370247008	Facial laceration	40	428251008	History of appendectomy	1095	109	51	10	99	41	945	1.96978	0.07127	2.32816	4.79072	1.13142	0.0282166279	0.3099944430	5.07671	0.85614	55	27	4	54	24	6	0.43825	0.38866
125	1734006	Fracture of the vertebral column with spinal cord injury	14	10509002	Acute bronchitis (disorder)	1095	5	863	3	2	860	230	0.76130	-0.03118	0.40116	2.41504	0.06664	0.2870534183	0.9695093904	3.94064	-0.30470	3	418	2	2	445	1	-0.75321	-0.18232
10	62106007	Concussion with no loss of consciousness	40	428251008	History of appendectomy	1095	206	51	9	197	42	847	0.93804	-0.00659	0.92132	1.92414	0.44115	1.0000000000	1.0000000000	9.59452	-0.08332	96	27	5	110	24	4	-0.08961	-0.34422
9	44465007	Sprain of ankle	40	428251008	History of appendectomy	1095	362	51	19	343	32	701	1.12691	0.01971	1.21347	2.17198	0.67795	0.5430933688	1.0000000000	16.86027	0.16325	185	27	7	177	24	12	0.48184	0.55474
8	233678006	Childhood asthma	40	428251008	History of appendectomy	1095	45	51	6	39	45	1005	2.86275	0.08523	3.43590	8.53509	1.38316	0.0152466105	0.2090920355	2.09589	1.17700	25	27	4	20	24	2	-0.51726	-0.41689
7	75498004	Acute bacterial sinusitis (disorder)	40	428251008	History of appendectomy	1095	187	51	11	176	40	868	1.26298	0.02638	1.35625	2.69498	0.68253	0.3470866848	1.0000000000	8.70959	0.30555	89	27	6	98	24	5	-0.05311	-0.26317
6	39848009	Whiplash injury to neck	40	428251008	History of appendectomy	1095	182	51	12	170	39	874	1.41564	0.04102	1.58190	3.08382	0.81146	0.1783962546	0.8051220167	8.47671	0.45605	92	27	7	90	24	5	-0.17741	-0.29523
5	284549007	Laceration of hand	40	428251008	History of appendectomy	1095	104	51	3	101	48	943	0.61934	-0.02726	0.58354	1.90729	0.17854	0.4700225459	1.0000000000	4.84384	-0.54692	54	27	3	50	24	0	2.30259	2.94444
1	444814009	Viral sinusitis (disorder)	40	428251008	History of appendectomy	1095	993	51	49	944	2	100	1.05948	0.04102	2.59534	10.83269	0.62180	0.2215112411	0.8794911525	46.24932	0.08163	478	27	26	515	24	23	-0.00246	-0.18788
96	283371005	Laceration of forearm	14	10509002	Acute bronchitis (disorder)	1095	75	863	66	9	797	223	1.11657	0.06096	2.05186	4.18222	1.00667	0.0556001609	0.4578407246	59.10959	0.15657	39	418	36	36	445	30	-0.22754	-0.05449
94	703151001	History of single seizure (situation)	14	10509002	Acute bronchitis (disorder)	1095	39	863	32	7	831	225	1.04109	0.01523	1.23775	2.84133	0.53919	0.6949029691	1.0000000000	30.73699	0.05630	14	418	11	25	445	21	0.56390	0.03686
75	431855005	Chronic kidney disease stage 1 (disorder)	14	10509002	Acute bronchitis (disorder)	1095	28	863	26	2	837	230	1.17820	0.05568	3.57228	15.16227	0.84164	0.0967726909	0.6177968585	22.06758	0.22709	10	418	9	18	445	17	0.55721	0.02508
44	58150001	Fracture of clavicle	14	10509002	Acute bronchitis (disorder)	1095	112	863	101	11	762	221	1.14421	0.09389	2.66297	5.05059	1.40407	0.0013701784	0.0317346327	88.27032	0.19232	55	418	49	57	445	52	-0.00284	0.01247
42	16114001	Fracture of ankle	14	10509002	Acute bronchitis (disorder)	1095	108	863	95	13	768	219	1.11610	0.07407	2.08383	3.79217	1.14509	0.0129335342	0.1834096331	85.11781	0.15672	48	418	45	60	445	50	0.03853	-0.06252
41	283385000	Laceration of thigh	14	10509002	Acute bronchitis (disorder)	1095	105	863	95	10	768	222	1.14799	0.09295	2.74609	5.35846	1.40731	0.0015276280	0.0343564566	82.75342	0.19689	50	418	45	55	445	50	0.03853	0.00528
33	429007001	History of cardiac arrest (situation)	14	10509002	Acute bronchitis (disorder)	1095	42	863	36	6	827	226	1.08757	0.03373	1.63966	3.94002	0.68235	0.3368920776	1.0000000000	33.10137	0.11770	24	418	20	18	445	16	-0.27432	0.03469
21	15777000	Prediabetes	14	10509002	Acute bronchitis (disorder)	1095	333	863	308	25	555	207	1.17357	0.22130	4.59503	7.11858	2.96608	0.0000000000	0.0000000000	262.44658	0.23010	159	418	147	174	445	161	0.02092	0.00043
15	40055000	Chronic sinusitis (disorder)	14	10509002	Acute bronchitis (disorder)	1095	216	863	192	24	671	208	1.12785	0.12223	2.47988	3.89683	1.57816	0.0000258882	0.0010010853	170.23562	0.17262	104	418	93	112	445	99	-0.00006	-0.00613
118	48333001	Burn injury(morphologic abnormality)	31	230690007	Stroke	1095	1	62	0	1	62	1032	0.00000	-0.00741	0.00000	0.00000	0.00000	1.0000000000	1.0000000000	0.05662	-0.07946	0	32	0	1	30	0	0.00000	0.00000
119	275272006	Brain damage - traumatic	31	230690007	Stroke	1095	4	62	1	3	61	1030	4.41532	0.05066	5.62842	54.90978	0.57693	0.2082252145	0.8610424124	0.22648	0.70547	0	32	0	4	30	1	-3.43399	-1.60944
120	162573006	Suspected lung cancer (situation)	31	230690007	Stroke	1095	8	62	0	8	62	1025	0.00000	-0.02102	0.00000	0.00000	0.00000	1.0000000000	1.0000000000	0.45297	-0.53900	0	32	0	8	30	0	0.00000	0.00000
123	195967001	Asthma	31	230690007	Stroke	1095	2	62	1	1	61	1032	8.83065	0.08206	16.91803	273.74484	1.04557	0.1100848964	0.6542486263	0.11324	0.84523	1	32	1	1	30	0	3.49651	0.69315
126	698754002	Chronic paralysis due to lesion of spinal cord	31	230690007	Stroke	1095	2	62	0	2	62	1031	0.00000	-0.01048	0.00000	0.00000	0.00000	1.0000000000	1.0000000000	0.11324	-0.15477	2	32	0	0	30	0	0.00000	0.00000
127	431856006	Chronic kidney disease stage 2 (disorder)	31	230690007	Stroke	1095	5	62	0	5	62	1028	0.00000	-0.01659	0.00000	0.00000	0.00000	1.0000000000	1.0000000000	0.28311	-0.35964	3	32	0	2	30	0	0.00000	0.00000
128	86849004	Suicidal deliberate poisoning	31	230690007	Stroke	1095	1	62	0	1	62	1032	0.00000	-0.00741	0.00000	0.00000	0.00000	1.0000000000	1.0000000000	0.05662	-0.07946	0	32	0	1	30	0	0.00000	0.00000
118	48333001	Burn injury(morphologic abnormality)	65	239873007	Osteoarthritis of knee	1095	1	57	0	1	57	1037	0.00000	-0.00708	0.00000	0.00000	0.00000	1.0000000000	1.0000000000	0.05205	-0.07321	0	30	0	1	27	0	0.00000	0.00000
130	314994000	Metastasis from malignant tumor of prostate (disorder)	31	230690007	Stroke	1095	1	62	0	1	62	1032	0.00000	-0.00741	0.00000	0.00000	0.00000	1.0000000000	1.0000000000	0.05662	-0.07946	0	32	0	1	30	0	0.00000	0.00000
131	93761005	Primary malignant neoplasm of colon	31	230690007	Stroke	1095	5	62	0	5	62	1028	0.00000	-0.01659	0.00000	0.00000	0.00000	1.0000000000	1.0000000000	0.28311	-0.35964	3	32	0	2	30	0	0.00000	0.00000
128	86849004	Suicidal deliberate poisoning	65	239873007	Osteoarthritis of knee	1095	1	57	0	1	57	1037	0.00000	-0.00708	0.00000	0.00000	0.00000	1.0000000000	1.0000000000	0.05205	-0.07321	0	30	0	1	27	0	0.00000	0.00000
130	314994000	Metastasis from malignant tumor of prostate (disorder)	65	239873007	Osteoarthritis of knee	1095	1	57	0	1	57	1037	0.00000	-0.00708	0.00000	0.00000	0.00000	1.0000000000	1.0000000000	0.05205	-0.07321	0	30	0	1	27	0	0.00000	0.00000
130	314994000	Metastasis from malignant tumor of prostate (disorder)	127	431856006	Chronic kidney disease stage 2 (disorder)	1095	1	5	0	1	5	1089	0.00000	-0.00205	0.00000	0.00000	0.00000	1.0000000000	1.0000000000	0.00457	-0.00657	0	3	0	1	2	0	0.00000	0.00000
129	47505003	Posttraumatic stress disorder	127	431856006	Chronic kidney disease stage 2 (disorder)	1095	4	5	0	4	5	1086	0.00000	-0.00410	0.00000	0.00000	0.00000	1.0000000000	1.0000000000	0.01826	-0.02611	1	3	0	3	2	0	0.00000	0.00000
128	86849004	Suicidal deliberate poisoning	127	431856006	Chronic kidney disease stage 2 (disorder)	1095	1	5	0	1	5	1089	0.00000	-0.00205	0.00000	0.00000	0.00000	1.0000000000	1.0000000000	0.00457	-0.00657	0	3	0	1	2	0	0.00000	0.00000
125	1734006	Fracture of the vertebral column with spinal cord injury	127	431856006	Chronic kidney disease stage 2 (disorder)	1095	5	5	0	5	5	1085	0.00000	-0.00459	0.00000	0.00000	0.00000	1.0000000000	1.0000000000	0.02283	-0.03257	3	3	0	2	2	0	0.00000	0.00000
124	1501000119109	Proliferative diabetic retinopathy due to type II diabetes mellitus (disorder)	127	431856006	Chronic kidney disease stage 2 (disorder)	1095	1	5	0	1	5	1089	0.00000	-0.00205	0.00000	0.00000	0.00000	1.0000000000	1.0000000000	0.00457	-0.00657	1	3	0	0	2	0	0.00000	0.00000
121	254637007	Non-small cell lung cancer (disorder)	127	431856006	Chronic kidney disease stage 2 (disorder)	1095	8	5	1	7	4	1083	27.37500	0.15325	38.67857	391.18956	3.82431	0.0360647676	0.3569070239	0.03653	0.94824	0	3	0	8	2	1	-1.09861	-2.19722
120	162573006	Suspected lung cancer (situation)	127	431856006	Chronic kidney disease stage 2 (disorder)	1095	8	5	1	7	4	1083	27.37500	0.15325	38.67857	391.18956	3.82431	0.0360647676	0.3569070239	0.03653	0.94824	0	3	0	8	2	1	-1.09861	-2.19722
118	48333001	Burn injury(morphologic abnormality)	127	431856006	Chronic kidney disease stage 2 (disorder)	1095	1	5	0	1	5	1089	0.00000	-0.00205	0.00000	0.00000	0.00000	1.0000000000	1.0000000000	0.00457	-0.00657	0	3	0	1	2	0	0.00000	0.00000
117	230265002	Familial Alzheimer's disease of early onset (disorder)	127	431856006	Chronic kidney disease stage 2 (disorder)	1095	6	5	0	6	5	1084	0.00000	-0.00503	0.00000	0.00000	0.00000	1.0000000000	1.0000000000	0.02740	-0.03899	2	3	0	4	2	0	0.00000	0.00000
115	36923009	Major depression  single episode	127	431856006	Chronic kidney disease stage 2 (disorder)	1095	6	5	0	6	5	1084	0.00000	-0.00503	0.00000	0.00000	0.00000	1.0000000000	1.0000000000	0.02740	-0.03899	3	3	0	3	2	0	0.00000	0.00000
114	449868002	Smokes tobacco daily	127	431856006	Chronic kidney disease stage 2 (disorder)	1095	9	5	2	7	3	1083	48.66667	0.29390	103.14286	715.88782	14.86050	0.0005933699	0.0162261720	0.04110	1.52686	2	3	1	7	2	1	0.28768	-0.98083
112	49436004	Atrial Fibrillation	127	431856006	Chronic kidney disease stage 2 (disorder)	1095	35	5	0	35	5	1055	0.00000	-0.01231	0.00000	0.00000	0.00000	1.0000000000	1.0000000000	0.15982	-0.21390	9	3	0	26	2	0	0.00000	0.00000
111	235919008	Cholelithiasis	127	431856006	Chronic kidney disease stage 2 (disorder)	1095	9	5	0	9	5	1081	0.00000	-0.00617	0.00000	0.00000	0.00000	1.0000000000	1.0000000000	0.04110	-0.05810	7	3	0	2	2	0	0.00000	0.00000
109	90560007	Gout	127	431856006	Chronic kidney disease stage 2 (disorder)	1095	4	5	0	4	5	1086	0.00000	-0.00410	0.00000	0.00000	0.00000	1.0000000000	1.0000000000	0.01826	-0.02611	0	3	0	4	2	0	0.00000	0.00000
108	40930008	Hypothyroidism (disorder)	127	431856006	Chronic kidney disease stage 2 (disorder)	1095	13	5	0	13	5	1077	0.00000	-0.00742	0.00000	0.00000	0.00000	1.0000000000	1.0000000000	0.05936	-0.08319	11	3	0	2	2	0	0.00000	0.00000
107	40275004	Contact dermatitis	127	431856006	Chronic kidney disease stage 2 (disorder)	1095	18	5	0	18	5	1072	0.00000	-0.00876	0.00000	0.00000	0.00000	1.0000000000	1.0000000000	0.08219	-0.11396	9	3	0	9	2	0	0.00000	0.00000
106	24079001	Atopic dermatitis	127	431856006	Chronic kidney disease stage 2 (disorder)	1095	20	5	0	20	5	1070	0.00000	-0.00924	0.00000	0.00000	0.00000	1.0000000000	1.0000000000	0.09132	-0.12608	13	3	0	7	2	0	0.00000	0.00000
105	363406005	Malignant tumor of colon	127	431856006	Chronic kidney disease stage 2 (disorder)	1095	6	5	1	5	4	1085	36.50000	0.17847	54.25000	575.05459	5.11788	0.0271477435	0.3035705638	0.02740	0.96101	4	3	1	2	2	0	1.38629	1.60944
104	367498001	Seasonal allergic rhinitis	127	431856006	Chronic kidney disease stage 2 (disorder)	1095	20	5	0	20	5	1070	0.00000	-0.00924	0.00000	0.00000	0.00000	1.0000000000	1.0000000000	0.09132	-0.12608	9	3	0	11	2	0	0.00000	0.00000
102	90781000119102	Microalbuminuria due to type 2 diabetes mellitus (disorder)	127	431856006	Chronic kidney disease stage 2 (disorder)	1095	6	5	5	1	0	1089	182.50000	0.91245	0.00000	0.00000	0.00000	0.0000000000	0.0000000000	0.02740	2.54597	3	3	3	3	2	2	0.00000	-0.22314
101	433144002	Chronic kidney disease stage 3 (disorder)	127	431856006	Chronic kidney disease stage 2 (disorder)	1095	3	5	2	1	3	1089	146.00000	0.51474	726.00000	10321.88356	51.06394	0.0000499947	0.0018362088	0.01370	1.56533	1	3	1	2	2	1	0.28768	-0.40547
100	161622006	History of lower limb amputation (situation)	127	431856006	Chronic kidney disease stage 2 (disorder)	1095	1	5	0	1	5	1089	0.00000	-0.00205	0.00000	0.00000	0.00000	1.0000000000	1.0000000000	0.00457	-0.00657	0	3	0	1	2	0	0.00000	0.00000
98	1551000119108	Nonproliferative diabetic retinopathy due to type 2 diabetes mellitus (disorder)	127	431856006	Chronic kidney disease stage 2 (disorder)	1095	12	5	0	12	5	1078	0.00000	-0.00713	0.00000	0.00000	0.00000	1.0000000000	1.0000000000	0.05479	-0.07696	7	3	0	5	2	0	0.00000	0.00000
97	403192003	Third degree burn	127	431856006	Chronic kidney disease stage 2 (disorder)	1095	8	5	0	8	5	1082	0.00000	-0.00581	0.00000	0.00000	0.00000	1.0000000000	1.0000000000	0.03653	-0.05176	3	3	0	5	2	0	0.00000	0.00000
96	283371005	Laceration of forearm	127	431856006	Chronic kidney disease stage 2 (disorder)	1095	75	5	1	74	4	1016	2.92000	0.03526	3.43243	31.10129	0.37881	0.2991294647	0.9871272335	0.34247	0.57511	39	3	1	36	2	0	1.38629	3.68888
95	84757009	Epilepsy	127	431856006	Chronic kidney disease stage 2 (disorder)	1095	30	5	1	29	4	1061	7.30000	0.07161	9.14655	84.39601	0.99127	0.1299075327	0.7087186589	0.13699	0.81479	13	3	0	17	2	1	-1.09861	-2.89037
94	703151001	History of single seizure (situation)	127	431856006	Chronic kidney disease stage 2 (disorder)	1095	39	5	2	37	3	1053	11.23077	0.13316	18.97297	116.97934	3.07724	0.0115542890	0.1696045966	0.17808	1.34852	14	3	0	25	2	2	-0.69315	-2.60269
93	128613002	Seizure disorder	127	431856006	Chronic kidney disease stage 2 (disorder)	1095	39	5	2	37	3	1053	11.23077	0.13316	18.97297	116.97934	3.07724	0.0115542890	0.1696045966	0.17808	1.34852	14	3	0	25	2	2	-0.69315	-2.60269
89	47693006	Rupture of appendix	127	431856006	Chronic kidney disease stage 2 (disorder)	1095	20	5	0	20	5	1070	0.00000	-0.00924	0.00000	0.00000	0.00000	1.0000000000	1.0000000000	0.09132	-0.12608	10	3	0	10	2	0	0.00000	0.00000
86	713197008	Recurrent rectal polyp	127	431856006	Chronic kidney disease stage 2 (disorder)	1095	22	5	1	21	4	1069	9.95455	0.08684	12.72619	118.76240	1.36370	0.0966699264	0.6177968585	0.10046	0.86190	12	3	1	10	2	0	1.38629	2.56495
82	94260004	Secondary malignant neoplasm of colon	127	431856006	Chronic kidney disease stage 2 (disorder)	1095	4	5	0	4	5	1086	0.00000	-0.00410	0.00000	0.00000	0.00000	1.0000000000	1.0000000000	0.01826	-0.02611	2	3	0	2	2	0	0.00000	0.00000
80	6072007	Bleeding from anus	127	431856006	Chronic kidney disease stage 2 (disorder)	1095	4	5	0	4	5	1086	0.00000	-0.00410	0.00000	0.00000	0.00000	1.0000000000	1.0000000000	0.01826	-0.02611	2	3	0	2	2	0	0.00000	0.00000
78	239872002	Osteoarthritis of hip	127	431856006	Chronic kidney disease stage 2 (disorder)	1095	21	5	1	20	4	1070	10.42857	0.08929	13.37500	125.07279	1.43029	0.0924448091	0.6006517651	0.09589	0.86790	13	3	0	8	2	1	-1.09861	-2.19722
76	127013003	Diabetic renal disease (disorder)	127	431856006	Chronic kidney disease stage 2 (disorder)	1095	28	5	5	23	0	1067	39.10714	0.41809	0.00000	0.00000	0.00000	0.0000000076	0.0000005145	0.12785	2.41138	10	3	3	18	2	2	0.00000	-0.83625
75	431855005	Chronic kidney disease stage 1 (disorder)	127	431856006	Chronic kidney disease stage 2 (disorder)	1095	28	5	5	23	0	1067	39.10714	0.41809	0.00000	0.00000	0.00000	0.0000000076	0.0000005145	0.12785	2.41138	10	3	3	18	2	2	0.00000	-0.83625
73	196416002	Impacted molars	127	431856006	Chronic kidney disease stage 2 (disorder)	1095	49	5	0	49	5	1041	0.00000	-0.01466	0.00000	0.00000	0.00000	1.0000000000	1.0000000000	0.22374	-0.29130	25	3	0	24	2	0	0.00000	0.00000
72	35999006	Blighted ovum	127	431856006	Chronic kidney disease stage 2 (disorder)	1095	53	5	0	53	5	1037	0.00000	-0.01527	0.00000	0.00000	0.00000	1.0000000000	1.0000000000	0.24201	-0.31268	53	3	0	0	2	0	0.00000	0.00000
71	201834006	Localized  primary osteoarthritis of the hand	127	431856006	Chronic kidney disease stage 2 (disorder)	1095	28	5	0	28	5	1062	0.00000	-0.01097	0.00000	0.00000	0.00000	1.0000000000	1.0000000000	0.12785	-0.17358	19	3	0	9	2	0	0.00000	0.00000
70	87433001	Pulmonary emphysema (disorder)	127	431856006	Chronic kidney disease stage 2 (disorder)	1095	17	5	0	17	5	1073	0.00000	-0.00851	0.00000	0.00000	0.00000	1.0000000000	1.0000000000	0.07763	-0.10786	9	3	0	8	2	0	0.00000	0.00000
69	233604007	Pneumonia	127	431856006	Chronic kidney disease stage 2 (disorder)	1095	7	5	0	7	5	1083	0.00000	-0.00543	0.00000	0.00000	0.00000	1.0000000000	1.0000000000	0.03196	-0.04539	3	3	0	4	2	0	0.00000	0.00000
68	26929004	Alzheimer's disease (disorder)	127	431856006	Chronic kidney disease stage 2 (disorder)	1095	23	5	0	23	5	1067	0.00000	-0.00992	0.00000	0.00000	0.00000	1.0000000000	1.0000000000	0.10502	-0.14408	15	3	0	8	2	0	0.00000	0.00000
67	403191005	Second degree burn	127	431856006	Chronic kidney disease stage 2 (disorder)	1095	49	5	1	48	4	1042	4.46939	0.05086	5.42708	49.48801	0.59516	0.2049370625	0.8533859271	0.22374	0.70870	23	3	1	26	2	0	1.38629	3.17805
65	239873007	Osteoarthritis of knee	127	431856006	Chronic kidney disease stage 2 (disorder)	1095	57	5	1	56	4	1034	3.84211	0.04511	4.61607	41.98411	0.50753	0.2349360088	0.8997636792	0.26027	0.66626	30	3	1	27	2	0	1.38629	3.43399
64	444448004	Injury of medial collateral ligament of knee	127	431856006	Chronic kidney disease stage 2 (disorder)	1095	32	5	1	31	4	1059	6.84375	0.06867	8.54032	78.65095	0.92735	0.1380620581	0.7305055733	0.14612	0.80324	17	3	1	15	2	0	1.38629	2.89037
63	68496003	Polyp of colon	127	431856006	Chronic kidney disease stage 2 (disorder)	1095	91	5	2	89	3	1001	4.81319	0.07775	7.49813	45.46470	1.23661	0.0578925327	0.4685406893	0.41553	1.08363	43	3	1	48	2	1	0.28768	-0.10763
62	185086009	Chronic obstructive bronchitis (disorder)	127	431856006	Chronic kidney disease stage 2 (disorder)	1095	6	5	0	6	5	1084	0.00000	-0.00503	0.00000	0.00000	0.00000	1.0000000000	1.0000000000	0.02740	-0.03899	4	3	0	2	2	0	0.00000	0.00000
59	262574004	Bullet wound	127	431856006	Chronic kidney disease stage 2 (disorder)	1095	20	5	0	20	5	1070	0.00000	-0.00924	0.00000	0.00000	0.00000	1.0000000000	1.0000000000	0.09132	-0.12608	9	3	0	11	2	0	0.00000	0.00000
58	239720000	Tear of meniscus of knee	127	431856006	Chronic kidney disease stage 2 (disorder)	1095	20	5	0	20	5	1070	0.00000	-0.00924	0.00000	0.00000	0.00000	1.0000000000	1.0000000000	0.09132	-0.12608	10	3	0	10	2	0	0.00000	0.00000
57	192127007	Child attention deficit disorder	127	431856006	Chronic kidney disease stage 2 (disorder)	1095	76	5	0	76	5	1014	0.00000	-0.01850	0.00000	0.00000	0.00000	1.0000000000	1.0000000000	0.34703	-0.42978	24	3	0	52	2	0	0.00000	0.00000
56	92691004	Carcinoma in situ of prostate (disorder)	127	431856006	Chronic kidney disease stage 2 (disorder)	1095	23	5	1	22	4	1068	9.52174	0.08454	12.13636	113.04743	1.30292	0.1008792930	0.6283150080	0.10502	0.85592	0	3	0	23	2	1	-1.09861	-3.17805
54	5602001	Opioid abuse (disorder)	127	431856006	Chronic kidney disease stage 2 (disorder)	1095	7	5	0	7	5	1083	0.00000	-0.00543	0.00000	0.00000	0.00000	1.0000000000	1.0000000000	0.03196	-0.04539	0	3	0	7	2	0	0.00000	0.00000
52	124171000119105	Chronic intractable migraine without aura	127	431856006	Chronic kidney disease stage 2 (disorder)	1095	51	5	0	51	5	1039	0.00000	-0.01497	0.00000	0.00000	0.00000	1.0000000000	1.0000000000	0.23288	-0.30203	21	3	0	30	2	0	0.00000	0.00000
50	446096008	Perennial allergic rhinitis	127	431856006	Chronic kidney disease stage 2 (disorder)	1095	26	5	1	25	4	1065	8.42308	0.07841	10.65000	98.73740	1.14873	0.1134133292	0.6645809103	0.11872	0.83815	14	3	1	12	2	0	1.38629	2.70805
49	88805009	Chronic congestive heart failure (disorder)	127	431856006	Chronic kidney disease stage 2 (disorder)	1095	10	5	0	10	5	1080	0.00000	-0.00650	0.00000	0.00000	0.00000	1.0000000000	1.0000000000	0.04566	-0.06442	5	3	0	5	2	0	0.00000	0.00000
47	359817006	Closed fracture of hip	127	431856006	Chronic kidney disease stage 2 (disorder)	1095	29	5	0	29	5	1061	0.00000	-0.01117	0.00000	0.00000	0.00000	1.0000000000	1.0000000000	0.13242	-0.17941	11	3	0	18	2	0	0.00000	0.00000
46	62564004	Concussion with loss of consciousness	127	431856006	Chronic kidney disease stage 2 (disorder)	1095	67	5	0	67	5	1023	0.00000	-0.01729	0.00000	0.00000	0.00000	1.0000000000	1.0000000000	0.30594	-0.38508	36	3	0	31	2	0	0.00000	0.00000
45	263102004	Fracture subluxation of wrist	127	431856006	Chronic kidney disease stage 2 (disorder)	1095	109	5	0	109	5	981	0.00000	-0.02252	0.00000	0.00000	0.00000	1.0000000000	1.0000000000	0.49772	-0.58276	51	3	0	58	2	0	0.00000	0.00000
44	58150001	Fracture of clavicle	127	431856006	Chronic kidney disease stage 2 (disorder)	1095	112	5	1	111	4	979	1.95536	0.02184	2.20495	19.90141	0.24430	0.4175699306	1.0000000000	0.51142	0.40410	55	3	1	57	2	0	1.38629	4.02535
43	307731004	Injury of tendon of the rotator cuff of shoulder	127	431856006	Chronic kidney disease stage 2 (disorder)	1095	51	5	0	51	5	1039	0.00000	-0.01497	0.00000	0.00000	0.00000	1.0000000000	1.0000000000	0.23288	-0.30203	26	3	0	25	2	0	0.00000	0.00000
42	16114001	Fracture of ankle	127	431856006	Chronic kidney disease stage 2 (disorder)	1095	108	5	1	107	4	983	2.02778	0.02303	2.29673	20.73576	0.25439	0.4055984650	1.0000000000	0.49315	0.42164	48	3	0	60	2	1	-1.09861	-4.11087
41	283385000	Laceration of thigh	127	431856006	Chronic kidney disease stage 2 (disorder)	1095	105	5	1	104	4	986	2.08571	0.02395	2.37019	21.40399	0.26247	0.3964913401	1.0000000000	0.47945	0.43494	50	3	1	55	2	0	1.38629	3.93183
39	74400008	Appendicitis	127	431856006	Chronic kidney disease stage 2 (disorder)	1095	51	5	0	51	5	1039	0.00000	-0.01497	0.00000	0.00000	0.00000	1.0000000000	1.0000000000	0.23288	-0.30203	27	3	0	24	2	0	0.00000	0.00000
38	398254007	Preeclampsia	127	431856006	Chronic kidney disease stage 2 (disorder)	1095	101	5	2	99	3	991	4.33663	0.07204	6.67340	40.41550	1.10191	0.0700423741	0.5206028448	0.46119	1.03782	101	3	2	0	2	0	0.91629	3.94158
35	19169002	Miscarriage in first trimester	127	431856006	Chronic kidney disease stage 2 (disorder)	1095	174	5	1	173	4	917	1.25862	0.00761	1.32514	11.92748	0.14722	0.5797807012	1.0000000000	0.79452	0.15640	174	3	1	0	2	0	1.38629	5.16479
33	429007001	History of cardiac arrest (situation)	127	431856006	Chronic kidney disease stage 2 (disorder)	1095	42	5	0	42	5	1048	0.00000	-0.01353	0.00000	0.00000	0.00000	1.0000000000	1.0000000000	0.19178	-0.25312	24	3	0	18	2	0	0.00000	0.00000
32	410429000	Cardiac Arrest	127	431856006	Chronic kidney disease stage 2 (disorder)	1095	42	5	0	42	5	1048	0.00000	-0.01353	0.00000	0.00000	0.00000	1.0000000000	1.0000000000	0.19178	-0.25312	24	3	0	18	2	0	0.00000	0.00000
30	399211009	History of myocardial infarction (situation)	127	431856006	Chronic kidney disease stage 2 (disorder)	1095	31	5	0	31	5	1059	0.00000	-0.01156	0.00000	0.00000	0.00000	1.0000000000	1.0000000000	0.14155	-0.19100	2	3	0	29	2	0	0.00000	0.00000
29	22298006	Myocardial Infarction	127	431856006	Chronic kidney disease stage 2 (disorder)	1095	31	5	0	31	5	1059	0.00000	-0.01156	0.00000	0.00000	0.00000	1.0000000000	1.0000000000	0.14155	-0.19100	2	3	0	29	2	0	0.00000	0.00000
28	53741008	Coronary Heart Disease	127	431856006	Chronic kidney disease stage 2 (disorder)	1095	80	5	0	80	5	1010	0.00000	-0.01901	0.00000	0.00000	0.00000	1.0000000000	1.0000000000	0.36530	-0.44921	24	3	0	56	2	0	0.00000	0.00000
27	408512008	Body mass index 40+ - severely obese (finding)	127	431856006	Chronic kidney disease stage 2 (disorder)	1095	97	5	0	97	5	993	0.00000	-0.02112	0.00000	0.00000	0.00000	1.0000000000	1.0000000000	0.44292	-0.52899	67	3	0	30	2	0	0.00000	0.00000
24	162864005	Body mass index 30+ - obesity (finding)	127	431856006	Chronic kidney disease stage 2 (disorder)	1095	439	5	2	437	3	653	0.99772	-0.00013	0.99619	5.98628	0.16578	1.0000000000	1.0000000000	2.00457	-0.00219	226	3	1	213	2	1	0.28768	0.05897
23	36971009	Sinusitis (disorder)	127	431856006	Chronic kidney disease stage 2 (disorder)	1095	190	5	0	190	5	900	0.00000	-0.03103	0.00000	0.00000	0.00000	0.5941776973	1.0000000000	0.86758	-0.90117	84	3	0	106	2	0	0.00000	0.00000
21	15777000	Prediabetes	127	431856006	Chronic kidney disease stage 2 (disorder)	1095	333	5	4	329	1	761	2.63063	0.07301	9.25228	83.09559	1.03020	0.0320420789	0.3293505485	1.52055	0.98819	159	3	3	174	2	1	-0.40547	-1.17580
20	80394007	Hyperglycemia (disorder)	127	431856006	Chronic kidney disease stage 2 (disorder)	1095	55	5	3	52	2	1038	11.94545	0.17048	29.94231	183.09731	4.89653	0.0011179445	0.0272154825	0.25114	1.67675	23	3	2	32	2	1	-0.18232	-0.97078
19	237602007	Metabolic syndrome X (disorder)	127	431856006	Chronic kidney disease stage 2 (disorder)	1095	64	5	5	59	0	1031	17.10937	0.27184	0.00000	0.00000	0.00000	0.0000005865	0.0000310157	0.29224	2.21509	28	3	3	36	2	2	0.00000	-0.60906
18	302870006	Hypertriglyceridemia (disorder)	127	431856006	Chronic kidney disease stage 2 (disorder)	1095	64	5	5	59	0	1031	17.10937	0.27184	0.00000	0.00000	0.00000	0.0000005865	0.0000310157	0.29224	2.21509	28	3	3	36	2	2	0.00000	-0.60906
17	368581000119106	Neuropathy due to type 2 diabetes mellitus (disorder)	127	431856006	Chronic kidney disease stage 2 (disorder)	1095	28	5	0	28	5	1062	0.00000	-0.01097	0.00000	0.00000	0.00000	1.0000000000	1.0000000000	0.12785	-0.17358	7	3	0	21	2	0	0.00000	0.00000
129	47505003	Posttraumatic stress disorder	101	433144002	Chronic kidney disease stage 3 (disorder)	1095	4	3	0	4	3	1088	0.00000	-0.00317	0.00000	0.00000	0.00000	1.0000000000	1.0000000000	0.01096	-0.01572	1	1	0	3	2	0	0.00000	0.00000
15	40055000	Chronic sinusitis (disorder)	127	431856006	Chronic kidney disease stage 2 (disorder)	1095	216	5	0	216	5	874	0.00000	-0.03357	0.00000	0.00000	0.00000	0.5895012359	1.0000000000	0.98630	-0.99008	104	3	0	112	2	0	0.00000	0.00000
14	10509002	Acute bronchitis (disorder)	127	431856006	Chronic kidney disease stage 2 (disorder)	1095	863	5	3	860	2	230	0.76130	-0.03118	0.40116	2.41504	0.06664	0.2870534183	0.9695093904	3.94064	-0.30470	418	3	2	445	2	1	-0.18232	-0.75321
13	370247008	Facial laceration	127	431856006	Chronic kidney disease stage 2 (disorder)	1095	109	5	1	108	4	982	2.00917	0.02273	2.27315	20.52133	0.25180	0.4086096177	1.0000000000	0.49772	0.41724	55	3	0	54	2	1	-1.09861	-4.00733
125	1734006	Fracture of the vertebral column with spinal cord injury	101	433144002	Chronic kidney disease stage 3 (disorder)	1095	5	3	0	5	3	1087	0.00000	-0.00355	0.00000	0.00000	0.00000	1.0000000000	1.0000000000	0.01370	-0.01963	3	1	0	2	2	0	0.00000	0.00000
124	1501000119109	Proliferative diabetic retinopathy due to type II diabetes mellitus (disorder)	101	433144002	Chronic kidney disease stage 3 (disorder)	1095	1	3	0	1	3	1091	0.00000	-0.00158	0.00000	0.00000	0.00000	1.0000000000	1.0000000000	0.00274	-0.00395	1	1	0	0	2	0	0.00000	0.00000
10	62106007	Concussion with no loss of consciousness	127	431856006	Chronic kidney disease stage 2 (disorder)	1095	206	5	0	206	5	884	0.00000	-0.03260	0.00000	0.00000	0.00000	0.5903525073	1.0000000000	0.94064	-0.95653	96	3	0	110	2	0	0.00000	0.00000
8	233678006	Childhood asthma	127	431856006	Chronic kidney disease stage 2 (disorder)	1095	45	5	0	45	5	1045	0.00000	-0.01402	0.00000	0.00000	0.00000	1.0000000000	1.0000000000	0.20548	-0.26961	25	3	0	20	2	0	0.00000	0.00000
7	75498004	Acute bacterial sinusitis (disorder)	127	431856006	Chronic kidney disease stage 2 (disorder)	1095	187	5	2	185	3	905	2.34225	0.04126	3.26126	19.65410	0.54115	0.2039274487	0.8524167357	0.85388	0.69441	89	3	1	98	2	1	0.28768	-0.09531
6	39848009	Whiplash injury to neck	127	431856006	Chronic kidney disease stage 2 (disorder)	1095	182	5	2	180	3	910	2.40659	0.04253	3.37037	20.31477	0.55917	0.1950681871	0.8340316782	0.83105	0.71229	92	3	2	90	2	0	0.91629	3.85015
5	284549007	Laceration of hand	127	431856006	Chronic kidney disease stage 2 (disorder)	1095	104	5	1	103	4	987	2.10577	0.02426	2.39563	21.63546	0.26526	0.3934309513	1.0000000000	0.47489	0.43940	54	3	1	50	2	0	1.38629	4.00733
117	230265002	Familial Alzheimer's disease of early onset (disorder)	101	433144002	Chronic kidney disease stage 3 (disorder)	1095	6	3	0	6	3	1086	0.00000	-0.00389	0.00000	0.00000	0.00000	1.0000000000	1.0000000000	0.01644	-0.02352	2	1	0	4	2	0	0.00000	0.00000
115	36923009	Major depression  single episode	101	433144002	Chronic kidney disease stage 3 (disorder)	1095	6	3	0	6	3	1086	0.00000	-0.00389	0.00000	0.00000	0.00000	1.0000000000	1.0000000000	0.01644	-0.02352	3	1	0	3	2	0	0.00000	0.00000
1	444814009	Viral sinusitis (disorder)	127	431856006	Chronic kidney disease stage 2 (disorder)	1095	993	5	5	988	0	102	1.10272	0.02171	0.00000	0.00000	0.00000	1.0000000000	1.0000000000	4.53425	0.11658	478	3	3	515	2	2	0.00000	-0.47764
111	235919008	Cholelithiasis	101	433144002	Chronic kidney disease stage 3 (disorder)	1095	9	3	0	9	3	1083	0.00000	-0.00477	0.00000	0.00000	0.00000	1.0000000000	1.0000000000	0.02466	-0.03514	7	1	0	2	2	0	0.00000	0.00000
109	90560007	Gout	101	433144002	Chronic kidney disease stage 3 (disorder)	1095	4	3	0	4	3	1088	0.00000	-0.00317	0.00000	0.00000	0.00000	1.0000000000	1.0000000000	0.01096	-0.01572	0	1	0	4	2	0	0.00000	0.00000
107	40275004	Contact dermatitis	101	433144002	Chronic kidney disease stage 3 (disorder)	1095	18	3	0	18	3	1074	0.00000	-0.00678	0.00000	0.00000	0.00000	1.0000000000	1.0000000000	0.04932	-0.06945	9	1	0	9	2	0	0.00000	0.00000
106	24079001	Atopic dermatitis	101	433144002	Chronic kidney disease stage 3 (disorder)	1095	20	3	0	20	3	1072	0.00000	-0.00715	0.00000	0.00000	0.00000	1.0000000000	1.0000000000	0.05479	-0.07696	13	1	0	7	2	0	0.00000	0.00000
102	90781000119102	Microalbuminuria due to type 2 diabetes mellitus (disorder)	101	433144002	Chronic kidney disease stage 3 (disorder)	1095	6	3	3	3	0	1089	182.50000	0.70613	0.00000	0.00000	0.00000	0.0000000916	0.0000053993	0.01644	1.97648	3	1	1	3	2	2	0.00000	0.47000
98	1551000119108	Nonproliferative diabetic retinopathy due to type 2 diabetes mellitus (disorder)	101	433144002	Chronic kidney disease stage 3 (disorder)	1095	12	3	1	11	2	1081	30.41667	0.16230	49.13636	582.56919	4.14437	0.0325471502	0.3325947436	0.03288	0.95333	7	1	0	5	2	1	-1.09861	-1.79176
97	403192003	Third degree burn	101	433144002	Chronic kidney disease stage 3 (disorder)	1095	8	3	0	8	3	1084	0.00000	-0.00450	0.00000	0.00000	0.00000	1.0000000000	1.0000000000	0.02192	-0.03128	3	1	0	5	2	0	0.00000	0.00000
96	283371005	Laceration of forearm	101	433144002	Chronic kidney disease stage 3 (disorder)	1095	75	3	1	74	2	1018	4.86667	0.05496	6.87838	76.73920	0.61653	0.1918899076	0.8268943621	0.20548	0.73039	39	1	1	36	2	0	0.69315	3.68888
94	703151001	History of single seizure (situation)	101	433144002	Chronic kidney disease stage 3 (disorder)	1095	39	3	1	38	2	1054	9.35897	0.08420	13.86842	156.30210	1.23052	0.1031797921	0.6315984763	0.10685	0.85354	14	1	0	25	2	1	-1.09861	-3.25810
93	128613002	Seizure disorder	101	433144002	Chronic kidney disease stage 3 (disorder)	1095	39	3	1	38	2	1054	9.35897	0.08420	13.86842	156.30210	1.23052	0.1031797921	0.6315984763	0.10685	0.85354	14	1	0	25	2	1	-1.09861	-3.25810
89	47693006	Rupture of appendix	101	433144002	Chronic kidney disease stage 3 (disorder)	1095	20	3	0	20	3	1072	0.00000	-0.00715	0.00000	0.00000	0.00000	1.0000000000	1.0000000000	0.05479	-0.07696	10	1	0	10	2	0	0.00000	0.00000
86	713197008	Recurrent rectal polyp	101	433144002	Chronic kidney disease stage 3 (disorder)	1095	22	3	0	22	3	1070	0.00000	-0.00751	0.00000	0.00000	0.00000	1.0000000000	1.0000000000	0.06027	-0.08444	12	1	0	10	2	0	0.00000	0.00000
82	94260004	Secondary malignant neoplasm of colon	101	433144002	Chronic kidney disease stage 3 (disorder)	1095	4	3	0	4	3	1088	0.00000	-0.00317	0.00000	0.00000	0.00000	1.0000000000	1.0000000000	0.01096	-0.01572	2	1	0	2	2	0	0.00000	0.00000
78	239872002	Osteoarthritis of hip	101	433144002	Chronic kidney disease stage 3 (disorder)	1095	21	3	0	21	3	1071	0.00000	-0.00733	0.00000	0.00000	0.00000	1.0000000000	1.0000000000	0.05753	-0.08070	13	1	0	8	2	0	0.00000	0.00000
76	127013003	Diabetic renal disease (disorder)	101	433144002	Chronic kidney disease stage 3 (disorder)	1095	28	3	3	25	0	1067	39.10714	0.32356	0.00000	0.00000	0.00000	0.0000150122	0.0006072666	0.07671	1.89337	10	1	1	18	2	2	0.00000	0.09531
75	431855005	Chronic kidney disease stage 1 (disorder)	101	433144002	Chronic kidney disease stage 3 (disorder)	1095	28	3	3	25	0	1067	39.10714	0.32356	0.00000	0.00000	0.00000	0.0000150122	0.0006072666	0.07671	1.89337	10	1	1	18	2	2	0.00000	0.09531
72	35999006	Blighted ovum	101	433144002	Chronic kidney disease stage 3 (disorder)	1095	53	3	0	53	3	1039	0.00000	-0.01182	0.00000	0.00000	0.00000	1.0000000000	1.0000000000	0.14521	-0.19561	53	1	0	0	2	0	0.00000	0.00000
71	201834006	Localized  primary osteoarthritis of the hand	101	433144002	Chronic kidney disease stage 3 (disorder)	1095	28	3	0	28	3	1064	0.00000	-0.00849	0.00000	0.00000	0.00000	1.0000000000	1.0000000000	0.07671	-0.10663	19	1	0	9	2	0	0.00000	0.00000
70	87433001	Pulmonary emphysema (disorder)	101	433144002	Chronic kidney disease stage 3 (disorder)	1095	17	3	0	17	3	1075	0.00000	-0.00658	0.00000	0.00000	0.00000	1.0000000000	1.0000000000	0.04658	-0.06568	9	1	0	8	2	0	0.00000	0.00000
69	233604007	Pneumonia	101	433144002	Chronic kidney disease stage 3 (disorder)	1095	7	3	0	7	3	1085	0.00000	-0.00420	0.00000	0.00000	0.00000	1.0000000000	1.0000000000	0.01918	-0.02741	3	1	0	4	2	0	0.00000	0.00000
128	86849004	Suicidal deliberate poisoning	95	84757009	Epilepsy	1095	1	30	0	1	30	1064	0.00000	-0.00507	0.00000	0.00000	0.00000	1.0000000000	1.0000000000	0.02740	-0.03899	0	13	0	1	17	0	0.00000	0.00000
67	403191005	Second degree burn	101	433144002	Chronic kidney disease stage 3 (disorder)	1095	49	3	1	48	2	1044	7.44898	0.07316	10.87500	122.03388	0.96912	0.1284408422	0.7042184342	0.13425	0.81827	23	1	1	26	2	0	0.69315	3.17805
130	314994000	Metastasis from malignant tumor of prostate (disorder)	95	84757009	Epilepsy	1095	1	30	0	1	30	1064	0.00000	-0.00507	0.00000	0.00000	0.00000	1.0000000000	1.0000000000	0.02740	-0.03899	0	13	0	1	17	0	0.00000	0.00000
64	444448004	Injury of medial collateral ligament of knee	101	433144002	Chronic kidney disease stage 3 (disorder)	1095	32	3	0	32	3	1060	0.00000	-0.00909	0.00000	0.00000	0.00000	1.0000000000	1.0000000000	0.08767	-0.12124	17	1	0	15	2	0	0.00000	0.00000
63	68496003	Polyp of colon	101	433144002	Chronic kidney disease stage 3 (disorder)	1095	91	3	1	90	2	1002	4.01099	0.04751	5.56667	61.98701	0.49991	0.2293613895	0.8880487574	0.24932	0.67886	43	1	0	48	2	1	-1.09861	-3.89182
59	262574004	Bullet wound	101	433144002	Chronic kidney disease stage 3 (disorder)	1095	20	3	0	20	3	1072	0.00000	-0.00715	0.00000	0.00000	0.00000	1.0000000000	1.0000000000	0.05479	-0.07696	9	1	0	11	2	0	0.00000	0.00000
58	239720000	Tear of meniscus of knee	101	433144002	Chronic kidney disease stage 3 (disorder)	1095	20	3	0	20	3	1072	0.00000	-0.00715	0.00000	0.00000	0.00000	1.0000000000	1.0000000000	0.05479	-0.07696	10	1	0	10	2	0	0.00000	0.00000
57	192127007	Child attention deficit disorder	101	433144002	Chronic kidney disease stage 3 (disorder)	1095	76	3	0	76	3	1016	0.00000	-0.01431	0.00000	0.00000	0.00000	1.0000000000	1.0000000000	0.20822	-0.27288	24	1	0	52	2	0	0.00000	0.00000
56	92691004	Carcinoma in situ of prostate (disorder)	101	433144002	Chronic kidney disease stage 3 (disorder)	1095	23	3	1	22	2	1070	15.86957	0.11416	24.31818	278.24967	2.12534	0.0617546283	0.4836892708	0.06301	0.91184	0	1	0	23	2	1	-1.09861	-3.17805
54	5602001	Opioid abuse (disorder)	101	433144002	Chronic kidney disease stage 3 (disorder)	1095	7	3	0	7	3	1085	0.00000	-0.00420	0.00000	0.00000	0.00000	1.0000000000	1.0000000000	0.01918	-0.02741	0	1	0	7	2	0	0.00000	0.00000
52	124171000119105	Chronic intractable migraine without aura	101	433144002	Chronic kidney disease stage 3 (disorder)	1095	51	3	0	51	3	1041	0.00000	-0.01158	0.00000	0.00000	0.00000	1.0000000000	1.0000000000	0.13973	-0.18869	21	1	0	30	2	0	0.00000	0.00000
50	446096008	Perennial allergic rhinitis	101	433144002	Chronic kidney disease stage 3 (disorder)	1095	26	3	1	25	2	1067	14.03846	0.10658	21.34000	243.12544	1.87309	0.0696169832	0.5191995567	0.07123	0.90073	14	1	1	12	2	0	0.69315	2.70805
49	88805009	Chronic congestive heart failure (disorder)	101	433144002	Chronic kidney disease stage 3 (disorder)	1095	10	3	0	10	3	1082	0.00000	-0.00503	0.00000	0.00000	0.00000	1.0000000000	1.0000000000	0.02740	-0.03899	5	1	0	5	2	0	0.00000	0.00000
47	359817006	Closed fracture of hip	101	433144002	Chronic kidney disease stage 3 (disorder)	1095	29	3	0	29	3	1063	0.00000	-0.00865	0.00000	0.00000	0.00000	1.0000000000	1.0000000000	0.07945	-0.11030	11	1	0	18	2	0	0.00000	0.00000
45	263102004	Fracture subluxation of wrist	101	433144002	Chronic kidney disease stage 3 (disorder)	1095	109	3	0	109	3	983	0.00000	-0.01743	0.00000	0.00000	0.00000	1.0000000000	1.0000000000	0.29863	-0.37699	51	1	0	58	2	0	0.00000	0.00000
44	58150001	Fracture of clavicle	101	433144002	Chronic kidney disease stage 3 (disorder)	1095	112	3	0	112	3	980	0.00000	-0.01769	0.00000	0.00000	0.00000	1.0000000000	1.0000000000	0.30685	-0.38609	55	1	0	57	2	0	0.00000	0.00000
43	307731004	Injury of tendon of the rotator cuff of shoulder	101	433144002	Chronic kidney disease stage 3 (disorder)	1095	51	3	0	51	3	1041	0.00000	-0.01158	0.00000	0.00000	0.00000	1.0000000000	1.0000000000	0.13973	-0.18869	26	1	0	25	2	0	0.00000	0.00000
42	16114001	Fracture of ankle	101	433144002	Chronic kidney disease stage 3 (disorder)	1095	108	3	1	107	2	985	3.37963	0.04126	4.60280	51.18264	0.41393	0.2678860284	0.9388450812	0.29589	0.62606	48	1	0	60	2	1	-1.09861	-4.11087
41	283385000	Laceration of thigh	101	433144002	Chronic kidney disease stage 3 (disorder)	1095	105	3	0	105	3	987	0.00000	-0.01707	0.00000	0.00000	0.00000	1.0000000000	1.0000000000	0.28767	-0.36476	50	1	0	55	2	0	0.00000	0.00000
39	74400008	Appendicitis	101	433144002	Chronic kidney disease stage 3 (disorder)	1095	51	3	0	51	3	1041	0.00000	-0.01158	0.00000	0.00000	0.00000	1.0000000000	1.0000000000	0.13973	-0.18869	27	1	0	24	2	0	0.00000	0.00000
38	398254007	Preeclampsia	101	433144002	Chronic kidney disease stage 3 (disorder)	1095	101	3	1	100	2	992	3.61386	0.04367	4.96000	55.18309	0.44582	0.2521823659	0.9133257124	0.27671	0.64757	101	1	1	0	2	0	0.69315	4.62497
35	19169002	Miscarriage in first trimester	101	433144002	Chronic kidney disease stage 3 (disorder)	1095	174	3	1	173	2	919	2.09770	0.02501	2.65607	29.45300	0.23952	0.4052816131	1.0000000000	0.47671	0.43761	174	1	1	0	2	0	0.69315	5.16479
33	429007001	History of cardiac arrest (situation)	101	433144002	Chronic kidney disease stage 3 (disorder)	1095	42	3	0	42	3	1050	0.00000	-0.01047	0.00000	0.00000	0.00000	1.0000000000	1.0000000000	0.11507	-0.15713	24	1	0	18	2	0	0.00000	0.00000
32	410429000	Cardiac Arrest	101	433144002	Chronic kidney disease stage 3 (disorder)	1095	42	3	0	42	3	1050	0.00000	-0.01047	0.00000	0.00000	0.00000	1.0000000000	1.0000000000	0.11507	-0.15713	24	1	0	18	2	0	0.00000	0.00000
30	399211009	History of myocardial infarction (situation)	101	433144002	Chronic kidney disease stage 3 (disorder)	1095	31	3	0	31	3	1061	0.00000	-0.00895	0.00000	0.00000	0.00000	1.0000000000	1.0000000000	0.08493	-0.11760	2	1	0	29	2	0	0.00000	0.00000
29	22298006	Myocardial Infarction	101	433144002	Chronic kidney disease stage 3 (disorder)	1095	31	3	0	31	3	1061	0.00000	-0.00895	0.00000	0.00000	0.00000	1.0000000000	1.0000000000	0.08493	-0.11760	2	1	0	29	2	0	0.00000	0.00000
27	408512008	Body mass index 40+ - severely obese (finding)	101	433144002	Chronic kidney disease stage 3 (disorder)	1095	97	3	0	97	3	995	0.00000	-0.01634	0.00000	0.00000	0.00000	1.0000000000	1.0000000000	0.26575	-0.34000	67	1	0	30	2	0	0.00000	0.00000
24	162864005	Body mass index 30+ - obesity (finding)	101	433144002	Chronic kidney disease stage 3 (disorder)	1095	439	3	1	438	2	654	0.83144	-0.00723	0.74658	8.25854	0.06749	1.0000000000	1.0000000000	1.20274	-0.13930	226	1	0	213	2	1	-1.09861	-5.36598
23	36971009	Sinusitis (disorder)	101	433144002	Chronic kidney disease stage 3 (disorder)	1095	190	3	1	189	2	903	1.92105	0.02212	2.38889	26.48031	0.21551	0.4357739195	1.0000000000	0.52055	0.39541	84	1	0	106	2	1	-1.09861	-4.67283
21	15777000	Prediabetes	101	433144002	Chronic kidney disease stage 3 (disorder)	1095	333	3	3	330	0	762	3.28829	0.07929	0.00000	0.00000	0.00000	0.0279485131	0.3078193827	0.91233	1.06467	159	1	1	174	2	2	0.00000	0.59784
20	80394007	Hyperglycemia (disorder)	101	433144002	Chronic kidney disease stage 3 (disorder)	1095	55	3	2	53	1	1039	13.27273	0.14793	39.20755	439.28273	3.49941	0.0071973880	0.1207683861	0.15068	1.38247	23	1	1	32	2	1	-0.40547	-0.31845
19	237602007	Metabolic syndrome X (disorder)	101	433144002	Chronic kidney disease stage 3 (disorder)	1095	64	3	3	61	0	1031	17.10937	0.21037	0.00000	0.00000	0.00000	0.0001909240	0.0061165372	0.17534	1.76692	28	1	1	36	2	2	0.00000	0.42286
18	302870006	Hypertriglyceridemia (disorder)	101	433144002	Chronic kidney disease stage 3 (disorder)	1095	64	3	3	61	0	1031	17.10937	0.21037	0.00000	0.00000	0.00000	0.0001909240	0.0061165372	0.17534	1.76692	28	1	1	36	2	2	0.00000	0.42286
17	368581000119106	Neuropathy due to type 2 diabetes mellitus (disorder)	101	433144002	Chronic kidney disease stage 3 (disorder)	1095	28	3	1	27	2	1065	13.03571	0.10219	19.72222	224.16927	1.73514	0.0748340751	0.5403135912	0.07671	0.89337	7	1	0	21	2	1	-1.09861	-3.09104
15	40055000	Chronic sinusitis (disorder)	101	433144002	Chronic kidney disease stage 3 (disorder)	1095	216	3	1	215	2	877	1.68981	0.01792	2.03953	22.59684	0.18408	0.4830704237	1.0000000000	0.59178	0.32936	104	1	0	112	2	1	-1.09861	-4.72739
14	10509002	Acute bronchitis (disorder)	101	433144002	Chronic kidney disease stage 3 (disorder)	1095	863	3	2	861	1	231	0.84589	-0.01558	0.53659	5.94362	0.04844	0.5108189669	1.0000000000	2.36438	-0.16538	418	1	1	445	2	1	-0.40547	-0.06245
13	370247008	Facial laceration	101	433144002	Chronic kidney disease stage 3 (disorder)	1095	109	3	1	108	2	984	3.34862	0.04093	4.55556	50.65380	0.40970	0.2701112988	0.9405144708	0.29863	0.62301	55	1	0	54	2	1	-1.09861	-4.00733
10	62106007	Concussion with no loss of consciousness	101	433144002	Chronic kidney disease stage 3 (disorder)	1095	206	3	1	205	2	887	1.77184	0.01947	2.16341	23.97345	0.19523	0.4652057324	1.0000000000	0.56438	0.35441	96	1	0	110	2	1	-1.09861	-4.70953
7	75498004	Acute bacterial sinusitis (disorder)	101	433144002	Chronic kidney disease stage 3 (disorder)	1095	187	3	2	185	1	907	3.90374	0.06907	9.80541	108.70027	0.88451	0.0772763621	0.5501475317	0.51233	0.98819	89	1	0	98	2	2	-0.69315	-3.91202
6	39848009	Whiplash injury to neck	101	433144002	Chronic kidney disease stage 3 (disorder)	1095	182	3	1	181	2	911	2.00549	0.02353	2.51657	27.90067	0.22699	0.4206615011	1.0000000000	0.49863	0.41636	92	1	1	90	2	0	0.69315	4.53260
5	284549007	Laceration of hand	101	433144002	Chronic kidney disease stage 3 (disorder)	1095	104	3	0	104	3	988	0.00000	-0.01698	0.00000	0.00000	0.00000	1.0000000000	1.0000000000	0.28493	-0.36169	54	1	0	50	2	0	0.00000	0.00000
1	444814009	Viral sinusitis (disorder)	101	433144002	Chronic kidney disease stage 3 (disorder)	1095	993	3	3	990	0	102	1.10272	0.01680	0.00000	0.00000	0.00000	1.0000000000	1.0000000000	2.72055	0.10448	478	1	1	515	2	2	0.00000	0.61680
117	230265002	Familial Alzheimer's disease of early onset (disorder)	40	428251008	History of appendectomy	1095	6	51	1	5	50	1039	3.57843	0.04230	4.15600	36.24351	0.47656	0.2493687300	0.9133257124	0.27945	0.64447	2	27	0	4	24	1	-3.21888	-1.60944
118	48333001	Burn injury(morphologic abnormality)	40	428251008	History of appendectomy	1095	1	51	0	1	51	1043	0.00000	-0.00668	0.00000	0.00000	0.00000	1.0000000000	1.0000000000	0.04658	-0.06568	0	27	0	1	24	0	0.00000	0.00000
120	162573006	Suspected lung cancer (situation)	40	428251008	History of appendectomy	1095	8	51	1	7	50	1037	2.68382	0.03193	2.96286	24.54668	0.35763	0.3180602796	1.0000000000	0.37260	0.54309	0	27	0	8	24	1	-3.21888	-2.19722
121	254637007	Non-small cell lung cancer (disorder)	40	428251008	History of appendectomy	1095	8	51	1	7	50	1037	2.68382	0.03193	2.96286	24.54668	0.35763	0.3180602796	1.0000000000	0.37260	0.54309	0	27	0	8	24	1	-3.21888	-2.19722
124	1501000119109	Proliferative diabetic retinopathy due to type II diabetes mellitus (disorder)	40	428251008	History of appendectomy	1095	1	51	0	1	51	1043	0.00000	-0.00668	0.00000	0.00000	0.00000	1.0000000000	1.0000000000	0.04658	-0.06568	1	27	0	0	24	0	0.00000	0.00000
125	1734006	Fracture of the vertebral column with spinal cord injury	40	428251008	History of appendectomy	1095	5	51	1	4	50	1040	4.29412	0.04931	5.20000	47.38305	0.57067	0.2125234992	0.8671354646	0.23288	0.69797	3	27	1	2	24	0	3.33220	1.38629
127	431856006	Chronic kidney disease stage 2 (disorder)	40	428251008	History of appendectomy	1095	5	51	0	5	51	1039	0.00000	-0.01497	0.00000	0.00000	0.00000	1.0000000000	1.0000000000	0.23288	-0.30203	3	27	0	2	24	0	0.00000	0.00000
128	86849004	Suicidal deliberate poisoning	40	428251008	History of appendectomy	1095	1	51	0	1	51	1043	0.00000	-0.00668	0.00000	0.00000	0.00000	1.0000000000	1.0000000000	0.04658	-0.06568	0	27	0	1	24	0	0.00000	0.00000
129	47505003	Posttraumatic stress disorder	40	428251008	History of appendectomy	1095	4	51	0	4	51	1040	0.00000	-0.01338	0.00000	0.00000	0.00000	1.0000000000	1.0000000000	0.18630	-0.24647	1	27	0	3	24	0	0.00000	0.00000
130	314994000	Metastasis from malignant tumor of prostate (disorder)	40	428251008	History of appendectomy	1095	1	51	0	1	51	1043	0.00000	-0.00668	0.00000	0.00000	0.00000	1.0000000000	1.0000000000	0.04658	-0.06568	0	27	0	1	24	0	0.00000	0.00000
15	40055000	Chronic sinusitis (disorder)	75	431855005	Chronic kidney disease stage 1 (disorder)	1095	216	28	5	211	23	856	0.90526	-0.00761	0.88193	2.34699	0.33140	1.0000000000	1.0000000000	5.52329	-0.12064	104	10	1	112	18	4	0.69315	1.28666
125	1734006	Fracture of the vertebral column with spinal cord injury	49	88805009	Chronic congestive heart failure (disorder)	1095	5	10	0	5	10	1080	0.00000	-0.00650	0.00000	0.00000	0.00000	1.0000000000	1.0000000000	0.04566	-0.06442	3	5	0	2	5	0	0.00000	0.00000
118	48333001	Burn injury(morphologic abnormality)	49	88805009	Chronic congestive heart failure (disorder)	1095	1	10	0	1	10	1084	0.00000	-0.00290	0.00000	0.00000	0.00000	1.0000000000	1.0000000000	0.00913	-0.01312	0	5	0	1	5	0	0.00000	0.00000
109	90560007	Gout	49	88805009	Chronic congestive heart failure (disorder)	1095	4	10	0	4	10	1081	0.00000	-0.00581	0.00000	0.00000	0.00000	1.0000000000	1.0000000000	0.03653	-0.05176	0	5	0	4	5	0	0.00000	0.00000
97	403192003	Third degree burn	49	88805009	Chronic congestive heart failure (disorder)	1095	8	10	0	8	10	1077	0.00000	-0.00824	0.00000	0.00000	0.00000	1.0000000000	1.0000000000	0.07306	-0.10173	3	5	0	5	5	0	0.00000	0.00000
96	283371005	Laceration of forearm	49	88805009	Chronic congestive heart failure (disorder)	1095	75	10	1	74	9	1011	1.46000	0.01197	1.51802	12.14395	0.18976	0.5096115070	1.0000000000	0.68493	0.24731	39	5	0	36	5	1	-1.79176	-3.61092
94	703151001	History of single seizure (situation)	49	88805009	Chronic congestive heart failure (disorder)	1095	39	10	1	38	9	1047	2.80769	0.03335	3.06140	24.78056	0.37821	0.3052397979	0.9953175875	0.35616	0.56047	14	5	1	25	5	0	1.79176	2.70805
93	128613002	Seizure disorder	49	88805009	Chronic congestive heart failure (disorder)	1095	39	10	1	38	9	1047	2.80769	0.03335	3.06140	24.78056	0.37821	0.3052397979	0.9953175875	0.35616	0.56047	14	5	1	25	5	0	1.79176	2.70805
86	713197008	Recurrent rectal polyp	49	88805009	Chronic congestive heart failure (disorder)	1095	22	10	2	20	8	1065	9.95455	0.12309	13.31250	66.69298	2.65729	0.0157366027	0.2138326607	0.20091	1.32083	12	5	1	10	5	1	0.00000	0.16705
75	431855005	Chronic kidney disease stage 1 (disorder)	49	88805009	Chronic congestive heart failure (disorder)	1095	28	10	0	28	10	1057	0.00000	-0.01555	0.00000	0.00000	0.00000	1.0000000000	1.0000000000	0.25571	-0.32850	10	5	0	18	5	0	0.00000	0.00000
69	233604007	Pneumonia	49	88805009	Chronic congestive heart failure (disorder)	1095	7	10	0	7	10	1078	0.00000	-0.00770	0.00000	0.00000	0.00000	1.0000000000	1.0000000000	0.06393	-0.08940	3	5	0	4	5	0	0.00000	0.00000
64	444448004	Injury of medial collateral ligament of knee	49	88805009	Chronic congestive heart failure (disorder)	1095	32	10	0	32	10	1053	0.00000	-0.01666	0.00000	0.00000	0.00000	1.0000000000	1.0000000000	0.29224	-0.36987	17	5	0	15	5	0	0.00000	0.00000
47	359817006	Closed fracture of hip	49	88805009	Chronic congestive heart failure (disorder)	1095	29	10	1	28	9	1057	3.77586	0.04395	4.19444	34.24543	0.51374	0.2362654258	0.9019682653	0.26484	0.66104	11	5	0	18	5	1	-1.79176	-2.94444
44	58150001	Fracture of clavicle	49	88805009	Chronic congestive heart failure (disorder)	1095	112	10	0	112	10	973	0.00000	-0.03241	0.00000	0.00000	0.00000	0.6109485659	1.0000000000	1.02283	-1.01638	55	5	0	57	5	0	0.00000	0.00000
43	307731004	Injury of tendon of the rotator cuff of shoulder	49	88805009	Chronic congestive heart failure (disorder)	1095	51	10	0	51	10	1034	0.00000	-0.02122	0.00000	0.00000	0.00000	1.0000000000	1.0000000000	0.46575	-0.55164	26	5	0	25	5	0	0.00000	0.00000
42	16114001	Fracture of ankle	49	88805009	Chronic congestive heart failure (disorder)	1095	108	10	1	107	9	978	1.01389	0.00044	1.01558	8.09348	0.12744	1.0000000000	1.0000000000	0.98630	0.00992	48	5	0	60	5	1	-1.79176	-4.11087
41	283385000	Laceration of thigh	49	88805009	Chronic congestive heart failure (disorder)	1095	105	10	2	103	8	982	2.08571	0.03395	2.38350	11.37364	0.49949	0.2477761105	0.9133257124	0.95890	0.61492	50	5	0	55	5	2	-1.25276	-3.34990
38	398254007	Preeclampsia	49	88805009	Chronic congestive heart failure (disorder)	1095	101	10	1	100	9	985	1.08416	0.00258	1.09444	8.72723	0.13725	1.0000000000	1.0000000000	0.92237	0.05711	101	5	1	0	5	0	1.79176	4.62497
35	19169002	Miscarriage in first trimester	49	88805009	Chronic congestive heart failure (disorder)	1095	174	10	3	171	7	914	1.88793	0.03705	2.29073	8.94592	0.58657	0.2027166618	0.8514099796	1.58904	0.62758	174	5	3	0	5	0	0.98083	4.07754
33	429007001	History of cardiac arrest (situation)	49	88805009	Chronic congestive heart failure (disorder)	1095	42	10	0	42	10	1043	0.00000	-0.01917	0.00000	0.00000	0.00000	1.0000000000	1.0000000000	0.38356	-0.46839	24	5	0	18	5	0	0.00000	0.00000
32	410429000	Cardiac Arrest	49	88805009	Chronic congestive heart failure (disorder)	1095	42	10	0	42	10	1043	0.00000	-0.01917	0.00000	0.00000	0.00000	1.0000000000	1.0000000000	0.38356	-0.46839	24	5	0	18	5	0	0.00000	0.00000
27	408512008	Body mass index 40+ - severely obese (finding)	49	88805009	Chronic congestive heart failure (disorder)	1095	97	10	0	97	10	988	0.00000	-0.02993	0.00000	0.00000	0.00000	1.0000000000	1.0000000000	0.88584	-0.91521	67	5	0	30	5	0	0.00000	0.00000
21	15777000	Prediabetes	49	88805009	Chronic congestive heart failure (disorder)	1095	333	10	5	328	5	757	1.64414	0.04088	2.30793	8.02606	0.66365	0.1825418541	0.8154465118	3.04110	0.57022	159	5	3	174	5	2	-0.27193	-0.48835
130	314994000	Metastasis from malignant tumor of prostate (disorder)	23	36971009	Sinusitis (disorder)	1095	1	190	1	0	189	905	5.76316	0.06598	0.00000	0.00000	0.00000	0.1735159817	0.7996618359	0.17352	0.76916	0	84	0	1	106	1	-4.67283	-0.69315
129	47505003	Posttraumatic stress disorder	23	36971009	Sinusitis (disorder)	1095	4	190	3	1	187	904	4.32237	0.09218	14.50267	140.18709	1.50033	0.0179755377	0.2327275365	0.69406	1.23951	1	84	1	3	106	2	0.45367	-0.22314
15	40055000	Chronic sinusitis (disorder)	49	88805009	Chronic congestive heart failure (disorder)	1095	216	10	3	213	7	872	1.52083	0.02479	1.75453	6.84128	0.44997	0.4236144882	1.0000000000	1.97260	0.42827	104	5	1	112	5	2	0.53900	0.61091
14	10509002	Acute bronchitis (disorder)	49	88805009	Chronic congestive heart failure (disorder)	1095	863	10	10	853	0	232	1.26883	0.04978	0.00000	0.00000	0.00000	0.1319917848	0.7140816678	7.88128	0.30866	418	5	5	445	5	5	0.00000	-0.06188
125	1734006	Fracture of the vertebral column with spinal cord injury	23	36971009	Sinusitis (disorder)	1095	5	190	1	4	189	901	1.15263	0.00474	1.19180	10.72284	0.13246	1.0000000000	1.0000000000	0.86758	0.09883	3	84	1	2	106	0	4.44265	1.38629
118	48333001	Burn injury(morphologic abnormality)	23	36971009	Sinusitis (disorder)	1095	1	190	0	1	190	904	0.00000	-0.01385	0.00000	0.00000	0.00000	1.0000000000	1.0000000000	0.17352	-0.23084	0	84	0	1	106	0	0.00000	0.00000
117	230265002	Familial Alzheimer's disease of early onset (disorder)	23	36971009	Sinusitis (disorder)	1095	6	190	3	3	187	902	2.88158	0.06399	4.82353	24.08386	0.96606	0.0685525751	0.5135368799	1.04110	0.97066	2	84	1	4	106	2	0.45367	0.00000
109	90560007	Gout	23	36971009	Sinusitis (disorder)	1095	4	190	0	4	190	901	0.00000	-0.02774	0.00000	0.00000	0.00000	1.0000000000	1.0000000000	0.69406	-0.76049	0	84	0	4	106	0	0.00000	0.00000
102	90781000119102	Microalbuminuria due to type 2 diabetes mellitus (disorder)	23	36971009	Sinusitis (disorder)	1095	6	190	1	5	189	900	0.96053	-0.00134	0.95238	8.19861	0.11063	1.0000000000	1.0000000000	1.04110	-0.02934	3	84	0	3	106	1	-4.67283	-1.38629
98	1551000119108	Nonproliferative diabetic retinopathy due to type 2 diabetes mellitus (disorder)	23	36971009	Sinusitis (disorder)	1095	12	190	4	8	186	897	1.92105	0.04442	2.41129	8.09086	0.71863	0.1390630501	0.7320273048	2.08219	0.69797	7	84	1	5	106	3	0.84992	1.09861
97	403192003	Third degree burn	23	36971009	Sinusitis (disorder)	1095	8	190	1	7	189	898	0.72039	-0.01099	0.67876	5.54928	0.08302	1.0000000000	1.0000000000	1.38813	-0.25588	3	84	0	5	106	1	-4.67283	-1.79176
96	283371005	Laceration of forearm	23	36971009	Sinusitis (disorder)	1095	75	190	16	59	174	846	1.22947	0.02851	1.31853	2.34563	0.74117	0.3441990833	1.0000000000	13.01370	0.27870	39	84	4	36	106	12	0.80526	0.98861
94	703151001	History of single seizure (situation)	23	36971009	Sinusitis (disorder)	1095	39	190	1	38	189	867	0.14777	-0.07504	0.12072	0.88472	0.01647	0.0085589581	0.1376017106	6.76712	-1.95738	14	84	0	25	106	1	-4.67283	-3.25810
93	128613002	Seizure disorder	23	36971009	Sinusitis (disorder)	1095	39	190	1	38	189	867	0.14777	-0.07504	0.12072	0.88472	0.01647	0.0085589581	0.1376017106	6.76712	-1.95738	14	84	0	25	106	1	-4.67283	-3.25810
89	47693006	Rupture of appendix	23	36971009	Sinusitis (disorder)	1095	20	190	4	16	186	889	1.15263	0.00954	1.19489	3.61484	0.39497	0.7649471497	1.0000000000	3.47032	0.16155	10	84	3	10	106	1	-1.30553	-0.93156
86	713197008	Recurrent rectal polyp	23	36971009	Sinusitis (disorder)	1095	22	190	3	19	187	886	0.78589	-0.01405	0.74810	2.55386	0.21914	0.7830713928	1.0000000000	3.81735	-0.26824	12	84	1	10	106	2	0.45367	0.77319
75	431855005	Chronic kidney disease stage 1 (disorder)	23	36971009	Sinusitis (disorder)	1095	28	190	5	23	185	882	1.02914	0.00216	1.03643	2.76156	0.38898	1.0000000000	1.0000000000	4.85845	0.03444	10	84	1	18	106	4	1.12847	0.69315
72	35999006	Blighted ovum	23	36971009	Sinusitis (disorder)	1095	53	190	11	42	179	863	1.19613	0.02027	1.26270	2.50011	0.63774	0.4617868313	1.0000000000	9.19635	0.23498	53	84	11	0	106	0	2.15598	1.76099
69	233604007	Pneumonia	23	36971009	Sinusitis (disorder)	1095	7	190	3	4	187	901	2.46992	0.05402	3.61364	16.27982	0.80212	0.1049962733	0.6373840157	1.21461	0.85295	3	84	1	4	106	2	0.45367	0.28768
67	403191005	Second degree burn	23	36971009	Sinusitis (disorder)	1095	49	190	8	41	182	864	0.94092	-0.00586	0.92629	2.00906	0.42708	1.0000000000	1.0000000000	8.50228	-0.07835	23	84	5	26	106	3	-0.71354	-0.54592
64	444448004	Injury of medial collateral ligament of knee	23	36971009	Sinusitis (disorder)	1095	32	190	8	24	182	881	1.44079	0.03504	1.61355	3.64863	0.71357	0.2393099819	0.9095097439	5.55251	0.45788	17	84	4	15	106	4	-0.22314	0.10008
63	68496003	Polyp of colon	23	36971009	Sinusitis (disorder)	1095	91	190	17	74	173	831	1.07663	0.01057	1.10350	1.91648	0.63539	0.7722659686	1.0000000000	15.78995	0.10040	43	84	8	48	106	9	-0.10536	0.00656
58	239720000	Tear of meniscus of knee	23	36971009	Sinusitis (disorder)	1095	20	190	1	19	189	886	0.28816	-0.04449	0.24673	1.85435	0.03283	0.2292431194	0.8880487574	3.47032	-1.16038	10	84	0	10	106	1	-4.67283	-2.39790
57	192127007	Child attention deficit disorder	23	36971009	Sinusitis (disorder)	1095	76	190	19	57	171	848	1.44079	0.05516	1.65302	2.84963	0.95889	0.0827223023	0.5681818225	13.18721	0.49541	24	84	4	52	106	15	1.00330	0.44927
54	5602001	Opioid abuse (disorder)	23	36971009	Sinusitis (disorder)	1095	7	190	2	5	188	900	1.64662	0.02376	1.91489	9.94433	0.36873	0.3495179801	1.0000000000	1.21461	0.43791	0	84	0	7	106	2	-3.98898	-1.50408
50	446096008	Perennial allergic rhinitis	23	36971009	Sinusitis (disorder)	1095	26	190	4	22	186	883	0.88664	-0.00810	0.86315	2.53414	0.29399	1.0000000000	1.0000000000	4.51142	-0.14049	14	84	1	12	106	3	0.84992	1.09861
49	88805009	Chronic congestive heart failure (disorder)	23	36971009	Sinusitis (disorder)	1095	10	190	1	9	189	896	0.57632	-0.01864	0.52675	4.18247	0.06634	1.0000000000	1.0000000000	1.73516	-0.45163	5	84	0	5	106	1	-4.67283	-1.79176
47	359817006	Closed fracture of hip	23	36971009	Sinusitis (disorder)	1095	29	190	8	21	182	884	1.58984	0.04458	1.85034	4.24256	0.80700	0.1399841634	0.7357969976	5.03196	0.57730	11	84	2	18	106	6	0.83446	0.48551
44	58150001	Fracture of clavicle	23	36971009	Sinusitis (disorder)	1095	112	190	17	95	173	810	0.87477	-0.01937	0.83785	1.44008	0.48746	0.5992006389	1.0000000000	19.43379	-0.18296	55	84	9	57	106	8	-0.32138	-0.13329
43	307731004	Injury of tendon of the rotator cuff of shoulder	23	36971009	Sinusitis (disorder)	1095	51	190	9	42	181	863	1.01703	0.00172	1.02170	2.13617	0.48867	1.0000000000	1.0000000000	8.84932	0.02190	26	84	5	25	106	4	-0.43499	-0.15645
42	16114001	Fracture of ankle	23	36971009	Sinusitis (disorder)	1095	108	190	21	87	169	818	1.12061	0.01828	1.16833	1.93492	0.70546	0.5920571791	1.0000000000	18.73973	0.15640	48	84	9	60	106	12	0.04960	0.05407
41	283385000	Laceration of thigh	23	36971009	Sinusitis (disorder)	1095	105	190	22	83	168	822	1.20752	0.03097	1.29690	2.13488	0.78785	0.3419507592	1.0000000000	18.21918	0.25909	50	84	12	55	106	10	-0.37156	-0.22957
39	74400008	Appendicitis	23	36971009	Sinusitis (disorder)	1095	51	190	11	40	179	865	1.24303	0.02461	1.32891	2.63998	0.66894	0.4474462508	1.0000000000	8.84932	0.28494	27	84	7	24	106	4	-0.74924	-0.36546
38	398254007	Preeclampsia	23	36971009	Sinusitis (disorder)	1095	101	190	20	81	170	824	1.14122	0.02063	1.19680	2.00600	0.71403	0.4913799918	1.0000000000	17.52511	0.18091	101	84	20	0	106	0	1.64866	1.80006
35	19169002	Miscarriage in first trimester	23	36971009	Sinusitis (disorder)	1095	174	190	38	136	152	769	1.25862	0.05151	1.41360	2.10781	0.94803	0.1011159127	0.6283865258	30.19178	0.32231	174	84	38	0	106	0	1.16643	1.71900
33	429007001	History of cardiac arrest (situation)	23	36971009	Sinusitis (disorder)	1095	42	190	7	35	183	870	0.96053	-0.00361	0.95082	2.17402	0.41585	1.0000000000	1.0000000000	7.28767	-0.05097	24	84	4	18	106	3	-0.50169	0.00000
32	410429000	Cardiac Arrest	23	36971009	Sinusitis (disorder)	1095	42	190	7	35	183	870	0.96053	-0.00361	0.95082	2.17402	0.41585	1.0000000000	1.0000000000	7.28767	-0.05097	24	84	4	18	106	3	-0.50169	0.00000
30	399211009	History of myocardial infarction (situation)	23	36971009	Sinusitis (disorder)	1095	31	190	9	22	181	883	1.67317	0.05265	1.99573	4.40550	0.90408	0.0917743622	0.5998476181	5.37900	0.64860	2	84	0	29	106	9	-2.54771	-1.44036
27	408512008	Body mass index 40+ - severely obese (finding)	23	36971009	Sinusitis (disorder)	1095	97	190	17	80	173	825	1.01004	0.00143	1.01337	1.75378	0.58554	1.0000000000	1.0000000000	16.83105	0.01361	67	84	9	30	106	8	-0.32138	0.57536
24	162864005	Body mass index 30+ - obesity (finding)	23	36971009	Sinusitis (disorder)	1095	439	190	101	338	89	567	1.32592	0.12216	1.90370	2.60902	1.38905	0.0000639183	0.0023281113	76.17352	0.40239	226	84	48	213	106	53	-0.08701	0.12872
21	15777000	Prediabetes	23	36971009	Sinusitis (disorder)	1095	333	190	76	257	114	648	1.31532	0.09551	1.68093	2.32465	1.21547	0.0023192493	0.0489383896	57.78082	0.38951	159	84	30	174	106	46	0.13976	0.27556
20	80394007	Hyperglycemia (disorder)	23	36971009	Sinusitis (disorder)	1095	55	190	13	42	177	863	1.36220	0.03817	1.50915	2.86992	0.79358	0.2032895539	0.8521851499	9.54338	0.40909	23	84	5	32	106	8	0.22244	0.11333
18	302870006	Hypertriglyceridemia (disorder)	23	36971009	Sinusitis (disorder)	1095	64	190	15	49	175	856	1.35074	0.04004	1.49738	2.73052	0.82114	0.1773373347	0.8029498763	11.10502	0.40247	28	84	5	36	106	10	0.42819	0.36101
17	368581000119106	Neuropathy due to type 2 diabetes mellitus (disorder)	23	36971009	Sinusitis (disorder)	1095	28	190	9	19	181	886	1.85244	0.06327	2.31870	5.20730	1.03247	0.0442969747	0.4050404623	4.85845	0.77141	7	84	1	21	106	8	1.78589	0.79159
15	40055000	Chronic sinusitis (disorder)	23	36971009	Sinusitis (disorder)	1095	216	190	121	95	69	810	3.22844	0.50616	14.95195	21.52004	10.38849	0.0000000000	0.0000000000	37.47945	1.66472	104	84	59	112	106	62	-0.11152	-0.01571
14	10509002	Acute bronchitis (disorder)	23	36971009	Sinusitis (disorder)	1095	863	190	168	695	22	210	1.12191	0.10774	2.30739	3.69337	1.44151	0.0002744969	0.0084249434	149.74429	0.16492	418	84	75	445	106	93	-0.00929	0.12776
13	370247008	Facial laceration	23	36971009	Sinusitis (disorder)	1095	109	190	22	87	168	818	1.16321	0.02486	1.23125	2.02253	0.74955	0.4239358266	1.0000000000	18.91324	0.20791	55	84	10	54	106	12	-0.04507	0.16705
10	62106007	Concussion with no loss of consciousness	23	36971009	Sinusitis (disorder)	1095	206	190	40	166	150	739	1.11906	0.02626	1.18715	1.74863	0.80596	0.4139160188	1.0000000000	35.74429	0.15810	96	84	21	110	106	19	-0.27444	-0.19772
7	75498004	Acute bacterial sinusitis (disorder)	23	36971009	Sinusitis (disorder)	1095	187	190	42	145	148	760	1.29440	0.06122	1.48742	2.18804	1.01114	0.0556928928	0.4581745199	32.44749	0.36244	89	84	21	98	106	21	-0.19023	-0.07864
6	39848009	Whiplash injury to neck	23	36971009	Sinusitis (disorder)	1095	182	190	29	153	161	752	0.91831	-0.01671	0.88532	1.36355	0.57481	0.6681459413	1.0000000000	31.57991	-0.11902	92	84	11	90	106	18	0.22607	0.44507
5	284549007	Laceration of hand	23	36971009	Sinusitis (disorder)	1095	104	190	17	87	173	818	0.94205	-0.00860	0.92393	1.59341	0.53573	0.8918495172	1.0000000000	18.04566	-0.08147	54	84	9	50	106	8	-0.32138	-0.03509
118	48333001	Burn injury(morphologic abnormality)	101	433144002	Chronic kidney disease stage 3 (disorder)	1095	1	3	0	1	3	1091	0.00000	-0.00158	0.00000	0.00000	0.00000	1.0000000000	1.0000000000	0.00274	-0.00395	0	1	0	1	2	0	0.00000	0.00000
114	449868002	Smokes tobacco daily	100	161622006	History of lower limb amputation (situation)	1095	9	1	0	9	1	1085	0.00000	-0.00275	0.00000	0.00000	0.00000	1.0000000000	1.0000000000	0.00822	-0.01181	2	0	0	7	1	0	0.00000	0.00000
130	314994000	Metastasis from malignant tumor of prostate (disorder)	100	161622006	History of lower limb amputation (situation)	1095	1	1	0	1	1	1093	0.00000	-0.00091	0.00000	0.00000	0.00000	1.0000000000	1.0000000000	0.00091	-0.00132	0	0	0	1	1	0	0.00000	0.00000
127	431856006	Chronic kidney disease stage 2 (disorder)	88	197927001	Recurrent urinary tract infection	1095	5	8	0	5	8	1082	0.00000	-0.00581	0.00000	0.00000	0.00000	1.0000000000	1.0000000000	0.03653	-0.05176	3	8	0	2	0	0	0.00000	0.00000
120	162573006	Suspected lung cancer (situation)	79	45816000	Pyelonephritis	1095	8	1	0	8	1	1086	0.00000	-0.00259	0.00000	0.00000	0.00000	1.0000000000	1.0000000000	0.00731	-0.01050	0	1	0	8	0	0	0.00000	0.00000
121	254637007	Non-small cell lung cancer (disorder)	79	45816000	Pyelonephritis	1095	8	1	0	8	1	1086	0.00000	-0.00259	0.00000	0.00000	0.00000	1.0000000000	1.0000000000	0.00731	-0.01050	0	1	0	8	0	0	0.00000	0.00000
127	431856006	Chronic kidney disease stage 2 (disorder)	79	45816000	Pyelonephritis	1095	5	1	0	5	1	1089	0.00000	-0.00205	0.00000	0.00000	0.00000	1.0000000000	1.0000000000	0.00457	-0.00657	3	1	0	2	0	0	0.00000	0.00000
128	86849004	Suicidal deliberate poisoning	79	45816000	Pyelonephritis	1095	1	1	0	1	1	1093	0.00000	-0.00091	0.00000	0.00000	0.00000	1.0000000000	1.0000000000	0.00091	-0.00132	0	1	0	1	0	0	0.00000	0.00000
130	314994000	Metastasis from malignant tumor of prostate (disorder)	79	45816000	Pyelonephritis	1095	1	1	0	1	1	1093	0.00000	-0.00091	0.00000	0.00000	0.00000	1.0000000000	1.0000000000	0.00091	-0.00132	0	1	0	1	0	0	0.00000	0.00000
130	314994000	Metastasis from malignant tumor of prostate (disorder)	58	239720000	Tear of meniscus of knee	1095	1	20	0	1	20	1074	0.00000	-0.00412	0.00000	0.00000	0.00000	1.0000000000	1.0000000000	0.01826	-0.02611	0	10	0	1	10	0	0.00000	0.00000
125	1734006	Fracture of the vertebral column with spinal cord injury	64	444448004	Injury of medial collateral ligament of knee	1095	5	32	0	5	32	1058	0.00000	-0.01175	0.00000	0.00000	0.00000	1.0000000000	1.0000000000	0.14612	-0.19676	3	17	0	2	15	0	0.00000	0.00000
118	48333001	Burn injury(morphologic abnormality)	58	239720000	Tear of meniscus of knee	1095	1	20	0	1	20	1074	0.00000	-0.00412	0.00000	0.00000	0.00000	1.0000000000	1.0000000000	0.01826	-0.02611	0	10	0	1	10	0	0.00000	0.00000
128	86849004	Suicidal deliberate poisoning	61	198992004	Antepartum eclampsia	1095	1	96	0	1	96	998	0.00000	-0.00937	0.00000	0.00000	0.00000	1.0000000000	1.0000000000	0.08767	-0.12124	0	96	0	1	0	0	0.00000	0.00000
130	314994000	Metastasis from malignant tumor of prostate (disorder)	110	65275009	Acute Cholecystitis	1095	1	9	0	1	9	1085	0.00000	-0.00275	0.00000	0.00000	0.00000	1.0000000000	1.0000000000	0.00822	-0.01181	0	7	0	1	2	0	0.00000	0.00000
125	1734006	Fracture of the vertebral column with spinal cord injury	58	239720000	Tear of meniscus of knee	1095	5	20	0	5	20	1070	0.00000	-0.00924	0.00000	0.00000	0.00000	1.0000000000	1.0000000000	0.09132	-0.12608	3	10	0	2	10	0	0.00000	0.00000
128	86849004	Suicidal deliberate poisoning	110	65275009	Acute Cholecystitis	1095	1	9	0	1	9	1085	0.00000	-0.00275	0.00000	0.00000	0.00000	1.0000000000	1.0000000000	0.00822	-0.01181	0	7	0	1	2	0	0.00000	0.00000
127	431856006	Chronic kidney disease stage 2 (disorder)	110	65275009	Acute Cholecystitis	1095	5	9	0	5	9	1081	0.00000	-0.00617	0.00000	0.00000	0.00000	1.0000000000	1.0000000000	0.04110	-0.05810	3	7	0	2	2	0	0.00000	0.00000
125	1734006	Fracture of the vertebral column with spinal cord injury	110	65275009	Acute Cholecystitis	1095	5	9	0	5	9	1081	0.00000	-0.00617	0.00000	0.00000	0.00000	1.0000000000	1.0000000000	0.04110	-0.05810	3	7	0	2	2	0	0.00000	0.00000
124	1501000119109	Proliferative diabetic retinopathy due to type II diabetes mellitus (disorder)	110	65275009	Acute Cholecystitis	1095	1	9	0	1	9	1085	0.00000	-0.00275	0.00000	0.00000	0.00000	1.0000000000	1.0000000000	0.00822	-0.01181	1	7	0	0	2	0	0.00000	0.00000
132	69896004	Rheumatoid arthritis	61	198992004	Antepartum eclampsia	1095	3	96	0	3	96	996	0.00000	-0.01625	0.00000	0.00000	0.00000	1.0000000000	1.0000000000	0.26301	-0.33687	2	96	0	1	0	0	0.00000	0.00000
121	254637007	Non-small cell lung cancer (disorder)	110	65275009	Acute Cholecystitis	1095	8	9	0	8	9	1078	0.00000	-0.00781	0.00000	0.00000	0.00000	1.0000000000	1.0000000000	0.06575	-0.09187	0	7	0	8	2	0	0.00000	0.00000
120	162573006	Suspected lung cancer (situation)	110	65275009	Acute Cholecystitis	1095	8	9	0	8	9	1078	0.00000	-0.00781	0.00000	0.00000	0.00000	1.0000000000	1.0000000000	0.06575	-0.09187	0	7	0	8	2	0	0.00000	0.00000
118	48333001	Burn injury(morphologic abnormality)	110	65275009	Acute Cholecystitis	1095	1	9	0	1	9	1085	0.00000	-0.00275	0.00000	0.00000	0.00000	1.0000000000	1.0000000000	0.00822	-0.01181	0	7	0	1	2	0	0.00000	0.00000
117	230265002	Familial Alzheimer's disease of early onset (disorder)	110	65275009	Acute Cholecystitis	1095	6	9	0	6	9	1080	0.00000	-0.00676	0.00000	0.00000	0.00000	1.0000000000	1.0000000000	0.04932	-0.06945	2	7	0	4	2	0	0.00000	0.00000
115	36923009	Major depression  single episode	110	65275009	Acute Cholecystitis	1095	6	9	0	6	9	1080	0.00000	-0.00676	0.00000	0.00000	0.00000	1.0000000000	1.0000000000	0.04932	-0.06945	3	7	0	3	2	0	0.00000	0.00000
114	449868002	Smokes tobacco daily	110	65275009	Acute Cholecystitis	1095	9	9	0	9	9	1077	0.00000	-0.00829	0.00000	0.00000	0.00000	1.0000000000	1.0000000000	0.07397	-0.10296	2	7	0	7	2	0	0.00000	0.00000
112	49436004	Atrial Fibrillation	110	65275009	Acute Cholecystitis	1095	35	9	2	33	7	1053	6.95238	0.09846	9.11688	45.57423	1.82378	0.0310429083	0.3255611102	0.28767	1.22020	9	7	1	26	2	1	0.98083	-0.99325
111	235919008	Cholelithiasis	110	65275009	Acute Cholecystitis	1095	9	9	9	0	0	1086	121.66667	1.00000	0.00000	0.00000	0.00000	0.0000000000	0.0000000000	0.07397	3.21897	7	7	7	2	2	2	0.00000	0.00000
109	90560007	Gout	110	65275009	Acute Cholecystitis	1095	4	9	0	4	9	1082	0.00000	-0.00551	0.00000	0.00000	0.00000	1.0000000000	1.0000000000	0.03288	-0.04667	0	7	0	4	2	0	0.00000	0.00000
108	40930008	Hypothyroidism (disorder)	110	65275009	Acute Cholecystitis	1095	13	9	1	12	8	1074	9.35897	0.08341	11.18750	96.55421	1.29627	0.1022698176	0.6291042150	0.10685	0.85354	11	7	0	2	2	1	-1.09861	-1.09861
107	40275004	Contact dermatitis	110	65275009	Acute Cholecystitis	1095	18	9	0	18	9	1068	0.00000	-0.01177	0.00000	0.00000	0.00000	1.0000000000	1.0000000000	0.14795	-0.19905	9	7	0	9	2	0	0.00000	0.00000
106	24079001	Atopic dermatitis	110	65275009	Acute Cholecystitis	1095	20	9	0	20	9	1066	0.00000	-0.01242	0.00000	0.00000	0.00000	1.0000000000	1.0000000000	0.16438	-0.21957	13	7	0	7	2	0	0.00000	0.00000
105	363406005	Malignant tumor of colon	110	65275009	Acute Cholecystitis	1095	6	9	0	6	9	1080	0.00000	-0.00676	0.00000	0.00000	0.00000	1.0000000000	1.0000000000	0.04932	-0.06945	4	7	0	2	2	0	0.00000	0.00000
104	367498001	Seasonal allergic rhinitis	110	65275009	Acute Cholecystitis	1095	20	9	0	20	9	1066	0.00000	-0.01242	0.00000	0.00000	0.00000	1.0000000000	1.0000000000	0.16438	-0.21957	9	7	0	11	2	0	0.00000	0.00000
102	90781000119102	Microalbuminuria due to type 2 diabetes mellitus (disorder)	110	65275009	Acute Cholecystitis	1095	6	9	0	6	9	1080	0.00000	-0.00676	0.00000	0.00000	0.00000	1.0000000000	1.0000000000	0.04932	-0.06945	3	7	0	3	2	0	0.00000	0.00000
101	433144002	Chronic kidney disease stage 3 (disorder)	110	65275009	Acute Cholecystitis	1095	3	9	0	3	9	1083	0.00000	-0.00477	0.00000	0.00000	0.00000	1.0000000000	1.0000000000	0.02466	-0.03514	1	7	0	2	2	0	0.00000	0.00000
100	161622006	History of lower limb amputation (situation)	110	65275009	Acute Cholecystitis	1095	1	9	0	1	9	1085	0.00000	-0.00275	0.00000	0.00000	0.00000	1.0000000000	1.0000000000	0.00822	-0.01181	0	7	0	1	2	0	0.00000	0.00000
99	30832001	Rupture of patellar tendon	110	65275009	Acute Cholecystitis	1095	23	9	0	23	9	1063	0.00000	-0.01333	0.00000	0.00000	0.00000	1.0000000000	1.0000000000	0.18904	-0.24980	14	7	0	9	2	0	0.00000	0.00000
98	1551000119108	Nonproliferative diabetic retinopathy due to type 2 diabetes mellitus (disorder)	110	65275009	Acute Cholecystitis	1095	12	9	0	12	9	1074	0.00000	-0.00958	0.00000	0.00000	0.00000	1.0000000000	1.0000000000	0.09863	-0.13571	7	7	0	5	2	0	0.00000	0.00000
97	403192003	Third degree burn	110	65275009	Acute Cholecystitis	1095	8	9	0	8	9	1078	0.00000	-0.00781	0.00000	0.00000	0.00000	1.0000000000	1.0000000000	0.06575	-0.09187	3	7	0	5	2	0	0.00000	0.00000
96	283371005	Laceration of forearm	110	65275009	Acute Cholecystitis	1095	75	9	1	74	8	1012	1.62222	0.01536	1.70946	13.85147	0.21097	0.4732325387	1.0000000000	0.61644	0.30718	39	7	1	36	2	0	2.07944	3.68888
95	84757009	Epilepsy	110	65275009	Acute Cholecystitis	1095	30	9	0	30	9	1056	0.00000	-0.01528	0.00000	0.00000	0.00000	1.0000000000	1.0000000000	0.24658	-0.31797	13	7	0	17	2	0	0.00000	0.00000
94	703151001	History of single seizure (situation)	110	65275009	Acute Cholecystitis	1095	39	9	0	39	9	1047	0.00000	-0.01749	0.00000	0.00000	0.00000	1.0000000000	1.0000000000	0.32055	-0.40114	14	7	0	25	2	0	0.00000	0.00000
93	128613002	Seizure disorder	110	65275009	Acute Cholecystitis	1095	39	9	0	39	9	1047	0.00000	-0.01749	0.00000	0.00000	0.00000	1.0000000000	1.0000000000	0.32055	-0.40114	14	7	0	25	2	0	0.00000	0.00000
89	47693006	Rupture of appendix	110	65275009	Acute Cholecystitis	1095	20	9	0	20	9	1066	0.00000	-0.01242	0.00000	0.00000	0.00000	1.0000000000	1.0000000000	0.16438	-0.21957	10	7	0	10	2	0	0.00000	0.00000
86	713197008	Recurrent rectal polyp	110	65275009	Acute Cholecystitis	1095	22	9	0	22	9	1064	0.00000	-0.01304	0.00000	0.00000	0.00000	1.0000000000	1.0000000000	0.18082	-0.23979	12	7	0	10	2	0	0.00000	0.00000
85	241929008	Acute allergic reaction	110	65275009	Acute Cholecystitis	1095	47	9	1	46	8	1040	2.58865	0.03063	2.82609	23.07202	0.34617	0.3272081453	1.0000000000	0.38630	0.52876	25	7	1	22	2	0	2.07944	3.25810
82	94260004	Secondary malignant neoplasm of colon	110	65275009	Acute Cholecystitis	1095	4	9	0	4	9	1082	0.00000	-0.00551	0.00000	0.00000	0.00000	1.0000000000	1.0000000000	0.03288	-0.04667	2	7	0	2	2	0	0.00000	0.00000
81	236077008	Protracted diarrhea	110	65275009	Acute Cholecystitis	1095	4	9	0	4	9	1082	0.00000	-0.00551	0.00000	0.00000	0.00000	1.0000000000	1.0000000000	0.03288	-0.04667	2	7	0	2	2	0	0.00000	0.00000
80	6072007	Bleeding from anus	110	65275009	Acute Cholecystitis	1095	4	9	0	4	9	1082	0.00000	-0.00551	0.00000	0.00000	0.00000	1.0000000000	1.0000000000	0.03288	-0.04667	2	7	0	2	2	0	0.00000	0.00000
78	239872002	Osteoarthritis of hip	110	65275009	Acute Cholecystitis	1095	21	9	0	21	9	1065	0.00000	-0.01273	0.00000	0.00000	0.00000	1.0000000000	1.0000000000	0.17260	-0.22971	13	7	0	8	2	0	0.00000	0.00000
76	127013003	Diabetic renal disease (disorder)	110	65275009	Acute Cholecystitis	1095	28	9	0	28	9	1058	0.00000	-0.01475	0.00000	0.00000	0.00000	1.0000000000	1.0000000000	0.23014	-0.29882	10	7	0	18	2	0	0.00000	0.00000
75	431855005	Chronic kidney disease stage 1 (disorder)	110	65275009	Acute Cholecystitis	1095	28	9	0	28	9	1058	0.00000	-0.01475	0.00000	0.00000	0.00000	1.0000000000	1.0000000000	0.23014	-0.29882	10	7	0	18	2	0	0.00000	0.00000
73	196416002	Impacted molars	110	65275009	Acute Cholecystitis	1095	49	9	0	49	9	1037	0.00000	-0.01970	0.00000	0.00000	0.00000	1.0000000000	1.0000000000	0.40274	-0.48825	25	7	0	24	2	0	0.00000	0.00000
72	35999006	Blighted ovum	110	65275009	Acute Cholecystitis	1095	53	9	2	51	7	1035	4.59119	0.07373	5.79832	28.61657	1.17486	0.0665389404	0.5048217971	0.43562	1.06329	53	7	2	0	2	0	1.50408	3.31419
71	201834006	Localized  primary osteoarthritis of the hand	110	65275009	Acute Cholecystitis	1095	28	9	1	27	8	1059	4.34524	0.04933	4.90278	40.58755	0.59223	0.2086364532	0.8610424124	0.23014	0.70118	19	7	1	9	2	0	2.07944	2.99573
70	87433001	Pulmonary emphysema (disorder)	110	65275009	Acute Cholecystitis	1095	17	9	0	17	9	1069	0.00000	-0.01143	0.00000	0.00000	0.00000	1.0000000000	1.0000000000	0.13973	-0.18869	9	7	0	8	2	0	0.00000	0.00000
69	233604007	Pneumonia	110	65275009	Acute Cholecystitis	1095	7	9	0	7	9	1079	0.00000	-0.00730	0.00000	0.00000	0.00000	1.0000000000	1.0000000000	0.05753	-0.08070	3	7	0	4	2	0	0.00000	0.00000
68	26929004	Alzheimer's disease (disorder)	110	65275009	Acute Cholecystitis	1095	23	9	0	23	9	1063	0.00000	-0.01333	0.00000	0.00000	0.00000	1.0000000000	1.0000000000	0.18904	-0.24980	15	7	0	8	2	0	0.00000	0.00000
67	403191005	Second degree burn	110	65275009	Acute Cholecystitis	1095	49	9	2	47	7	1039	4.96599	0.07814	6.31611	31.23450	1.27722	0.0577709668	0.4685406893	0.40274	1.09672	23	7	1	26	2	1	0.98083	-0.11778
65	239873007	Osteoarthritis of knee	110	65275009	Acute Cholecystitis	1095	57	9	0	57	9	1029	0.00000	-0.02133	0.00000	0.00000	0.00000	1.0000000000	1.0000000000	0.46849	-0.55434	30	7	0	27	2	0	0.00000	0.00000
64	444448004	Injury of medial collateral ligament of knee	110	65275009	Acute Cholecystitis	1095	32	9	0	32	9	1054	0.00000	-0.01579	0.00000	0.00000	0.00000	1.0000000000	1.0000000000	0.26301	-0.33687	17	7	0	15	2	0	0.00000	0.00000
63	68496003	Polyp of colon	110	65275009	Acute Cholecystitis	1095	91	9	1	90	8	996	1.33700	0.00924	1.38333	11.18438	0.17110	0.5433587273	1.0000000000	0.74795	0.19434	43	7	0	48	2	1	-1.09861	-3.89182
62	185086009	Chronic obstructive bronchitis (disorder)	110	65275009	Acute Cholecystitis	1095	6	9	0	6	9	1080	0.00000	-0.00676	0.00000	0.00000	0.00000	1.0000000000	1.0000000000	0.04932	-0.06945	4	7	0	2	2	0	0.00000	0.00000
59	262574004	Bullet wound	110	65275009	Acute Cholecystitis	1095	20	9	0	20	9	1066	0.00000	-0.01242	0.00000	0.00000	0.00000	1.0000000000	1.0000000000	0.16438	-0.21957	9	7	0	11	2	0	0.00000	0.00000
58	239720000	Tear of meniscus of knee	110	65275009	Acute Cholecystitis	1095	20	9	1	19	8	1067	6.08333	0.06312	7.01974	58.93898	0.83606	0.1533925818	0.7711941449	0.16438	0.78043	10	7	1	10	2	0	2.07944	2.39790
57	192127007	Child attention deficit disorder	110	65275009	Acute Cholecystitis	1095	76	9	0	76	9	1010	0.00000	-0.02486	0.00000	0.00000	0.00000	1.0000000000	1.0000000000	0.62466	-0.70014	24	7	0	52	2	0	0.00000	0.00000
56	92691004	Carcinoma in situ of prostate (disorder)	110	65275009	Acute Cholecystitis	1095	23	9	1	22	8	1064	5.28986	0.05720	6.04545	50.43056	0.72471	0.1744981661	0.8000743861	0.18904	0.75020	0	7	0	23	2	1	-1.09861	-3.17805
54	5602001	Opioid abuse (disorder)	110	65275009	Acute Cholecystitis	1095	7	9	0	7	9	1079	0.00000	-0.00730	0.00000	0.00000	0.00000	1.0000000000	1.0000000000	0.05753	-0.08070	0	7	0	7	2	0	0.00000	0.00000
52	124171000119105	Chronic intractable migraine without aura	110	65275009	Acute Cholecystitis	1095	51	9	0	51	9	1035	0.00000	-0.02012	0.00000	0.00000	0.00000	1.0000000000	1.0000000000	0.41918	-0.50506	21	7	0	30	2	0	0.00000	0.00000
50	446096008	Perennial allergic rhinitis	110	65275009	Acute Cholecystitis	1095	26	9	0	26	9	1060	0.00000	-0.01420	0.00000	0.00000	0.00000	1.0000000000	1.0000000000	0.21370	-0.27941	14	7	0	12	2	0	0.00000	0.00000
49	88805009	Chronic congestive heart failure (disorder)	110	65275009	Acute Cholecystitis	1095	10	9	0	10	9	1076	0.00000	-0.00874	0.00000	0.00000	0.00000	1.0000000000	1.0000000000	0.08219	-0.11396	5	7	0	5	2	0	0.00000	0.00000
47	359817006	Closed fracture of hip	110	65275009	Acute Cholecystitis	1095	29	9	0	29	9	1057	0.00000	-0.01502	0.00000	0.00000	0.00000	1.0000000000	1.0000000000	0.23836	-0.30843	11	7	0	18	2	0	0.00000	0.00000
46	62564004	Concussion with loss of consciousness	110	65275009	Acute Cholecystitis	1095	67	9	1	66	8	1020	1.81592	0.01896	1.93182	15.67664	0.23806	0.4347046993	1.0000000000	0.55068	0.36709	36	7	1	31	2	0	2.07944	3.61092
45	263102004	Fracture subluxation of wrist	110	65275009	Acute Cholecystitis	1095	109	9	1	108	8	978	1.11621	0.00352	1.13194	9.13646	0.14024	1.0000000000	1.0000000000	0.89589	0.07712	51	7	0	58	2	1	-1.09861	-4.07754
44	58150001	Fracture of clavicle	110	65275009	Acute Cholecystitis	1095	112	9	1	111	8	975	1.08631	0.00265	1.09797	8.86025	0.13606	1.0000000000	1.0000000000	0.92055	0.05848	55	7	0	57	2	1	-1.09861	-4.06044
43	307731004	Injury of tendon of the rotator cuff of shoulder	110	65275009	Acute Cholecystitis	1095	51	9	0	51	9	1035	0.00000	-0.02012	0.00000	0.00000	0.00000	1.0000000000	1.0000000000	0.41918	-0.50506	26	7	0	25	2	0	0.00000	0.00000
42	16114001	Fracture of ankle	110	65275009	Acute Cholecystitis	1095	108	9	1	107	8	979	1.12654	0.00381	1.14369	9.23200	0.14168	0.6086580832	1.0000000000	0.88767	0.08339	48	7	1	60	2	0	2.07944	3.89182
41	283385000	Laceration of thigh	110	65275009	Acute Cholecystitis	1095	105	9	1	104	8	982	1.15873	0.00471	1.18029	9.52975	0.14618	0.5977768862	1.0000000000	0.86301	0.10236	50	7	1	55	2	0	2.07944	3.93183
39	74400008	Appendicitis	110	65275009	Acute Cholecystitis	1095	51	9	0	51	9	1035	0.00000	-0.02012	0.00000	0.00000	0.00000	1.0000000000	1.0000000000	0.41918	-0.50506	27	7	0	24	2	0	0.00000	0.00000
38	398254007	Preeclampsia	110	65275009	Acute Cholecystitis	1095	101	9	1	100	8	986	1.20462	0.00594	1.23250	9.95480	0.15260	0.5828505756	1.0000000000	0.83014	0.12805	101	7	1	0	2	0	2.07944	4.62497
35	19169002	Miscarriage in first trimester	110	65275009	Acute Cholecystitis	1095	174	9	2	172	7	914	1.39847	0.01577	1.51827	7.37033	0.31276	0.6408981043	1.0000000000	1.43014	0.30392	174	7	2	0	2	0	1.50408	4.47734
33	429007001	History of cardiac arrest (situation)	110	65275009	Acute Cholecystitis	1095	42	9	0	42	9	1044	0.00000	-0.01818	0.00000	0.00000	0.00000	1.0000000000	1.0000000000	0.34521	-0.42783	24	7	0	18	2	0	0.00000	0.00000
32	410429000	Cardiac Arrest	110	65275009	Acute Cholecystitis	1095	42	9	0	42	9	1044	0.00000	-0.01818	0.00000	0.00000	0.00000	1.0000000000	1.0000000000	0.34521	-0.42783	24	7	0	18	2	0	0.00000	0.00000
30	399211009	History of myocardial infarction (situation)	110	65275009	Acute Cholecystitis	1095	31	9	0	31	9	1055	0.00000	-0.01554	0.00000	0.00000	0.00000	1.0000000000	1.0000000000	0.25479	-0.32745	2	7	0	29	2	0	0.00000	0.00000
29	22298006	Myocardial Infarction	110	65275009	Acute Cholecystitis	1095	31	9	0	31	9	1055	0.00000	-0.01554	0.00000	0.00000	0.00000	1.0000000000	1.0000000000	0.25479	-0.32745	2	7	0	29	2	0	0.00000	0.00000
28	53741008	Coronary Heart Disease	110	65275009	Acute Cholecystitis	1095	80	9	0	80	9	1006	0.00000	-0.02556	0.00000	0.00000	0.00000	1.0000000000	1.0000000000	0.65753	-0.72904	24	7	0	56	2	0	0.00000	0.00000
27	408512008	Body mass index 40+ - severely obese (finding)	110	65275009	Acute Cholecystitis	1095	97	9	0	97	9	989	0.00000	-0.02838	0.00000	0.00000	0.00000	1.0000000000	1.0000000000	0.79726	-0.84580	67	7	0	30	2	0	0.00000	0.00000
26	33737001	Fracture of rib	110	65275009	Acute Cholecystitis	1095	54	9	0	54	9	1032	0.00000	-0.02073	0.00000	0.00000	0.00000	1.0000000000	1.0000000000	0.44384	-0.52991	32	7	0	22	2	0	0.00000	0.00000
24	162864005	Body mass index 30+ - obesity (finding)	110	65275009	Acute Cholecystitis	1095	439	9	4	435	5	651	1.10858	0.00809	1.19724	4.48346	0.31971	1.0000000000	1.0000000000	3.60822	0.11772	226	7	4	213	2	0	1.01160	4.05178
23	36971009	Sinusitis (disorder)	110	65275009	Acute Cholecystitis	1095	190	9	2	188	7	898	1.28070	0.01171	1.36474	6.62120	0.28130	0.6593574246	1.0000000000	1.56164	0.22789	84	7	1	106	2	1	0.98083	-0.23018
21	15777000	Prediabetes	110	65275009	Acute Cholecystitis	1095	333	9	5	328	4	758	1.82683	0.04976	2.88872	10.82615	0.77079	0.1407364023	0.7371027084	2.73699	0.68309	159	7	3	174	2	2	0.51083	-0.48835
20	80394007	Hyperglycemia (disorder)	110	65275009	Acute Cholecystitis	1095	55	9	0	55	9	1031	0.00000	-0.02093	0.00000	0.00000	0.00000	1.0000000000	1.0000000000	0.45205	-0.53810	23	7	0	32	2	0	0.00000	0.00000
19	237602007	Metabolic syndrome X (disorder)	110	65275009	Acute Cholecystitis	1095	64	9	0	64	9	1022	0.00000	-0.02268	0.00000	0.00000	0.00000	1.0000000000	1.0000000000	0.52603	-0.60978	28	7	0	36	2	0	0.00000	0.00000
18	302870006	Hypertriglyceridemia (disorder)	110	65275009	Acute Cholecystitis	1095	64	9	0	64	9	1022	0.00000	-0.02268	0.00000	0.00000	0.00000	1.0000000000	1.0000000000	0.52603	-0.60978	28	7	0	36	2	0	0.00000	0.00000
17	368581000119106	Neuropathy due to type 2 diabetes mellitus (disorder)	110	65275009	Acute Cholecystitis	1095	28	9	0	28	9	1058	0.00000	-0.01475	0.00000	0.00000	0.00000	1.0000000000	1.0000000000	0.23014	-0.29882	7	7	0	21	2	0	0.00000	0.00000
129	47505003	Posttraumatic stress disorder	84	232353008	Perennial allergic rhinitis with seasonal variation	1095	4	29	0	4	29	1062	0.00000	-0.00999	0.00000	0.00000	0.00000	1.0000000000	1.0000000000	0.10594	-0.14527	1	14	0	3	15	0	0.00000	0.00000
15	40055000	Chronic sinusitis (disorder)	110	65275009	Acute Cholecystitis	1095	216	9	2	214	7	872	1.12654	0.00571	1.16422	5.64413	0.24014	0.6935767206	1.0000000000	1.77534	0.11230	104	7	2	112	2	0	1.50408	3.97029
14	10509002	Acute bronchitis (disorder)	110	65275009	Acute Cholecystitis	1095	863	9	7	856	2	230	0.98687	-0.00231	0.94042	4.55747	0.19405	1.0000000000	1.0000000000	7.09315	-0.01670	418	7	6	445	2	1	-0.32542	-1.84234
13	370247008	Facial laceration	110	65275009	Acute Cholecystitis	1095	109	9	2	107	7	979	2.23242	0.03730	2.61415	12.74361	0.53625	0.2232636120	0.8794911525	0.89589	0.66209	55	7	2	54	2	0	1.50408	3.34990
125	1734006	Fracture of the vertebral column with spinal cord injury	84	232353008	Perennial allergic rhinitis with seasonal variation	1095	5	29	0	5	29	1061	0.00000	-0.01117	0.00000	0.00000	0.00000	1.0000000000	1.0000000000	0.13242	-0.17941	3	14	0	2	15	0	0.00000	0.00000
124	1501000119109	Proliferative diabetic retinopathy due to type II diabetes mellitus (disorder)	84	232353008	Perennial allergic rhinitis with seasonal variation	1095	1	29	0	1	29	1065	0.00000	-0.00499	0.00000	0.00000	0.00000	1.0000000000	1.0000000000	0.02648	-0.03771	1	14	0	0	15	0	0.00000	0.00000
10	62106007	Concussion with no loss of consciousness	110	65275009	Acute Cholecystitis	1095	206	9	0	206	9	880	0.00000	-0.04382	0.00000	0.00000	0.00000	0.2220372390	0.8794911525	1.69315	-1.42929	96	7	0	110	2	0	0.00000	0.00000
9	44465007	Sprain of ankle	110	65275009	Acute Cholecystitis	1095	362	9	2	360	7	726	0.67219	-0.02097	0.57619	2.78772	0.11909	0.7257794797	1.0000000000	2.97534	-0.40612	185	7	1	177	2	1	0.98083	0.04396
8	233678006	Childhood asthma	110	65275009	Acute Cholecystitis	1095	45	9	1	44	8	1042	2.70370	0.03211	2.96023	24.18894	0.36227	0.3155189275	1.0000000000	0.36986	0.54597	25	7	1	20	2	0	2.07944	3.25810
7	75498004	Acute bacterial sinusitis (disorder)	110	65275009	Acute Cholecystitis	1095	187	9	1	186	8	900	0.65062	-0.01443	0.60484	4.86492	0.07520	1.0000000000	1.0000000000	1.53699	-0.34312	89	7	1	98	2	0	2.07944	4.49981
6	39848009	Whiplash injury to neck	110	65275009	Acute Cholecystitis	1095	182	9	1	181	8	905	0.66850	-0.01347	0.62500	5.02774	0.07769	1.0000000000	1.0000000000	1.49589	-0.31955	92	7	0	90	2	1	-1.09861	-4.51086
5	284549007	Laceration of hand	110	65275009	Acute Cholecystitis	1095	104	9	1	103	8	983	1.16987	0.00501	1.19296	9.63289	0.14774	0.5940905237	1.0000000000	0.85479	0.10874	54	7	1	50	2	0	2.07944	4.00733
117	230265002	Familial Alzheimer's disease of early onset (disorder)	84	232353008	Perennial allergic rhinitis with seasonal variation	1095	6	29	1	5	28	1061	6.29310	0.06480	7.57857	67.01435	0.85705	0.1490655320	0.7572321990	0.15890	0.78724	2	14	0	4	15	1	-2.77259	-1.60944
116	370143000	Major depression disorder	84	232353008	Perennial allergic rhinitis with seasonal variation	1095	8	29	0	8	29	1058	0.00000	-0.01415	0.00000	0.00000	0.00000	1.0000000000	1.0000000000	0.21187	-0.27724	3	14	0	5	15	0	0.00000	0.00000
115	36923009	Major depression  single episode	84	232353008	Perennial allergic rhinitis with seasonal variation	1095	6	29	0	6	29	1060	0.00000	-0.01224	0.00000	0.00000	0.00000	1.0000000000	1.0000000000	0.15890	-0.21276	3	14	0	3	15	0	0.00000	0.00000
1	444814009	Viral sinusitis (disorder)	110	65275009	Acute Cholecystitis	1095	993	9	9	984	0	102	1.10272	0.02918	0.00000	0.00000	0.00000	1.0000000000	1.0000000000	8.16164	0.12632	478	7	7	515	2	2	0.00000	-1.31666
113	443165006	Pathological fracture due to osteoporosis (disorder)	84	232353008	Perennial allergic rhinitis with seasonal variation	1095	10	29	0	10	29	1056	0.00000	-0.01583	0.00000	0.00000	0.00000	1.0000000000	1.0000000000	0.26484	-0.33896	7	14	0	3	15	0	0.00000	0.00000
112	49436004	Atrial Fibrillation	84	232353008	Perennial allergic rhinitis with seasonal variation	1095	35	29	0	35	29	1031	0.00000	-0.02997	0.00000	0.00000	0.00000	1.0000000000	1.0000000000	0.92694	-0.94631	9	14	0	26	15	0	0.00000	0.00000
111	235919008	Cholelithiasis	84	232353008	Perennial allergic rhinitis with seasonal variation	1095	9	29	1	8	28	1058	4.19540	0.04798	4.72321	39.05408	0.57123	0.2153114971	0.8672161313	0.23836	0.69157	7	14	1	2	15	0	2.70805	2.07944
110	65275009	Acute Cholecystitis	84	232353008	Perennial allergic rhinitis with seasonal variation	1095	9	29	1	8	28	1058	4.19540	0.04798	4.72321	39.05408	0.57123	0.2153114971	0.8672161313	0.23836	0.69157	7	14	1	2	15	0	2.70805	2.07944
109	90560007	Gout	84	232353008	Perennial allergic rhinitis with seasonal variation	1095	4	29	0	4	29	1062	0.00000	-0.00999	0.00000	0.00000	0.00000	1.0000000000	1.0000000000	0.10594	-0.14527	0	14	0	4	15	0	0.00000	0.00000
108	40930008	Hypothyroidism (disorder)	84	232353008	Perennial allergic rhinitis with seasonal variation	1095	13	29	0	13	29	1053	0.00000	-0.01808	0.00000	0.00000	0.00000	1.0000000000	1.0000000000	0.34429	-0.42685	11	14	0	2	15	0	0.00000	0.00000
107	40275004	Contact dermatitis	84	232353008	Perennial allergic rhinitis with seasonal variation	1095	18	29	0	18	29	1048	0.00000	-0.02132	0.00000	0.00000	0.00000	1.0000000000	1.0000000000	0.47671	-0.56239	9	14	0	9	15	0	0.00000	0.00000
106	24079001	Atopic dermatitis	84	232353008	Perennial allergic rhinitis with seasonal variation	1095	20	29	5	15	24	1051	9.43966	0.18987	14.59722	43.41629	4.90781	0.0001072347	0.0036484723	0.52968	1.97173	13	14	3	7	15	2	-0.40547	0.16990
105	363406005	Malignant tumor of colon	84	232353008	Perennial allergic rhinitis with seasonal variation	1095	6	29	0	6	29	1060	0.00000	-0.01224	0.00000	0.00000	0.00000	1.0000000000	1.0000000000	0.15890	-0.21276	4	14	0	2	15	0	0.00000	0.00000
104	367498001	Seasonal allergic rhinitis	84	232353008	Perennial allergic rhinitis with seasonal variation	1095	20	29	0	20	29	1046	0.00000	-0.02250	0.00000	0.00000	0.00000	1.0000000000	1.0000000000	0.52968	-0.61323	9	14	0	11	15	0	0.00000	0.00000
103	157141000119108	Proteinuria due to type 2 diabetes mellitus (disorder)	84	232353008	Perennial allergic rhinitis with seasonal variation	1095	3	29	0	3	29	1063	0.00000	-0.00865	0.00000	0.00000	0.00000	1.0000000000	1.0000000000	0.07945	-0.11030	1	14	0	2	15	0	0.00000	0.00000
102	90781000119102	Microalbuminuria due to type 2 diabetes mellitus (disorder)	84	232353008	Perennial allergic rhinitis with seasonal variation	1095	6	29	0	6	29	1060	0.00000	-0.01224	0.00000	0.00000	0.00000	1.0000000000	1.0000000000	0.15890	-0.21276	3	14	0	3	15	0	0.00000	0.00000
101	433144002	Chronic kidney disease stage 3 (disorder)	84	232353008	Perennial allergic rhinitis with seasonal variation	1095	3	29	0	3	29	1063	0.00000	-0.00865	0.00000	0.00000	0.00000	1.0000000000	1.0000000000	0.07945	-0.11030	1	14	0	2	15	0	0.00000	0.00000
100	161622006	History of lower limb amputation (situation)	84	232353008	Perennial allergic rhinitis with seasonal variation	1095	1	29	0	1	29	1065	0.00000	-0.00499	0.00000	0.00000	0.00000	1.0000000000	1.0000000000	0.02648	-0.03771	0	14	0	1	15	0	0.00000	0.00000
99	30832001	Rupture of patellar tendon	84	232353008	Perennial allergic rhinitis with seasonal variation	1095	23	29	1	22	28	1044	1.64168	0.01550	1.69481	13.01925	0.22062	0.4640519964	1.0000000000	0.60913	0.31372	14	14	1	9	15	0	2.70805	2.70805
98	1551000119108	Nonproliferative diabetic retinopathy due to type 2 diabetes mellitus (disorder)	84	232353008	Perennial allergic rhinitis with seasonal variation	1095	12	29	1	11	28	1055	3.14655	0.03727	3.42532	27.45172	0.42740	0.2765645124	0.9516594629	0.31781	0.60186	7	14	1	5	15	0	2.70805	2.07944
97	403192003	Third degree burn	84	232353008	Perennial allergic rhinitis with seasonal variation	1095	8	29	0	8	29	1058	0.00000	-0.01415	0.00000	0.00000	0.00000	1.0000000000	1.0000000000	0.21187	-0.27724	3	14	0	5	15	0	0.00000	0.00000
96	283371005	Laceration of forearm	84	232353008	Perennial allergic rhinitis with seasonal variation	1095	75	29	2	73	27	993	1.00690	0.00031	1.00761	4.32077	0.23498	1.0000000000	1.0000000000	1.98630	0.00660	39	14	1	36	15	1	-0.06454	0.07796
95	84757009	Epilepsy	84	232353008	Perennial allergic rhinitis with seasonal variation	1095	30	29	0	30	29	1036	0.00000	-0.02768	0.00000	0.00000	0.00000	1.0000000000	1.0000000000	0.79452	-0.84360	13	14	0	17	15	0	0.00000	0.00000
94	703151001	History of single seizure (situation)	84	232353008	Perennial allergic rhinitis with seasonal variation	1095	39	29	0	39	29	1027	0.00000	-0.03170	0.00000	0.00000	0.00000	0.6209823396	1.0000000000	1.03288	-1.02352	14	14	0	25	15	0	0.00000	0.00000
93	128613002	Seizure disorder	84	232353008	Perennial allergic rhinitis with seasonal variation	1095	39	29	0	39	29	1027	0.00000	-0.03170	0.00000	0.00000	0.00000	0.6209823396	1.0000000000	1.03288	-1.02352	14	14	0	25	15	0	0.00000	0.00000
92	82423001	Chronic pain	84	232353008	Perennial allergic rhinitis with seasonal variation	1095	52	29	2	50	27	1016	1.45225	0.01666	1.50519	6.50797	0.34812	0.6443711795	1.0000000000	1.37717	0.33572	24	14	1	28	15	1	-0.06454	-0.14842
91	64859006	Osteoporosis (disorder)	84	232353008	Perennial allergic rhinitis with seasonal variation	1095	37	29	0	37	29	1029	0.00000	-0.03084	0.00000	0.00000	0.00000	0.6205936292	1.0000000000	0.97991	-0.98543	24	14	0	13	15	0	0.00000	0.00000
89	47693006	Rupture of appendix	84	232353008	Perennial allergic rhinitis with seasonal variation	1095	20	29	0	20	29	1046	0.00000	-0.02250	0.00000	0.00000	0.00000	1.0000000000	1.0000000000	0.52968	-0.61323	10	14	0	10	15	0	0.00000	0.00000
88	197927001	Recurrent urinary tract infection	84	232353008	Perennial allergic rhinitis with seasonal variation	1095	8	29	0	8	29	1058	0.00000	-0.01415	0.00000	0.00000	0.00000	1.0000000000	1.0000000000	0.21187	-0.27724	8	14	0	0	15	0	0.00000	0.00000
86	713197008	Recurrent rectal polyp	84	232353008	Perennial allergic rhinitis with seasonal variation	1095	22	29	0	22	29	1044	0.00000	-0.02362	0.00000	0.00000	0.00000	1.0000000000	1.0000000000	0.58265	-0.66234	12	14	0	10	15	0	0.00000	0.00000
85	241929008	Acute allergic reaction	84	232353008	Perennial allergic rhinitis with seasonal variation	1095	47	29	11	36	18	1030	8.83712	0.27374	17.48457	39.71508	7.69758	0.0000000053	0.0000003741	1.24475	2.41841	25	14	6	22	15	5	-0.18232	-0.04417
83	110030002	Concussion injury of brain	84	232353008	Perennial allergic rhinitis with seasonal variation	1095	7	29	1	6	28	1060	5.39409	0.05813	6.30952	54.16677	0.73495	0.1717258622	0.7972585288	0.18539	0.75464	1	14	0	6	15	1	-2.77259	-1.94591
82	94260004	Secondary malignant neoplasm of colon	84	232353008	Perennial allergic rhinitis with seasonal variation	1095	4	29	0	4	29	1062	0.00000	-0.00999	0.00000	0.00000	0.00000	1.0000000000	1.0000000000	0.10594	-0.14527	2	14	0	2	15	0	0.00000	0.00000
81	236077008	Protracted diarrhea	84	232353008	Perennial allergic rhinitis with seasonal variation	1095	4	29	0	4	29	1062	0.00000	-0.00999	0.00000	0.00000	0.00000	1.0000000000	1.0000000000	0.10594	-0.14527	2	14	0	2	15	0	0.00000	0.00000
80	6072007	Bleeding from anus	84	232353008	Perennial allergic rhinitis with seasonal variation	1095	4	29	0	4	29	1062	0.00000	-0.00999	0.00000	0.00000	0.00000	1.0000000000	1.0000000000	0.10594	-0.14527	2	14	0	2	15	0	0.00000	0.00000
79	45816000	Pyelonephritis	84	232353008	Perennial allergic rhinitis with seasonal variation	1095	1	29	0	1	29	1065	0.00000	-0.00499	0.00000	0.00000	0.00000	1.0000000000	1.0000000000	0.02648	-0.03771	1	14	0	0	15	0	0.00000	0.00000
78	239872002	Osteoarthritis of hip	84	232353008	Perennial allergic rhinitis with seasonal variation	1095	21	29	0	21	29	1045	0.00000	-0.02306	0.00000	0.00000	0.00000	1.0000000000	1.0000000000	0.55616	-0.63799	13	14	0	8	15	0	0.00000	0.00000
77	422034002	Diabetic retinopathy associated with type II diabetes mellitus (disorder)	84	232353008	Perennial allergic rhinitis with seasonal variation	1095	20	29	1	19	28	1047	1.88793	0.01998	1.96805	15.22059	0.25447	0.4181826721	1.0000000000	0.52968	0.38677	8	14	1	12	15	0	2.70805	2.19722
76	127013003	Diabetic renal disease (disorder)	84	232353008	Perennial allergic rhinitis with seasonal variation	1095	28	29	0	28	29	1038	0.00000	-0.02672	0.00000	0.00000	0.00000	1.0000000000	1.0000000000	0.74155	-0.80037	10	14	0	18	15	0	0.00000	0.00000
75	431855005	Chronic kidney disease stage 1 (disorder)	84	232353008	Perennial allergic rhinitis with seasonal variation	1095	28	29	0	28	29	1038	0.00000	-0.02672	0.00000	0.00000	0.00000	1.0000000000	1.0000000000	0.74155	-0.80037	10	14	0	18	15	0	0.00000	0.00000
73	196416002	Impacted molars	84	232353008	Perennial allergic rhinitis with seasonal variation	1095	49	29	2	47	27	1019	1.54117	0.01932	1.60599	6.95542	0.37082	0.3759872794	1.0000000000	1.29772	0.38476	25	14	1	24	15	1	-0.06454	0.03922
72	35999006	Blighted ovum	84	232353008	Perennial allergic rhinitis with seasonal variation	1095	53	29	2	51	27	1015	1.42485	0.01580	1.47422	6.37081	0.34114	0.6472628439	1.0000000000	1.40365	0.31973	53	14	2	0	15	0	2.07944	3.31419
71	201834006	Localized  primary osteoarthritis of the hand	84	232353008	Perennial allergic rhinitis with seasonal variation	1095	28	29	0	28	29	1038	0.00000	-0.02672	0.00000	0.00000	0.00000	1.0000000000	1.0000000000	0.74155	-0.80037	19	14	0	9	15	0	0.00000	0.00000
70	87433001	Pulmonary emphysema (disorder)	84	232353008	Perennial allergic rhinitis with seasonal variation	1095	17	29	0	17	29	1049	0.00000	-0.02071	0.00000	0.00000	0.00000	1.0000000000	1.0000000000	0.45023	-0.53628	9	14	0	8	15	0	0.00000	0.00000
69	233604007	Pneumonia	84	232353008	Perennial allergic rhinitis with seasonal variation	1095	7	29	1	6	28	1060	5.39409	0.05813	6.30952	54.16677	0.73495	0.1717258622	0.7972585288	0.18539	0.75464	3	14	0	4	15	1	-2.77259	-1.60944
68	26929004	Alzheimer's disease (disorder)	84	232353008	Perennial allergic rhinitis with seasonal variation	1095	23	29	0	23	29	1043	0.00000	-0.02416	0.00000	0.00000	0.00000	1.0000000000	1.0000000000	0.60913	-0.68628	15	14	0	8	15	0	0.00000	0.00000
67	403191005	Second degree burn	84	232353008	Perennial allergic rhinitis with seasonal variation	1095	49	29	3	46	26	1020	2.31175	0.04683	2.55853	8.76262	0.74704	0.1362305478	0.7287213582	1.29772	0.79980	23	14	1	26	15	2	0.56798	0.53900
117	230265002	Familial Alzheimer's disease of early onset (disorder)	22	70704007	Sprain of wrist	1095	6	195	0	6	195	894	0.00000	-0.03455	0.00000	0.00000	0.00000	0.5981727712	1.0000000000	1.06849	-1.04858	2	90	0	4	105	0	0.00000	0.00000
65	239873007	Osteoarthritis of knee	84	232353008	Perennial allergic rhinitis with seasonal variation	1095	57	29	1	56	28	1010	0.66243	-0.01305	0.64413	4.82049	0.08607	1.0000000000	1.0000000000	1.50959	-0.32745	30	14	0	27	15	1	-2.77259	-3.33220
64	444448004	Injury of medial collateral ligament of knee	84	232353008	Perennial allergic rhinitis with seasonal variation	1095	32	29	1	31	28	1035	1.17996	0.00515	1.19240	9.04637	0.15717	0.5816684066	1.0000000000	0.84749	0.11443	17	14	1	15	15	0	2.70805	2.89037
63	68496003	Polyp of colon	84	232353008	Perennial allergic rhinitis with seasonal variation	1095	91	29	2	89	27	977	0.82986	-0.00845	0.81315	3.47565	0.19024	1.0000000000	1.0000000000	2.41005	-0.18483	43	14	0	48	15	2	-2.14007	-3.21888
62	185086009	Chronic obstructive bronchitis (disorder)	84	232353008	Perennial allergic rhinitis with seasonal variation	1095	6	29	0	6	29	1060	0.00000	-0.01224	0.00000	0.00000	0.00000	1.0000000000	1.0000000000	0.15890	-0.21276	4	14	0	2	15	0	0.00000	0.00000
60	301011002	Escherichia coli urinary tract infection	84	232353008	Perennial allergic rhinitis with seasonal variation	1095	92	29	4	88	25	978	1.64168	0.03205	1.77818	5.22456	0.60521	0.2973504474	0.9848726602	2.43653	0.54098	85	14	4	7	15	0	1.50408	3.10234
59	262574004	Bullet wound	84	232353008	Perennial allergic rhinitis with seasonal variation	1095	20	29	0	20	29	1046	0.00000	-0.02250	0.00000	0.00000	0.00000	1.0000000000	1.0000000000	0.52968	-0.61323	9	14	0	11	15	0	0.00000	0.00000
58	239720000	Tear of meniscus of knee	84	232353008	Perennial allergic rhinitis with seasonal variation	1095	20	29	1	19	28	1047	1.88793	0.01998	1.96805	15.22059	0.25447	0.4181826721	1.0000000000	0.52968	0.38677	10	14	1	10	15	0	2.70805	2.39790
57	192127007	Child attention deficit disorder	84	232353008	Perennial allergic rhinitis with seasonal variation	1095	76	29	2	74	27	992	0.99365	-0.00029	0.99299	4.25705	0.23162	1.0000000000	1.0000000000	2.01279	-0.00614	24	14	0	52	15	2	-2.14007	-3.29584
56	92691004	Carcinoma in situ of prostate (disorder)	84	232353008	Perennial allergic rhinitis with seasonal variation	1095	23	29	0	23	29	1043	0.00000	-0.02416	0.00000	0.00000	0.00000	1.0000000000	1.0000000000	0.60913	-0.68628	0	14	0	23	15	0	0.00000	0.00000
54	5602001	Opioid abuse (disorder)	84	232353008	Perennial allergic rhinitis with seasonal variation	1095	7	29	0	7	29	1059	0.00000	-0.01323	0.00000	0.00000	0.00000	1.0000000000	1.0000000000	0.18539	-0.24536	0	14	0	7	15	0	0.00000	0.00000
53	7200002	Alcoholism	84	232353008	Perennial allergic rhinitis with seasonal variation	1095	5	29	0	5	29	1061	0.00000	-0.01117	0.00000	0.00000	0.00000	1.0000000000	1.0000000000	0.13242	-0.17941	0	14	0	5	15	0	0.00000	0.00000
52	124171000119105	Chronic intractable migraine without aura	84	232353008	Perennial allergic rhinitis with seasonal variation	1095	51	29	2	49	27	1017	1.48073	0.01752	1.53741	6.65087	0.35539	0.6415978778	1.0000000000	1.35068	0.35188	21	14	1	30	15	1	-0.06454	-0.34294
50	446096008	Perennial allergic rhinitis	84	232353008	Perennial allergic rhinitis with seasonal variation	1095	26	29	0	26	29	1040	0.00000	-0.02572	0.00000	0.00000	0.00000	1.0000000000	1.0000000000	0.68858	-0.75581	14	14	0	12	15	0	0.00000	0.00000
49	88805009	Chronic congestive heart failure (disorder)	84	232353008	Perennial allergic rhinitis with seasonal variation	1095	10	29	0	10	29	1056	0.00000	-0.01583	0.00000	0.00000	0.00000	1.0000000000	1.0000000000	0.26484	-0.33896	5	14	0	5	15	0	0.00000	0.00000
123	195967001	Asthma	22	70704007	Sprain of wrist	1095	2	195	0	2	195	898	0.00000	-0.01991	0.00000	0.00000	0.00000	1.0000000000	1.0000000000	0.35616	-0.43953	1	90	0	1	105	0	0.00000	0.00000
47	359817006	Closed fracture of hip	84	232353008	Perennial allergic rhinitis with seasonal variation	1095	29	29	1	28	28	1038	1.30202	0.00822	1.32398	10.07757	0.17394	0.5455456722	1.0000000000	0.76804	0.17785	11	14	0	18	15	1	-2.77259	-2.94444
46	62564004	Concussion with loss of consciousness	84	232353008	Perennial allergic rhinitis with seasonal variation	1095	67	29	4	63	25	1003	2.25425	0.05281	2.54730	7.54417	0.86010	0.0957112291	0.6155535021	1.77443	0.84974	36	14	2	31	15	2	-0.06062	0.14108
45	263102004	Fracture subluxation of wrist	84	232353008	Perennial allergic rhinitis with seasonal variation	1095	109	29	5	104	24	962	1.73205	0.04015	1.92708	5.15790	0.71999	0.1994707893	0.8432232976	2.88676	0.62640	51	14	2	58	15	3	0.28768	0.26488
44	58150001	Fracture of clavicle	84	232353008	Perennial allergic rhinitis with seasonal variation	1095	112	29	2	110	27	956	0.67426	-0.01814	0.64377	2.74395	0.15104	0.7602927410	1.0000000000	2.96621	-0.40280	55	14	1	57	15	1	-0.06454	-0.03509
43	307731004	Injury of tendon of the rotator cuff of shoulder	84	232353008	Perennial allergic rhinitis with seasonal variation	1095	51	29	1	50	28	1016	0.74037	-0.00946	0.72571	5.44210	0.09678	1.0000000000	1.0000000000	1.35068	-0.23308	26	14	1	25	15	0	2.70805	3.29584
42	16114001	Fracture of ankle	84	232353008	Perennial allergic rhinitis with seasonal variation	1095	108	29	2	106	27	960	0.69923	-0.01641	0.67086	2.86069	0.15732	1.0000000000	1.0000000000	2.86027	-0.36374	48	14	1	60	15	1	-0.06454	-0.21905
41	283385000	Laceration of thigh	84	232353008	Perennial allergic rhinitis with seasonal variation	1095	105	29	5	100	24	966	1.79803	0.04287	2.01250	5.39052	0.75135	0.1884331568	0.8196068864	2.78082	0.66626	50	14	2	55	15	3	0.28768	0.29627
40	428251008	History of appendectomy	84	232353008	Perennial allergic rhinitis with seasonal variation	1095	51	29	1	50	28	1016	0.74037	-0.00946	0.72571	5.44210	0.09678	1.0000000000	1.0000000000	1.35068	-0.23308	27	14	1	24	15	0	2.70805	3.33220
39	74400008	Appendicitis	84	232353008	Perennial allergic rhinitis with seasonal variation	1095	51	29	1	50	28	1016	0.74037	-0.00946	0.72571	5.44210	0.09678	1.0000000000	1.0000000000	1.35068	-0.23308	27	14	1	24	15	0	2.70805	3.33220
38	398254007	Preeclampsia	84	232353008	Perennial allergic rhinitis with seasonal variation	1095	101	29	6	95	23	971	2.24309	0.06536	2.66636	6.70979	1.05957	0.0436638961	0.4005033231	2.67489	0.92966	101	14	6	0	15	0	1.20397	2.88107
37	38822007	Cystitis	84	232353008	Perennial allergic rhinitis with seasonal variation	1095	71	29	3	68	26	998	1.59543	0.02586	1.69344	5.73642	0.49992	0.4284840854	1.0000000000	1.88037	0.47375	68	14	3	3	15	0	1.73460	3.16407
35	19169002	Miscarriage in first trimester	84	232353008	Perennial allergic rhinitis with seasonal variation	1095	174	29	5	169	24	897	1.08502	0.00610	1.10577	2.93871	0.41608	0.7977030439	1.0000000000	4.60822	0.09742	174	14	5	0	15	0	1.33500	3.57795
33	429007001	History of cardiac arrest (situation)	84	232353008	Perennial allergic rhinitis with seasonal variation	1095	42	29	2	40	27	1026	1.79803	0.02629	1.90000	8.26886	0.43658	0.3066060542	0.9977249576	1.11233	0.50613	24	14	0	18	15	2	-2.14007	-2.30259
32	410429000	Cardiac Arrest	84	232353008	Perennial allergic rhinitis with seasonal variation	1095	42	29	2	40	27	1026	1.79803	0.02629	1.90000	8.26886	0.43658	0.3066060542	0.9977249576	1.11233	0.50613	24	14	0	18	15	2	-2.14007	-2.30259
31	230690007	Stroke	84	232353008	Perennial allergic rhinitis with seasonal variation	1095	62	29	1	61	28	1005	0.60901	-0.01580	0.58841	4.39733	0.07873	1.0000000000	1.0000000000	1.64201	-0.40164	32	14	1	30	15	0	2.70805	3.49651
30	399211009	History of myocardial infarction (situation)	84	232353008	Perennial allergic rhinitis with seasonal variation	1095	31	29	0	31	29	1035	0.00000	-0.02815	0.00000	0.00000	0.00000	1.0000000000	1.0000000000	0.82100	-0.86473	2	14	0	29	15	0	0.00000	0.00000
29	22298006	Myocardial Infarction	84	232353008	Perennial allergic rhinitis with seasonal variation	1095	31	29	0	31	29	1035	0.00000	-0.02815	0.00000	0.00000	0.00000	1.0000000000	1.0000000000	0.82100	-0.86473	2	14	0	29	15	0	0.00000	0.00000
28	53741008	Coronary Heart Disease	84	232353008	Perennial allergic rhinitis with seasonal variation	1095	80	29	0	80	29	986	0.00000	-0.04631	0.00000	0.00000	0.00000	0.2633806360	0.9292424529	2.11872	-1.64095	24	14	0	56	15	0	0.00000	0.00000
27	408512008	Body mass index 40+ - severely obese (finding)	84	232353008	Perennial allergic rhinitis with seasonal variation	1095	97	29	3	94	26	972	1.16779	0.00863	1.19313	4.01594	0.35447	0.7373286414	1.0000000000	2.56895	0.16450	67	14	2	30	15	1	-0.69315	0.10697
26	33737001	Fracture of rib	84	232353008	Perennial allergic rhinitis with seasonal variation	1095	54	29	0	54	29	1012	0.00000	-0.03757	0.00000	0.00000	0.00000	0.3943441841	1.0000000000	1.43014	-1.28104	32	14	0	22	15	0	0.00000	0.00000
120	162573006	Suspected lung cancer (situation)	3	65363002	Otitis media	1095	8	580	3	5	577	510	0.70797	-0.02659	0.53033	2.23010	0.12611	0.4859122459	1.0000000000	4.23744	-0.38886	0	277	0	8	303	3	-4.62497	-1.29928
24	162864005	Body mass index 30+ - obesity (finding)	84	232353008	Perennial allergic rhinitis with seasonal variation	1095	439	29	12	427	17	639	1.03213	0.00433	1.05634	2.23419	0.49945	1.0000000000	1.0000000000	11.62648	0.04206	226	14	7	213	15	5	-0.28768	-0.26993
23	36971009	Sinusitis (disorder)	84	232353008	Perennial allergic rhinitis with seasonal variation	1095	190	29	7	183	22	883	1.39111	0.02956	1.53527	3.64735	0.64624	0.3217856938	1.0000000000	5.03196	0.40737	84	14	1	106	15	6	1.45529	1.51591
22	70704007	Sprain of wrist	84	232353008	Perennial allergic rhinitis with seasonal variation	1095	195	29	5	190	24	876	0.96817	-0.00244	0.96053	2.54956	0.36187	1.0000000000	1.0000000000	5.16438	-0.03899	90	14	3	105	15	2	-0.40547	-0.54569
21	15777000	Prediabetes	84	232353008	Perennial allergic rhinitis with seasonal variation	1095	333	29	4	329	25	737	0.45356	-0.05958	0.35842	1.03810	0.12375	0.0634931170	0.4910507321	8.81918	-0.97367	159	14	3	174	15	1	-1.03799	-1.17580
20	80394007	Hyperglycemia (disorder)	84	232353008	Perennial allergic rhinitis with seasonal variation	1095	55	29	2	53	27	1013	1.37304	0.01415	1.41579	6.11240	0.32794	0.6533693345	1.0000000000	1.45662	0.28829	23	14	2	32	15	0	2.07944	2.52573
19	237602007	Metabolic syndrome X (disorder)	84	232353008	Perennial allergic rhinitis with seasonal variation	1095	64	29	2	62	27	1004	1.17996	0.00740	1.19952	5.16013	0.27884	0.6847968333	1.0000000000	1.69498	0.15469	28	14	2	36	15	0	2.07944	2.70805
18	302870006	Hypertriglyceridemia (disorder)	84	232353008	Perennial allergic rhinitis with seasonal variation	1095	64	29	2	62	27	1004	1.17996	0.00740	1.19952	5.16013	0.27884	0.6847968333	1.0000000000	1.69498	0.15469	28	14	2	36	15	0	2.07944	2.70805
17	368581000119106	Neuropathy due to type 2 diabetes mellitus (disorder)	84	232353008	Perennial allergic rhinitis with seasonal variation	1095	28	29	0	28	29	1038	0.00000	-0.02672	0.00000	0.00000	0.00000	1.0000000000	1.0000000000	0.74155	-0.80037	7	14	0	21	15	0	0.00000	0.00000
15	40055000	Chronic sinusitis (disorder)	84	232353008	Perennial allergic rhinitis with seasonal variation	1095	216	29	3	213	26	853	0.52443	-0.03888	0.46208	1.54105	0.13855	0.2432550514	0.9130344998	5.72055	-0.74858	104	14	0	112	15	3	-1.79176	-3.64632
14	10509002	Acute bronchitis (disorder)	84	232353008	Perennial allergic rhinitis with seasonal variation	1095	863	29	22	841	7	225	0.96256	-0.01191	0.84084	1.99331	0.35469	0.6492226726	1.0000000000	22.85571	-0.05270	418	14	11	445	15	11	-0.03922	-0.06104
13	370247008	Facial laceration	84	232353008	Perennial allergic rhinitis with seasonal variation	1095	109	29	4	105	25	961	1.38564	0.02115	1.46438	4.28860	0.50003	0.5222646017	1.0000000000	2.88676	0.36336	55	14	3	54	15	1	-1.03799	-1.04550
12	65966004	Fracture of forearm	84	232353008	Perennial allergic rhinitis with seasonal variation	1095	123	29	5	118	24	948	1.53490	0.03138	1.67373	4.46996	0.62671	0.3629031694	1.0000000000	3.25753	0.49494	55	14	2	68	15	3	0.28768	0.18584
11	38341003	Hypertension	84	232353008	Perennial allergic rhinitis with seasonal variation	1095	278	29	6	272	23	794	0.81493	-0.01781	0.76151	1.88989	0.30684	0.6688819707	1.0000000000	7.36256	-0.25659	131	14	5	147	15	1	-1.43759	-1.69400
10	62106007	Concussion with no loss of consciousness	84	232353008	Perennial allergic rhinitis with seasonal variation	1095	206	29	7	199	22	867	1.28306	0.02247	1.38625	3.29026	0.58405	0.4696165867	1.0000000000	5.45571	0.30942	96	14	5	110	15	2	-0.80507	-1.01967
9	44465007	Sprain of ankle	84	232353008	Perennial allergic rhinitis with seasonal variation	1095	362	29	12	350	17	716	1.25167	0.02917	1.44403	3.05688	0.68214	0.3252471521	1.0000000000	9.58721	0.29619	185	14	5	177	15	7	0.18987	0.36856
8	233678006	Childhood asthma	84	232353008	Perennial allergic rhinitis with seasonal variation	1095	45	29	9	36	20	1030	7.55172	0.22371	12.87500	30.24412	5.48092	0.0000008001	0.0000409250	1.19178	2.18982	25	14	5	20	15	4	-0.22314	0.00000
7	75498004	Acute bacterial sinusitis (disorder)	84	232353008	Perennial allergic rhinitis with seasonal variation	1095	187	29	1	186	28	880	0.20192	-0.05974	0.16897	1.24968	0.02285	0.0457844215	0.4100976042	4.95251	-1.57350	89	14	0	98	15	1	-2.77259	-4.59512
6	39848009	Whiplash injury to neck	84	232353008	Perennial allergic rhinitis with seasonal variation	1095	182	29	5	177	24	889	1.03732	0.00275	1.04637	2.77946	0.39393	1.0000000000	1.0000000000	4.82009	0.04392	92	14	3	90	15	2	-0.40547	-0.37338
5	284549007	Laceration of hand	84	232353008	Perennial allergic rhinitis with seasonal variation	1095	104	29	1	103	28	963	0.36306	-0.03403	0.33391	2.47961	0.04497	0.5136724057	1.0000000000	2.75434	-0.90856	54	14	0	50	15	1	-2.77259	-3.93183
4	195662009	Acute viral pharyngitis (disorder)	84	232353008	Perennial allergic rhinitis with seasonal variation	1095	890	29	24	866	5	200	1.01821	0.00626	1.10855	2.94101	0.41784	1.0000000000	1.0000000000	23.57078	0.02498	430	14	13	460	15	11	-0.12931	-0.22834
3	65363002	Otitis media	84	232353008	Perennial allergic rhinitis with seasonal variation	1095	580	29	18	562	11	504	1.17182	0.03007	1.46749	3.13685	0.68652	0.3509566674	1.0000000000	15.36073	0.21576	277	14	8	303	15	10	0.09531	0.12943
1	444814009	Viral sinusitis (disorder)	84	232353008	Perennial allergic rhinitis with seasonal variation	1095	993	29	28	965	1	101	1.06469	0.03329	2.93057	21.76623	0.39457	0.5109748310	1.0000000000	26.29863	0.08722	478	14	13	515	15	15	0.03774	0.06667
118	48333001	Burn injury(morphologic abnormality)	10	62106007	Concussion with no loss of consciousness	1095	1	206	0	1	206	888	0.00000	-0.01455	0.00000	0.00000	0.00000	1.0000000000	1.0000000000	0.18813	-0.24869	0	96	0	1	110	0	0.00000	0.00000
109	90560007	Gout	58	239720000	Tear of meniscus of knee	1095	4	20	0	4	20	1071	0.00000	-0.00826	0.00000	0.00000	0.00000	1.0000000000	1.0000000000	0.07306	-0.10173	0	10	0	4	10	0	0.00000	0.00000
102	90781000119102	Microalbuminuria due to type 2 diabetes mellitus (disorder)	58	239720000	Tear of meniscus of knee	1095	6	20	0	6	20	1069	0.00000	-0.01012	0.00000	0.00000	0.00000	1.0000000000	1.0000000000	0.10959	-0.15003	3	10	0	3	10	0	0.00000	0.00000
98	1551000119108	Nonproliferative diabetic retinopathy due to type 2 diabetes mellitus (disorder)	58	239720000	Tear of meniscus of knee	1095	12	20	1	11	19	1064	4.56250	0.05115	5.09091	41.43957	0.62543	0.1993519240	0.8432232976	0.21918	0.71409	7	10	0	5	10	1	-2.39790	-1.79176
97	403192003	Third degree burn	58	239720000	Tear of meniscus of knee	1095	8	20	0	8	20	1067	0.00000	-0.01170	0.00000	0.00000	0.00000	1.0000000000	1.0000000000	0.14612	-0.19676	3	10	0	5	10	0	0.00000	0.00000
96	283371005	Laceration of forearm	58	239720000	Tear of meniscus of knee	1095	75	20	1	74	19	1001	0.73000	-0.00999	0.71195	5.39217	0.09400	1.0000000000	1.0000000000	1.36986	-0.24480	39	10	1	36	10	0	2.39790	3.68888
94	703151001	History of single seizure (situation)	58	239720000	Tear of meniscus of knee	1095	39	20	3	36	17	1039	4.21154	0.08418	5.09314	18.16421	1.42809	0.0313050527	0.3268117118	0.71233	1.22404	14	10	3	25	10	0	1.46634	1.73460
93	128613002	Seizure disorder	58	239720000	Tear of meniscus of knee	1095	39	20	3	36	17	1039	4.21154	0.08418	5.09314	18.16421	1.42809	0.0313050527	0.3268117118	0.71233	1.22404	14	10	3	25	10	0	1.46634	1.73460
125	1734006	Fracture of the vertebral column with spinal cord injury	10	62106007	Concussion with no loss of consciousness	1095	5	206	2	3	204	886	2.12621	0.03672	2.89542	17.44042	0.48069	0.2383738363	0.9069984981	0.94064	0.62843	3	96	2	2	110	0	3.89182	0.91629
89	47693006	Rupture of appendix	58	239720000	Tear of meniscus of knee	1095	20	20	1	19	19	1056	2.73750	0.03233	2.92521	22.98381	0.37230	0.3106053939	1.0000000000	0.36530	0.55079	10	10	0	10	10	1	-2.39790	-2.39790
86	713197008	Recurrent rectal polyp	58	239720000	Tear of meniscus of knee	1095	22	20	1	21	19	1054	2.48864	0.02907	2.64160	20.65870	0.33778	0.3360303840	1.0000000000	0.40183	0.51269	12	10	1	10	10	0	2.39790	2.56495
130	314994000	Metastasis from malignant tumor of prostate (disorder)	10	62106007	Concussion with no loss of consciousness	1095	1	206	0	1	206	888	0.00000	-0.01455	0.00000	0.00000	0.00000	1.0000000000	1.0000000000	0.18813	-0.24869	0	96	0	1	110	0	0.00000	0.00000
75	431855005	Chronic kidney disease stage 1 (disorder)	58	239720000	Tear of meniscus of knee	1095	28	20	1	27	19	1048	1.95536	0.02111	2.04288	15.81901	0.26382	0.4070686830	1.0000000000	0.51142	0.40410	10	10	0	18	10	1	-2.39790	-2.94444
72	35999006	Blighted ovum	58	239720000	Tear of meniscus of knee	1095	53	20	2	51	18	1024	2.06604	0.03279	2.23094	9.87605	0.50395	0.2518212279	0.9133257124	0.96804	0.60821	53	10	2	0	10	0	1.79176	3.31419
69	233604007	Pneumonia	58	239720000	Tear of meniscus of knee	1095	7	20	0	7	20	1068	0.00000	-0.01094	0.00000	0.00000	0.00000	1.0000000000	1.0000000000	0.12785	-0.17358	3	10	0	4	10	0	0.00000	0.00000
67	403191005	Second degree burn	58	239720000	Tear of meniscus of knee	1095	49	20	1	48	19	1027	1.11735	0.00346	1.12610	8.58797	0.14766	0.6030116966	1.0000000000	0.89498	0.07782	23	10	1	26	10	0	2.39790	3.17805
64	444448004	Injury of medial collateral ligament of knee	58	239720000	Tear of meniscus of knee	1095	32	20	1	31	19	1044	1.71094	0.01682	1.77250	13.66383	0.22993	0.4503494275	1.0000000000	0.58447	0.33600	17	10	0	15	10	1	-2.39790	-2.77259
63	68496003	Polyp of colon	58	239720000	Tear of meniscus of knee	1095	91	20	1	90	19	985	0.60165	-0.01636	0.57602	4.35283	0.07623	1.0000000000	1.0000000000	1.66210	-0.41257	43	10	1	48	10	0	2.39790	3.78419
50	446096008	Perennial allergic rhinitis	58	239720000	Tear of meniscus of knee	1095	26	20	1	25	19	1050	2.10577	0.02352	2.21053	17.16473	0.28468	0.3842327652	1.0000000000	0.47489	0.43940	14	10	0	12	10	1	-2.39790	-2.56495
49	88805009	Chronic congestive heart failure (disorder)	58	239720000	Tear of meniscus of knee	1095	10	20	1	9	19	1066	5.47500	0.05860	6.23392	51.68709	0.75187	0.1689838786	0.7953568293	0.18265	0.75798	5	10	1	5	10	0	2.39790	1.79176
47	359817006	Closed fracture of hip	58	239720000	Tear of meniscus of knee	1095	29	20	0	29	20	1046	0.00000	-0.02250	0.00000	0.00000	0.00000	1.0000000000	1.0000000000	0.52968	-0.61323	11	10	0	18	10	0	0.00000	0.00000
44	58150001	Fracture of clavicle	58	239720000	Tear of meniscus of knee	1095	112	20	2	110	18	965	0.97768	-0.00103	0.97475	4.25694	0.22320	1.0000000000	1.0000000000	2.04566	-0.02179	55	10	2	57	10	0	1.79176	3.34990
43	307731004	Injury of tendon of the rotator cuff of shoulder	58	239720000	Tear of meniscus of knee	1095	51	20	1	50	19	1025	1.07353	0.00222	1.07895	8.22193	0.14159	0.6180548828	1.0000000000	0.93151	0.05027	26	10	0	25	10	1	-2.39790	-3.25810
42	16114001	Fracture of ankle	58	239720000	Tear of meniscus of knee	1095	108	20	0	108	20	967	0.00000	-0.04512	0.00000	0.00000	0.00000	0.2491789032	0.9133257124	1.97260	-1.57173	48	10	0	60	10	0	0.00000	0.00000
41	283385000	Laceration of thigh	58	239720000	Tear of meniscus of knee	1095	105	20	2	103	18	972	1.04286	0.00190	1.04854	4.58287	0.23990	1.0000000000	1.0000000000	1.91781	0.04008	50	10	0	55	10	2	-1.79176	-3.34990
39	74400008	Appendicitis	58	239720000	Tear of meniscus of knee	1095	51	20	2	49	18	1026	2.14706	0.03458	2.32653	10.30984	0.52501	0.2379729124	0.9062586661	0.93151	0.63524	27	10	1	24	10	1	0.00000	0.11333
38	398254007	Preeclampsia	58	239720000	Tear of meniscus of knee	1095	101	20	3	98	17	977	1.62624	0.02723	1.75930	6.10888	0.50666	0.4202448219	1.0000000000	1.84475	0.49170	101	10	3	0	10	0	1.46634	3.54578
35	19169002	Miscarriage in first trimester	58	239720000	Tear of meniscus of knee	1095	174	20	5	169	15	906	1.57328	0.03399	1.78698	4.98228	0.64093	0.3477328087	1.0000000000	3.17808	0.52212	174	10	5	0	10	0	1.09861	3.57795
33	429007001	History of cardiac arrest (situation)	58	239720000	Tear of meniscus of knee	1095	42	20	2	40	18	1035	2.60714	0.04378	2.87500	12.81576	0.64496	0.1768262823	0.8029498763	0.76712	0.76356	24	10	1	18	10	1	0.00000	0.27444
32	410429000	Cardiac Arrest	58	239720000	Tear of meniscus of knee	1095	42	20	2	40	18	1035	2.60714	0.04378	2.87500	12.81576	0.64496	0.1768262823	0.8029498763	0.76712	0.76356	24	10	1	18	10	1	0.00000	0.27444
27	408512008	Body mass index 40+ - severely obese (finding)	58	239720000	Tear of meniscus of knee	1095	97	20	3	94	17	981	1.69330	0.02948	1.84168	6.39915	0.53004	0.4116635187	1.0000000000	1.77169	0.52923	67	10	3	30	10	0	1.46634	3.14988
24	162864005	Body mass index 30+ - obesity (finding)	58	239720000	Tear of meniscus of knee	1095	439	20	7	432	13	643	0.87301	-0.01417	0.80146	2.02502	0.31720	0.8186387335	1.0000000000	8.01826	-0.17285	226	10	5	213	10	2	-0.69315	-0.84451
21	15777000	Prediabetes	58	239720000	Tear of meniscus of knee	1095	333	20	9	324	11	751	1.47973	0.04326	1.89646	4.62054	0.77839	0.2175005937	0.8717900511	6.08219	0.49773	159	10	3	174	10	6	0.48551	0.58779
20	80394007	Hyperglycemia (disorder)	58	239720000	Tear of meniscus of knee	1095	55	20	2	53	18	1022	1.99091	0.03108	2.14256	9.47577	0.48445	0.2657146534	0.9344724470	1.00457	0.58167	23	10	0	32	10	2	-1.79176	-2.83321
18	302870006	Hypertriglyceridemia (disorder)	58	239720000	Tear of meniscus of knee	1095	64	20	2	62	18	1013	1.71094	0.02416	1.81541	8.00062	0.41193	0.3282786903	1.0000000000	1.16895	0.46797	28	10	0	36	10	2	-1.79176	-2.94444
17	368581000119106	Neuropathy due to type 2 diabetes mellitus (disorder)	58	239720000	Tear of meniscus of knee	1095	28	20	2	26	18	1049	3.91071	0.06431	4.48291	20.32961	0.98853	0.0902351548	0.5966770779	0.51142	0.98906	7	10	0	21	10	2	-1.79176	-2.44235
15	40055000	Chronic sinusitis (disorder)	58	239720000	Tear of meniscus of knee	1095	216	20	3	213	17	862	0.76042	-0.01620	0.71417	2.45928	0.20739	0.7798663570	1.0000000000	3.94521	-0.30603	104	10	2	112	10	1	-0.60614	-0.75710
14	10509002	Acute bronchitis (disorder)	58	239720000	Tear of meniscus of knee	1095	863	20	18	845	2	230	1.14195	0.03734	2.44970	10.63440	0.56431	0.2786034939	0.9565195531	15.76256	0.18076	418	10	8	445	10	10	0.11778	0.15729
13	370247008	Facial laceration	58	239720000	Tear of meniscus of knee	1095	109	20	3	106	17	969	1.50688	0.02299	1.61321	5.59500	0.46514	0.4406298009	1.0000000000	1.99087	0.41944	55	10	2	54	10	1	-0.60614	-0.65743
125	1734006	Fracture of the vertebral column with spinal cord injury	32	410429000	Cardiac Arrest	1095	5	42	1	4	41	1049	5.21429	0.05700	6.39634	58.50650	0.69929	0.1779227643	0.8046398895	0.19178	0.74688	3	24	0	2	18	1	-2.94444	-1.09861
10	62106007	Concussion with no loss of consciousness	58	239720000	Tear of meniscus of knee	1095	206	20	4	202	16	873	1.06311	0.00414	1.08045	3.26632	0.35739	0.7791189838	1.0000000000	3.76256	0.07019	96	10	1	110	10	3	0.93156	0.94594
7	75498004	Acute bacterial sinusitis (disorder)	58	239720000	Tear of meniscus of knee	1095	187	20	3	184	17	891	0.87834	-0.00753	0.85454	2.94587	0.24789	1.0000000000	1.0000000000	3.41553	-0.14259	89	10	0	98	10	3	-1.46634	-3.51651
6	39848009	Whiplash injury to neck	58	239720000	Tear of meniscus of knee	1095	182	20	6	176	14	899	1.80495	0.04902	2.18912	5.77429	0.82993	0.1242759457	0.6913144812	3.32420	0.69492	92	10	1	90	10	5	1.29928	1.58816
118	48333001	Burn injury(morphologic abnormality)	32	410429000	Cardiac Arrest	1095	1	42	0	1	42	1052	0.00000	-0.00604	0.00000	0.00000	0.00000	1.0000000000	1.0000000000	0.03836	-0.05430	0	24	0	1	18	0	0.00000	0.00000
96	283371005	Laceration of forearm	32	410429000	Cardiac Arrest	1095	75	42	6	69	36	984	2.08571	0.05880	2.37681	5.83474	0.96821	0.0612581076	0.4826962916	2.87671	0.85252	39	24	3	36	18	3	0.25131	0.07411
94	703151001	History of single seizure (situation)	32	410429000	Cardiac Arrest	1095	39	42	3	36	39	1017	2.00549	0.03859	2.17308	7.36386	0.64128	0.1850424915	0.8181443419	1.49589	0.68045	14	24	0	25	18	3	-1.94591	-2.23359
86	713197008	Recurrent rectal polyp	32	410429000	Cardiac Arrest	1095	22	42	1	21	41	1032	1.18506	0.00529	1.19861	9.12834	0.15738	0.5806180630	1.0000000000	0.84384	0.11729	12	24	1	10	18	0	3.21888	2.56495
75	431855005	Chronic kidney disease stage 1 (disorder)	32	410429000	Cardiac Arrest	1095	28	42	1	27	41	1026	0.93112	-0.00223	0.92683	6.98809	0.12293	1.0000000000	1.0000000000	1.07397	-0.05240	10	24	1	18	18	0	3.21888	2.39790
44	58150001	Fracture of clavicle	32	410429000	Cardiac Arrest	1095	112	42	7	105	35	948	1.62946	0.04243	1.80571	4.16669	0.78254	0.1871321590	0.8181443419	4.29589	0.59513	55	24	5	57	18	2	-0.54473	-0.89948
43	307731004	Injury of tendon of the rotator cuff of shoulder	32	410429000	Cardiac Arrest	1095	51	42	2	49	40	1004	1.02241	0.00099	1.02449	4.36224	0.24061	1.0000000000	1.0000000000	1.95616	0.02124	26	24	2	25	18	0	2.56495	2.63906
42	16114001	Fracture of ankle	32	410429000	Cardiac Arrest	1095	108	42	3	105	39	948	0.72421	-0.01822	0.69451	2.28628	0.21097	0.7913261509	1.0000000000	4.14247	-0.36246	48	24	1	60	18	2	0.91629	0.45783
41	283385000	Laceration of thigh	32	410429000	Cardiac Arrest	1095	105	42	5	100	37	953	1.24150	0.01571	1.28784	3.35111	0.49492	0.5902468084	1.0000000000	4.02740	0.25515	50	24	2	55	18	3	0.61904	0.29627
33	429007001	History of cardiac arrest (situation)	32	410429000	Cardiac Arrest	1095	42	42	42	0	0	1053	26.07143	1.00000	0.00000	0.00000	0.00000	0.0000000000	0.0000000000	1.61096	4.04169	24	24	24	18	18	18	0.00000	0.00000
27	408512008	Body mass index 40+ - severely obese (finding)	32	410429000	Cardiac Arrest	1095	97	42	5	92	37	961	1.34389	0.02141	1.41157	3.67944	0.54153	0.4113439269	1.0000000000	3.72055	0.34601	67	24	4	30	18	1	-0.99853	-0.55760
21	15777000	Prediabetes	32	410429000	Cardiac Arrest	1095	333	42	18	315	24	738	1.40927	0.05403	1.75714	3.28344	0.94034	0.0867771639	0.5823623432	12.77260	0.46420	159	24	9	174	18	9	0.20067	-0.08552
15	40055000	Chronic sinusitis (disorder)	32	410429000	Cardiac Arrest	1095	216	42	10	206	32	847	1.20701	0.02049	1.28489	2.65616	0.62155	0.5519762780	1.0000000000	8.28493	0.24454	104	24	5	112	18	5	0.23180	-0.07083
14	10509002	Acute bronchitis (disorder)	32	410429000	Cardiac Arrest	1095	863	42	36	827	6	226	1.08757	0.03373	1.63966	3.94002	0.68235	0.3368920776	1.0000000000	33.10137	0.11770	418	24	20	445	18	16	0.03469	-0.27432
125	1734006	Fracture of the vertebral column with spinal cord injury	6	39848009	Whiplash injury to neck	1095	5	182	1	4	181	909	1.20330	0.00615	1.25552	11.29841	0.13952	1.0000000000	1.0000000000	0.83105	0.12733	3	92	0	2	90	1	-4.51086	-1.09861
118	48333001	Burn injury(morphologic abnormality)	6	39848009	Whiplash injury to neck	1095	1	182	0	1	182	912	0.00000	-0.01350	0.00000	0.00000	0.00000	1.0000000000	1.0000000000	0.16621	-0.22183	0	92	0	1	90	0	0.00000	0.00000
117	230265002	Familial Alzheimer's disease of early onset (disorder)	6	39848009	Whiplash injury to neck	1095	6	182	2	4	180	909	2.00549	0.03332	2.52500	13.88955	0.45902	0.2619364224	0.9281913645	0.99726	0.58694	2	92	1	4	90	1	0.02174	-0.51083
109	90560007	Gout	6	39848009	Whiplash injury to neck	1095	4	182	3	1	179	912	4.51236	0.09495	15.28492	147.77716	1.58095	0.0158876761	0.2148875519	0.66484	1.26462	0	92	0	4	90	3	-3.43399	-0.84730
97	403192003	Third degree burn	6	39848009	Whiplash injury to neck	1095	8	182	3	5	179	908	2.25618	0.04812	3.04358	12.84991	0.72089	0.1332731768	0.7172728056	1.32968	0.77987	3	92	1	5	90	2	0.70396	0.13353
96	283371005	Laceration of forearm	6	39848009	Whiplash injury to neck	1095	75	182	14	61	168	852	1.12308	0.01490	1.16393	2.12919	0.63627	0.6297529850	1.0000000000	12.46575	0.15567	39	92	6	36	90	8	0.28768	0.31015
94	703151001	History of single seizure (situation)	6	39848009	Whiplash injury to neck	1095	39	182	3	36	179	877	0.46281	-0.04609	0.40829	1.34035	0.12437	0.1855467243	0.8181443419	6.48219	-0.90346	14	92	2	25	90	1	-0.66071	-1.17865
93	128613002	Seizure disorder	6	39848009	Whiplash injury to neck	1095	39	182	3	36	179	877	0.46281	-0.04609	0.40829	1.34035	0.12437	0.1855467243	0.8181443419	6.48219	-0.90346	14	92	2	25	90	1	-0.66071	-1.17865
89	47693006	Rupture of appendix	6	39848009	Whiplash injury to neck	1095	20	182	2	18	180	895	0.60165	-0.02426	0.55247	2.40190	0.12708	0.5562916701	1.0000000000	3.32420	-0.52747	10	92	1	10	90	1	0.02174	0.00000
86	713197008	Recurrent rectal polyp	6	39848009	Whiplash injury to neck	1095	22	182	7	15	175	898	1.91434	0.05845	2.39467	5.95896	0.96232	0.0754134314	0.5412748168	3.65662	0.78072	12	92	6	10	90	1	-1.71765	-1.29928
75	431855005	Chronic kidney disease stage 1 (disorder)	6	39848009	Whiplash injury to neck	1095	28	182	7	21	175	892	1.50412	0.03646	1.69905	4.05796	0.71138	0.2987807959	0.9870898856	4.65388	0.50076	10	92	4	18	90	3	-0.25593	-0.69315
69	233604007	Pneumonia	6	39848009	Whiplash injury to neck	1095	7	182	1	6	181	907	0.85950	-0.00503	0.83517	6.97893	0.09995	1.0000000000	1.0000000000	1.16347	-0.11335	3	92	0	4	90	1	-4.51086	-1.60944
64	444448004	Injury of medial collateral ligament of knee	6	39848009	Whiplash injury to neck	1095	32	182	8	24	174	889	1.50412	0.03905	1.70307	3.85323	0.75273	0.2243228722	0.8794911525	5.31872	0.51029	17	92	7	15	90	1	-1.86165	-1.54045
49	88805009	Chronic congestive heart failure (disorder)	6	39848009	Whiplash injury to neck	1095	10	182	1	9	181	904	0.60165	-0.01707	0.55494	4.40724	0.06988	1.0000000000	1.0000000000	1.66210	-0.41257	5	92	1	5	90	0	4.53260	1.79176
47	359817006	Closed fracture of hip	6	39848009	Whiplash injury to neck	1095	29	182	3	26	179	887	0.62239	-0.02781	0.57177	1.90943	0.17121	0.4560793314	1.0000000000	4.82009	-0.54104	11	92	2	18	90	1	-0.66071	-1.07264
44	58150001	Fracture of clavicle	6	39848009	Whiplash injury to neck	1095	112	182	23	89	159	824	1.23553	0.03550	1.33927	2.18367	0.82139	0.2306478713	0.8899459402	18.61553	0.29104	55	92	8	57	90	15	0.57982	0.49508
43	307731004	Injury of tendon of the rotator cuff of shoulder	6	39848009	Whiplash injury to neck	1095	51	182	12	39	170	874	1.41564	0.04102	1.58190	3.08382	0.81146	0.1783962546	0.8051220167	8.47671	0.45605	26	92	6	25	90	6	0.02062	0.03175
42	16114001	Fracture of ankle	6	39848009	Whiplash injury to neck	1095	108	182	21	87	161	826	1.16987	0.02509	1.23838	2.05313	0.74695	0.4142767687	1.0000000000	17.95068	0.21525	48	92	8	60	90	13	0.45595	0.22040
41	283385000	Laceration of thigh	6	39848009	Whiplash injury to neck	1095	105	182	17	88	165	825	0.97410	-0.00377	0.96591	1.66663	0.55980	1.0000000000	1.0000000000	17.45205	-0.03578	50	92	9	55	90	8	-0.08763	-0.18338
39	74400008	Appendicitis	6	39848009	Whiplash injury to neck	1095	51	182	12	39	170	874	1.41564	0.04102	1.58190	3.08382	0.81146	0.1783962546	0.8051220167	8.47671	0.45605	27	92	7	24	90	5	-0.29523	-0.17741
38	398254007	Preeclampsia	6	39848009	Whiplash injury to neck	1095	101	182	23	78	159	835	1.37009	0.05267	1.54854	2.54039	0.94394	0.0917697273	0.5998476181	16.78721	0.43219	101	92	23	0	90	0	1.60944	1.68479
35	19169002	Miscarriage in first trimester	6	39848009	Whiplash injury to neck	1095	174	182	43	131	139	782	1.48683	0.09448	1.84667	2.72438	1.25173	0.0026341922	0.0541520832	28.92055	0.55637	174	92	43	0	90	0	1.14407	1.61870
33	429007001	History of cardiac arrest (situation)	6	39848009	Whiplash injury to neck	1095	42	182	6	36	176	877	0.85950	-0.01253	0.83049	2.00082	0.34472	0.8336196177	1.0000000000	6.98082	-0.18918	24	92	2	18	90	4	0.69315	0.86020
32	410429000	Cardiac Arrest	6	39848009	Whiplash injury to neck	1095	42	182	6	36	176	877	0.85950	-0.01253	0.83049	2.00082	0.34472	0.8336196177	1.0000000000	6.98082	-0.18918	24	92	2	18	90	4	0.69315	0.86020
27	408512008	Body mass index 40+ - severely obese (finding)	6	39848009	Whiplash injury to neck	1095	97	182	21	76	161	837	1.30254	0.04211	1.43650	2.39646	0.86107	0.1971076347	0.8366590028	16.12237	0.36162	67	92	16	30	90	5	-1.03490	-0.29966
21	15777000	Prediabetes	6	39848009	Whiplash injury to neck	1095	333	182	72	261	110	652	1.30086	0.08880	1.63511	2.27434	1.17554	0.0046270243	0.0858689624	55.34795	0.37353	159	92	31	174	90	41	0.21657	0.15597
18	302870006	Hypertriglyceridemia (disorder)	6	39848009	Whiplash injury to neck	1095	64	182	12	52	170	861	1.12809	0.01425	1.16878	2.23635	0.61083	0.6056718385	1.0000000000	10.63744	0.15974	28	92	6	36	90	6	0.02062	-0.21131
15	40055000	Chronic sinusitis (disorder)	6	39848009	Whiplash injury to neck	1095	216	182	33	183	149	730	0.91918	-0.01789	0.88349	1.33181	0.58608	0.6105746489	1.0000000000	35.90137	-0.11814	104	92	18	112	90	15	-0.13580	-0.22249
14	10509002	Acute bronchitis (disorder)	6	39848009	Whiplash injury to neck	1095	863	182	157	706	25	207	1.09454	0.08141	1.84130	2.88654	1.17456	0.0071160668	0.1198941166	143.43927	0.12946	418	92	79	445	90	78	0.00496	-0.06373
127	431856006	Chronic kidney disease stage 2 (disorder)	12	65966004	Fracture of forearm	1095	5	123	0	5	123	967	0.00000	-0.02409	0.00000	0.00000	0.00000	1.0000000000	1.0000000000	0.56164	-0.64307	3	55	0	2	68	0	0.00000	0.00000
128	86849004	Suicidal deliberate poisoning	12	65966004	Fracture of forearm	1095	1	123	0	1	123	971	0.00000	-0.01076	0.00000	0.00000	0.00000	1.0000000000	1.0000000000	0.11233	-0.15358	0	55	0	1	68	0	0.00000	0.00000
128	86849004	Suicidal deliberate poisoning	77	422034002	Diabetic retinopathy associated with type II diabetes mellitus (disorder)	1095	1	20	0	1	20	1074	0.00000	-0.00412	0.00000	0.00000	0.00000	1.0000000000	1.0000000000	0.01826	-0.02611	0	8	0	1	12	0	0.00000	0.00000
130	314994000	Metastasis from malignant tumor of prostate (disorder)	77	422034002	Diabetic retinopathy associated with type II diabetes mellitus (disorder)	1095	1	20	0	1	20	1074	0.00000	-0.00412	0.00000	0.00000	0.00000	1.0000000000	1.0000000000	0.01826	-0.02611	0	8	0	1	12	0	0.00000	0.00000
132	69896004	Rheumatoid arthritis	77	422034002	Diabetic retinopathy associated with type II diabetes mellitus (disorder)	1095	3	20	0	3	20	1072	0.00000	-0.00715	0.00000	0.00000	0.00000	1.0000000000	1.0000000000	0.05479	-0.07696	2	8	0	1	12	0	0.00000	0.00000
118	48333001	Burn injury(morphologic abnormality)	33	429007001	History of cardiac arrest (situation)	1095	1	42	0	1	42	1052	0.00000	-0.00604	0.00000	0.00000	0.00000	1.0000000000	1.0000000000	0.03836	-0.05430	0	24	0	1	18	0	0.00000	0.00000
131	93761005	Primary malignant neoplasm of colon	119	275272006	Brain damage - traumatic	1095	5	4	0	5	4	1086	0.00000	-0.00410	0.00000	0.00000	0.00000	1.0000000000	1.0000000000	0.01826	-0.02611	3	0	0	2	4	0	0.00000	0.00000
130	314994000	Metastasis from malignant tumor of prostate (disorder)	119	275272006	Brain damage - traumatic	1095	1	4	0	1	4	1090	0.00000	-0.00183	0.00000	0.00000	0.00000	1.0000000000	1.0000000000	0.00365	-0.00526	0	0	0	1	4	0	0.00000	0.00000
129	47505003	Posttraumatic stress disorder	119	275272006	Brain damage - traumatic	1095	4	4	0	4	4	1087	0.00000	-0.00367	0.00000	0.00000	0.00000	1.0000000000	1.0000000000	0.01461	-0.02093	1	0	0	3	4	0	0.00000	0.00000
128	86849004	Suicidal deliberate poisoning	119	275272006	Brain damage - traumatic	1095	1	4	0	1	4	1090	0.00000	-0.00183	0.00000	0.00000	0.00000	1.0000000000	1.0000000000	0.00365	-0.00526	0	0	0	1	4	0	0.00000	0.00000
127	431856006	Chronic kidney disease stage 2 (disorder)	119	275272006	Brain damage - traumatic	1095	5	4	0	5	4	1086	0.00000	-0.00410	0.00000	0.00000	0.00000	1.0000000000	1.0000000000	0.01826	-0.02611	3	0	0	2	4	0	0.00000	0.00000
126	698754002	Chronic paralysis due to lesion of spinal cord	119	275272006	Brain damage - traumatic	1095	2	4	0	2	4	1089	0.00000	-0.00259	0.00000	0.00000	0.00000	1.0000000000	1.0000000000	0.00731	-0.01050	2	0	0	0	4	0	0.00000	0.00000
125	1734006	Fracture of the vertebral column with spinal cord injury	119	275272006	Brain damage - traumatic	1095	5	4	0	5	4	1086	0.00000	-0.00410	0.00000	0.00000	0.00000	1.0000000000	1.0000000000	0.01826	-0.02611	3	0	0	2	4	0	0.00000	0.00000
124	1501000119109	Proliferative diabetic retinopathy due to type II diabetes mellitus (disorder)	119	275272006	Brain damage - traumatic	1095	1	4	0	1	4	1090	0.00000	-0.00183	0.00000	0.00000	0.00000	1.0000000000	1.0000000000	0.00365	-0.00526	1	0	0	0	4	0	0.00000	0.00000
123	195967001	Asthma	119	275272006	Brain damage - traumatic	1095	2	4	0	2	4	1089	0.00000	-0.00259	0.00000	0.00000	0.00000	1.0000000000	1.0000000000	0.00731	-0.01050	1	0	0	1	4	0	0.00000	0.00000
121	254637007	Non-small cell lung cancer (disorder)	119	275272006	Brain damage - traumatic	1095	8	4	1	7	3	1084	34.21875	0.17256	51.61905	558.89744	4.76747	0.0289442858	0.3121289194	0.02922	0.95844	0	0	0	8	4	1	-1.60944	-2.19722
120	162573006	Suspected lung cancer (situation)	119	275272006	Brain damage - traumatic	1095	8	4	1	7	3	1084	34.21875	0.17256	51.61905	558.89744	4.76747	0.0289442858	0.3121289194	0.02922	0.95844	0	0	0	8	4	1	-1.60944	-2.19722
118	48333001	Burn injury(morphologic abnormality)	119	275272006	Brain damage - traumatic	1095	1	4	0	1	4	1090	0.00000	-0.00183	0.00000	0.00000	0.00000	1.0000000000	1.0000000000	0.00365	-0.00526	0	0	0	1	4	0	0.00000	0.00000
117	230265002	Familial Alzheimer's disease of early onset (disorder)	119	275272006	Brain damage - traumatic	1095	6	4	0	6	4	1085	0.00000	-0.00449	0.00000	0.00000	0.00000	1.0000000000	1.0000000000	0.02192	-0.03128	2	0	0	4	4	0	0.00000	0.00000
115	36923009	Major depression  single episode	119	275272006	Brain damage - traumatic	1095	6	4	0	6	4	1085	0.00000	-0.00449	0.00000	0.00000	0.00000	1.0000000000	1.0000000000	0.02192	-0.03128	3	0	0	3	4	0	0.00000	0.00000
114	449868002	Smokes tobacco daily	119	275272006	Brain damage - traumatic	1095	9	4	0	9	4	1082	0.00000	-0.00551	0.00000	0.00000	0.00000	1.0000000000	1.0000000000	0.03288	-0.04667	2	0	0	7	4	0	0.00000	0.00000
112	49436004	Atrial Fibrillation	119	275272006	Brain damage - traumatic	1095	35	4	1	34	3	1057	7.82143	0.07505	10.36275	102.20808	1.05067	0.1220126900	0.6889733259	0.12785	0.82642	9	0	0	26	4	1	-1.60944	-3.29584
111	235919008	Cholelithiasis	119	275272006	Brain damage - traumatic	1095	9	4	0	9	4	1082	0.00000	-0.00551	0.00000	0.00000	0.00000	1.0000000000	1.0000000000	0.03288	-0.04667	7	0	0	2	4	0	0.00000	0.00000
110	65275009	Acute Cholecystitis	119	275272006	Brain damage - traumatic	1095	9	4	0	9	4	1082	0.00000	-0.00551	0.00000	0.00000	0.00000	1.0000000000	1.0000000000	0.03288	-0.04667	7	0	0	2	4	0	0.00000	0.00000
109	90560007	Gout	119	275272006	Brain damage - traumatic	1095	4	4	0	4	4	1087	0.00000	-0.00367	0.00000	0.00000	0.00000	1.0000000000	1.0000000000	0.01461	-0.02093	0	0	0	4	4	0	0.00000	0.00000
108	40930008	Hypothyroidism (disorder)	119	275272006	Brain damage - traumatic	1095	13	4	0	13	4	1078	0.00000	-0.00664	0.00000	0.00000	0.00000	1.0000000000	1.0000000000	0.04749	-0.06693	11	0	0	2	4	0	0.00000	0.00000
107	40275004	Contact dermatitis	119	275272006	Brain damage - traumatic	1095	18	4	0	18	4	1073	0.00000	-0.00783	0.00000	0.00000	0.00000	1.0000000000	1.0000000000	0.06575	-0.09187	9	0	0	9	4	0	0.00000	0.00000
106	24079001	Atopic dermatitis	119	275272006	Brain damage - traumatic	1095	20	4	0	20	4	1071	0.00000	-0.00826	0.00000	0.00000	0.00000	1.0000000000	1.0000000000	0.07306	-0.10173	13	0	0	7	4	0	0.00000	0.00000
105	363406005	Malignant tumor of colon	119	275272006	Brain damage - traumatic	1095	6	4	0	6	4	1085	0.00000	-0.00449	0.00000	0.00000	0.00000	1.0000000000	1.0000000000	0.02192	-0.03128	4	0	0	2	4	0	0.00000	0.00000
104	367498001	Seasonal allergic rhinitis	119	275272006	Brain damage - traumatic	1095	20	4	0	20	4	1071	0.00000	-0.00826	0.00000	0.00000	0.00000	1.0000000000	1.0000000000	0.07306	-0.10173	9	0	0	11	4	0	0.00000	0.00000
102	90781000119102	Microalbuminuria due to type 2 diabetes mellitus (disorder)	119	275272006	Brain damage - traumatic	1095	6	4	0	6	4	1085	0.00000	-0.00449	0.00000	0.00000	0.00000	1.0000000000	1.0000000000	0.02192	-0.03128	3	0	0	3	4	0	0.00000	0.00000
101	433144002	Chronic kidney disease stage 3 (disorder)	119	275272006	Brain damage - traumatic	1095	3	4	0	3	4	1088	0.00000	-0.00317	0.00000	0.00000	0.00000	1.0000000000	1.0000000000	0.01096	-0.01572	1	0	0	2	4	0	0.00000	0.00000
100	161622006	History of lower limb amputation (situation)	119	275272006	Brain damage - traumatic	1095	1	4	0	1	4	1090	0.00000	-0.00183	0.00000	0.00000	0.00000	1.0000000000	1.0000000000	0.00365	-0.00526	0	0	0	1	4	0	0.00000	0.00000
99	30832001	Rupture of patellar tendon	119	275272006	Brain damage - traumatic	1095	23	4	0	23	4	1068	0.00000	-0.00887	0.00000	0.00000	0.00000	1.0000000000	1.0000000000	0.08402	-0.11639	14	0	0	9	4	0	0.00000	0.00000
98	1551000119108	Nonproliferative diabetic retinopathy due to type 2 diabetes mellitus (disorder)	119	275272006	Brain damage - traumatic	1095	12	4	0	12	4	1079	0.00000	-0.00637	0.00000	0.00000	0.00000	1.0000000000	1.0000000000	0.04384	-0.06189	7	0	0	5	4	0	0.00000	0.00000
97	403192003	Third degree burn	119	275272006	Brain damage - traumatic	1095	8	4	0	8	4	1083	0.00000	-0.00519	0.00000	0.00000	0.00000	1.0000000000	1.0000000000	0.02922	-0.04156	3	0	0	5	4	0	0.00000	0.00000
96	283371005	Laceration of forearm	119	275272006	Brain damage - traumatic	1095	75	4	0	75	4	1016	0.00000	-0.01642	0.00000	0.00000	0.00000	1.0000000000	1.0000000000	0.27397	-0.34933	39	0	0	36	4	0	0.00000	0.00000
95	84757009	Epilepsy	119	275272006	Brain damage - traumatic	1095	30	4	0	30	4	1061	0.00000	-0.01016	0.00000	0.00000	0.00000	1.0000000000	1.0000000000	0.10959	-0.15003	13	0	0	17	4	0	0.00000	0.00000
94	703151001	History of single seizure (situation)	119	275272006	Brain damage - traumatic	1095	39	4	0	39	4	1052	0.00000	-0.01164	0.00000	0.00000	0.00000	1.0000000000	1.0000000000	0.14247	-0.19215	14	0	0	25	4	0	0.00000	0.00000
93	128613002	Seizure disorder	119	275272006	Brain damage - traumatic	1095	39	4	0	39	4	1052	0.00000	-0.01164	0.00000	0.00000	0.00000	1.0000000000	1.0000000000	0.14247	-0.19215	14	0	0	25	4	0	0.00000	0.00000
91	64859006	Osteoporosis (disorder)	119	275272006	Brain damage - traumatic	1095	37	4	0	37	4	1054	0.00000	-0.01132	0.00000	0.00000	0.00000	1.0000000000	1.0000000000	0.13516	-0.18290	24	0	0	13	4	0	0.00000	0.00000
89	47693006	Rupture of appendix	119	275272006	Brain damage - traumatic	1095	20	4	0	20	4	1071	0.00000	-0.00826	0.00000	0.00000	0.00000	1.0000000000	1.0000000000	0.07306	-0.10173	10	0	0	10	4	0	0.00000	0.00000
86	713197008	Recurrent rectal polyp	119	275272006	Brain damage - traumatic	1095	22	4	0	22	4	1069	0.00000	-0.00867	0.00000	0.00000	0.00000	1.0000000000	1.0000000000	0.08037	-0.11152	12	0	0	10	4	0	0.00000	0.00000
85	241929008	Acute allergic reaction	119	275272006	Brain damage - traumatic	1095	47	4	0	47	4	1044	0.00000	-0.01282	0.00000	0.00000	0.00000	1.0000000000	1.0000000000	0.17169	-0.22859	25	0	0	22	4	0	0.00000	0.00000
83	110030002	Concussion injury of brain	119	275272006	Brain damage - traumatic	1095	7	4	1	6	3	1085	39.10714	0.18508	60.27778	665.24780	5.46174	0.0253610543	0.2905941929	0.02557	0.96357	1	0	0	6	4	1	-1.60944	-1.94591
82	94260004	Secondary malignant neoplasm of colon	119	275272006	Brain damage - traumatic	1095	4	4	0	4	4	1087	0.00000	-0.00367	0.00000	0.00000	0.00000	1.0000000000	1.0000000000	0.01461	-0.02093	2	0	0	2	4	0	0.00000	0.00000
81	236077008	Protracted diarrhea	119	275272006	Brain damage - traumatic	1095	4	4	0	4	4	1087	0.00000	-0.00367	0.00000	0.00000	0.00000	1.0000000000	1.0000000000	0.01461	-0.02093	2	0	0	2	4	0	0.00000	0.00000
80	6072007	Bleeding from anus	119	275272006	Brain damage - traumatic	1095	4	4	0	4	4	1087	0.00000	-0.00367	0.00000	0.00000	0.00000	1.0000000000	1.0000000000	0.01461	-0.02093	2	0	0	2	4	0	0.00000	0.00000
79	45816000	Pyelonephritis	119	275272006	Brain damage - traumatic	1095	1	4	0	1	4	1090	0.00000	-0.00183	0.00000	0.00000	0.00000	1.0000000000	1.0000000000	0.00365	-0.00526	1	0	0	0	4	0	0.00000	0.00000
78	239872002	Osteoarthritis of hip	119	275272006	Brain damage - traumatic	1095	21	4	1	20	3	1071	13.03571	0.10191	17.85000	179.10989	1.77892	0.0746329783	0.5403135912	0.07671	0.89337	13	0	0	8	4	1	-1.60944	-2.19722
76	127013003	Diabetic renal disease (disorder)	119	275272006	Brain damage - traumatic	1095	28	4	0	28	4	1063	0.00000	-0.00981	0.00000	0.00000	0.00000	1.0000000000	1.0000000000	0.10228	-0.14049	10	0	0	18	4	0	0.00000	0.00000
75	431855005	Chronic kidney disease stage 1 (disorder)	119	275272006	Brain damage - traumatic	1095	28	4	0	28	4	1063	0.00000	-0.00981	0.00000	0.00000	0.00000	1.0000000000	1.0000000000	0.10228	-0.14049	10	0	0	18	4	0	0.00000	0.00000
73	196416002	Impacted molars	119	275272006	Brain damage - traumatic	1095	49	4	0	49	4	1042	0.00000	-0.01311	0.00000	0.00000	0.00000	1.0000000000	1.0000000000	0.17900	-0.23756	25	0	0	24	4	0	0.00000	0.00000
72	35999006	Blighted ovum	119	275272006	Brain damage - traumatic	1095	53	4	0	53	4	1038	0.00000	-0.01366	0.00000	0.00000	0.00000	1.0000000000	1.0000000000	0.19361	-0.25533	53	0	0	0	4	0	0.00000	0.00000
71	201834006	Localized  primary osteoarthritis of the hand	119	275272006	Brain damage - traumatic	1095	28	4	0	28	4	1063	0.00000	-0.00981	0.00000	0.00000	0.00000	1.0000000000	1.0000000000	0.10228	-0.14049	19	0	0	9	4	0	0.00000	0.00000
70	87433001	Pulmonary emphysema (disorder)	119	275272006	Brain damage - traumatic	1095	17	4	0	17	4	1074	0.00000	-0.00760	0.00000	0.00000	0.00000	1.0000000000	1.0000000000	0.06210	-0.08692	9	0	0	8	4	0	0.00000	0.00000
69	233604007	Pneumonia	119	275272006	Brain damage - traumatic	1095	7	4	0	7	4	1084	0.00000	-0.00486	0.00000	0.00000	0.00000	1.0000000000	1.0000000000	0.02557	-0.03643	3	0	0	4	4	0	0.00000	0.00000
68	26929004	Alzheimer's disease (disorder)	119	275272006	Brain damage - traumatic	1095	23	4	0	23	4	1068	0.00000	-0.00887	0.00000	0.00000	0.00000	1.0000000000	1.0000000000	0.08402	-0.11639	15	0	0	8	4	0	0.00000	0.00000
67	403191005	Second degree burn	119	275272006	Brain damage - traumatic	1095	49	4	0	49	4	1042	0.00000	-0.01311	0.00000	0.00000	0.00000	1.0000000000	1.0000000000	0.17900	-0.23756	23	0	0	26	4	0	0.00000	0.00000
65	239873007	Osteoarthritis of knee	119	275272006	Brain damage - traumatic	1095	57	4	0	57	4	1034	0.00000	-0.01419	0.00000	0.00000	0.00000	1.0000000000	1.0000000000	0.20822	-0.27288	30	0	0	27	4	0	0.00000	0.00000
64	444448004	Injury of medial collateral ligament of knee	119	275272006	Brain damage - traumatic	1095	32	4	0	32	4	1059	0.00000	-0.01051	0.00000	0.00000	0.00000	1.0000000000	1.0000000000	0.11689	-0.15949	17	0	0	15	4	0	0.00000	0.00000
63	68496003	Polyp of colon	119	275272006	Brain damage - traumatic	1095	91	4	0	91	4	1000	0.00000	-0.01823	0.00000	0.00000	0.00000	1.0000000000	1.0000000000	0.33242	-0.41405	43	0	0	48	4	0	0.00000	0.00000
62	185086009	Chronic obstructive bronchitis (disorder)	119	275272006	Brain damage - traumatic	1095	6	4	0	6	4	1085	0.00000	-0.00449	0.00000	0.00000	0.00000	1.0000000000	1.0000000000	0.02192	-0.03128	4	0	0	2	4	0	0.00000	0.00000
59	262574004	Bullet wound	119	275272006	Brain damage - traumatic	1095	20	4	0	20	4	1071	0.00000	-0.00826	0.00000	0.00000	0.00000	1.0000000000	1.0000000000	0.07306	-0.10173	9	0	0	11	4	0	0.00000	0.00000
58	239720000	Tear of meniscus of knee	119	275272006	Brain damage - traumatic	1095	20	4	0	20	4	1071	0.00000	-0.00826	0.00000	0.00000	0.00000	1.0000000000	1.0000000000	0.07306	-0.10173	10	0	0	10	4	0	0.00000	0.00000
57	192127007	Child attention deficit disorder	119	275272006	Brain damage - traumatic	1095	76	4	1	75	3	1016	3.60197	0.04303	4.51556	43.93983	0.46405	0.2503433784	0.9133257124	0.27763	0.64653	24	0	0	52	4	1	-1.60944	-3.97029
56	92691004	Carcinoma in situ of prostate (disorder)	119	275272006	Brain damage - traumatic	1095	23	4	2	21	2	1070	23.80435	0.20226	50.95238	379.12866	6.84766	0.0024698933	0.0514981546	0.08402	1.46857	0	0	0	23	4	2	-1.09861	-2.52573
54	5602001	Opioid abuse (disorder)	119	275272006	Brain damage - traumatic	1095	7	4	0	7	4	1084	0.00000	-0.00486	0.00000	0.00000	0.00000	1.0000000000	1.0000000000	0.02557	-0.03643	0	0	0	7	4	0	0.00000	0.00000
53	7200002	Alcoholism	119	275272006	Brain damage - traumatic	1095	5	4	0	5	4	1086	0.00000	-0.00410	0.00000	0.00000	0.00000	1.0000000000	1.0000000000	0.01826	-0.02611	0	0	0	5	4	0	0.00000	0.00000
52	124171000119105	Chronic intractable migraine without aura	119	275272006	Brain damage - traumatic	1095	51	4	0	51	4	1040	0.00000	-0.01338	0.00000	0.00000	0.00000	1.0000000000	1.0000000000	0.18630	-0.24647	21	0	0	30	4	0	0.00000	0.00000
50	446096008	Perennial allergic rhinitis	119	275272006	Brain damage - traumatic	1095	26	4	0	26	4	1065	0.00000	-0.00944	0.00000	0.00000	0.00000	1.0000000000	1.0000000000	0.09498	-0.13090	14	0	0	12	4	0	0.00000	0.00000
49	88805009	Chronic congestive heart failure (disorder)	119	275272006	Brain damage - traumatic	1095	10	4	0	10	4	1081	0.00000	-0.00581	0.00000	0.00000	0.00000	1.0000000000	1.0000000000	0.03653	-0.05176	5	0	0	5	4	0	0.00000	0.00000
47	359817006	Closed fracture of hip	119	275272006	Brain damage - traumatic	1095	29	4	0	29	4	1062	0.00000	-0.00999	0.00000	0.00000	0.00000	1.0000000000	1.0000000000	0.10594	-0.14527	11	0	0	18	4	0	0.00000	0.00000
46	62564004	Concussion with loss of consciousness	119	275272006	Brain damage - traumatic	1095	67	4	0	67	4	1024	0.00000	-0.01546	0.00000	0.00000	0.00000	1.0000000000	1.0000000000	0.24475	-0.31585	36	0	0	31	4	0	0.00000	0.00000
45	263102004	Fracture subluxation of wrist	119	275272006	Brain damage - traumatic	1095	109	4	1	108	3	983	2.51147	0.03043	3.03395	29.42206	0.31286	0.3429664897	1.0000000000	0.39817	0.51646	51	0	0	58	4	1	-1.60944	-4.07754
44	58150001	Fracture of clavicle	119	275272006	Brain damage - traumatic	1095	112	4	2	110	2	981	4.88839	0.07947	8.91818	63.93976	1.24389	0.0542246756	0.4511698599	0.40913	1.09016	55	0	0	57	4	2	-1.09861	-3.38439
43	307731004	Injury of tendon of the rotator cuff of shoulder	119	275272006	Brain damage - traumatic	1095	51	4	0	51	4	1040	0.00000	-0.01338	0.00000	0.00000	0.00000	1.0000000000	1.0000000000	0.18630	-0.24647	26	0	0	25	4	0	0.00000	0.00000
42	16114001	Fracture of ankle	119	275272006	Brain damage - traumatic	1095	108	4	0	108	4	983	0.00000	-0.02003	0.00000	0.00000	0.00000	1.0000000000	1.0000000000	0.39452	-0.47977	48	0	0	60	4	0	0.00000	0.00000
41	283385000	Laceration of thigh	119	275272006	Brain damage - traumatic	1095	105	4	0	105	4	986	0.00000	-0.01972	0.00000	0.00000	0.00000	1.0000000000	1.0000000000	0.38356	-0.46839	50	0	0	55	4	0	0.00000	0.00000
40	428251008	History of appendectomy	119	275272006	Brain damage - traumatic	1095	51	4	0	51	4	1040	0.00000	-0.01338	0.00000	0.00000	0.00000	1.0000000000	1.0000000000	0.18630	-0.24647	27	0	0	24	4	0	0.00000	0.00000
39	74400008	Appendicitis	119	275272006	Brain damage - traumatic	1095	51	4	0	51	4	1040	0.00000	-0.01338	0.00000	0.00000	0.00000	1.0000000000	1.0000000000	0.18630	-0.24647	27	0	0	24	4	0	0.00000	0.00000
38	398254007	Preeclampsia	119	275272006	Brain damage - traumatic	1095	101	4	0	101	4	990	0.00000	-0.01930	0.00000	0.00000	0.00000	1.0000000000	1.0000000000	0.36895	-0.45307	101	0	0	0	4	0	0.00000	0.00000
35	19169002	Miscarriage in first trimester	119	275272006	Brain damage - traumatic	1095	174	4	0	174	4	917	0.00000	-0.02632	0.00000	0.00000	0.00000	1.0000000000	1.0000000000	0.63562	-0.70983	174	0	0	0	4	0	0.00000	0.00000
33	429007001	History of cardiac arrest (situation)	119	275272006	Brain damage - traumatic	1095	42	4	1	41	3	1050	6.51786	0.06673	8.53659	83.84267	0.86917	0.1450083278	0.7430724470	0.15342	0.79408	24	0	0	18	4	1	-1.60944	-2.94444
32	410429000	Cardiac Arrest	119	275272006	Brain damage - traumatic	1095	42	4	1	41	3	1050	6.51786	0.06673	8.53659	83.84267	0.86917	0.1450083278	0.7430724470	0.15342	0.79408	24	0	0	18	4	1	-1.60944	-2.94444
30	399211009	History of myocardial infarction (situation)	119	275272006	Brain damage - traumatic	1095	31	4	0	31	4	1060	0.00000	-0.01034	0.00000	0.00000	0.00000	1.0000000000	1.0000000000	0.11324	-0.15477	2	0	0	29	4	0	0.00000	0.00000
29	22298006	Myocardial Infarction	119	275272006	Brain damage - traumatic	1095	31	4	0	31	4	1060	0.00000	-0.01034	0.00000	0.00000	0.00000	1.0000000000	1.0000000000	0.11324	-0.15477	2	0	0	29	4	0	0.00000	0.00000
28	53741008	Coronary Heart Disease	119	275272006	Brain damage - traumatic	1095	80	4	0	80	4	1011	0.00000	-0.01700	0.00000	0.00000	0.00000	1.0000000000	1.0000000000	0.29224	-0.36987	24	0	0	56	4	0	0.00000	0.00000
27	408512008	Body mass index 40+ - severely obese (finding)	119	275272006	Brain damage - traumatic	1095	97	4	0	97	4	994	0.00000	-0.01888	0.00000	0.00000	0.00000	1.0000000000	1.0000000000	0.35434	-0.43759	67	0	0	30	4	0	0.00000	0.00000
26	33737001	Fracture of rib	119	275272006	Brain damage - traumatic	1095	54	4	0	54	4	1037	0.00000	-0.01379	0.00000	0.00000	0.00000	1.0000000000	1.0000000000	0.19726	-0.25974	32	0	0	22	4	0	0.00000	0.00000
24	162864005	Body mass index 30+ - obesity (finding)	119	275272006	Brain damage - traumatic	1095	439	4	3	436	1	655	1.87073	0.04313	4.50688	43.46776	0.46729	0.3081720540	0.9989417613	1.60365	0.61946	226	0	0	213	4	3	-0.84730	-4.27667
23	36971009	Sinusitis (disorder)	119	275272006	Brain damage - traumatic	1095	190	4	0	190	4	901	0.00000	-0.02774	0.00000	0.00000	0.00000	1.0000000000	1.0000000000	0.69406	-0.76049	84	0	0	106	4	0	0.00000	0.00000
21	15777000	Prediabetes	119	275272006	Brain damage - traumatic	1095	333	4	2	331	2	760	1.64414	0.02578	2.29607	16.36937	0.32206	0.5894337899	1.0000000000	1.21644	0.43672	159	0	0	174	4	2	-1.09861	-4.47734
20	80394007	Hyperglycemia (disorder)	119	275272006	Brain damage - traumatic	1095	55	4	0	55	4	1036	0.00000	-0.01392	0.00000	0.00000	0.00000	1.0000000000	1.0000000000	0.20091	-0.26413	23	0	0	32	4	0	0.00000	0.00000
19	237602007	Metabolic syndrome X (disorder)	119	275272006	Brain damage - traumatic	1095	64	4	0	64	4	1027	0.00000	-0.01509	0.00000	0.00000	0.00000	1.0000000000	1.0000000000	0.23379	-0.30310	28	0	0	36	4	0	0.00000	0.00000
18	302870006	Hypertriglyceridemia (disorder)	119	275272006	Brain damage - traumatic	1095	64	4	0	64	4	1027	0.00000	-0.01509	0.00000	0.00000	0.00000	1.0000000000	1.0000000000	0.23379	-0.30310	28	0	0	36	4	0	0.00000	0.00000
17	368581000119106	Neuropathy due to type 2 diabetes mellitus (disorder)	119	275272006	Brain damage - traumatic	1095	28	4	0	28	4	1063	0.00000	-0.00981	0.00000	0.00000	0.00000	1.0000000000	1.0000000000	0.10228	-0.14049	7	0	0	21	4	0	0.00000	0.00000
15	40055000	Chronic sinusitis (disorder)	119	275272006	Brain damage - traumatic	1095	216	4	3	213	1	878	3.80208	0.08411	12.36620	119.47255	1.27998	0.0259193512	0.2928186163	0.78904	1.16081	104	0	0	112	4	3	-0.84730	-3.64632
14	10509002	Acute bronchitis (disorder)	119	275272006	Brain damage - traumatic	1095	863	4	4	859	0	232	1.26883	0.03139	0.00000	0.00000	0.00000	0.5842857155	1.0000000000	3.15251	0.26794	418	0	0	445	4	4	-0.69315	-4.72073
13	370247008	Facial laceration	119	275272006	Brain damage - traumatic	1095	109	4	0	109	4	982	0.00000	-0.02013	0.00000	0.00000	0.00000	1.0000000000	1.0000000000	0.39817	-0.48354	55	0	0	54	4	0	0.00000	0.00000
125	1734006	Fracture of the vertebral column with spinal cord injury	93	128613002	Seizure disorder	1095	5	39	0	5	39	1051	0.00000	-0.01302	0.00000	0.00000	0.00000	1.0000000000	1.0000000000	0.17808	-0.23644	3	14	0	2	25	0	0.00000	0.00000
10	62106007	Concussion with no loss of consciousness	119	275272006	Brain damage - traumatic	1095	206	4	1	205	3	886	1.32888	0.00959	1.44065	13.92048	0.14909	0.5660918305	1.0000000000	0.75251	0.19058	96	0	0	110	4	1	-1.60944	-4.70953
9	44465007	Sprain of ankle	119	275272006	Brain damage - traumatic	1095	362	4	1	361	3	730	0.75622	-0.01037	0.67405	6.50284	0.06987	1.0000000000	1.0000000000	1.32237	-0.21560	185	0	0	177	4	1	-1.60944	-5.18178
8	233678006	Childhood asthma	119	275272006	Brain damage - traumatic	1095	45	4	0	45	4	1046	0.00000	-0.01254	0.00000	0.00000	0.00000	1.0000000000	1.0000000000	0.16438	-0.21957	25	0	0	20	4	0	0.00000	0.00000
7	75498004	Acute bacterial sinusitis (disorder)	119	275272006	Brain damage - traumatic	1095	187	4	2	185	2	906	2.92781	0.05297	4.89730	34.98846	0.68547	0.1373791614	0.7296699408	0.68311	0.83384	89	0	0	98	4	2	-1.09861	-3.91202
6	39848009	Whiplash injury to neck	119	275272006	Brain damage - traumatic	1095	182	4	0	182	4	909	0.00000	-0.02703	0.00000	0.00000	0.00000	1.0000000000	1.0000000000	0.66484	-0.73538	92	0	0	90	4	0	0.00000	0.00000
5	284549007	Laceration of hand	119	275272006	Brain damage - traumatic	1095	104	4	1	103	3	988	2.63221	0.03202	3.19741	31.01888	0.32959	0.3295168874	1.0000000000	0.37991	0.53543	54	0	0	50	4	1	-1.60944	-3.93183
3	65363002	Otitis media	119	275272006	Brain damage - traumatic	1095	580	4	1	579	3	512	0.47198	-0.03393	0.29476	2.84256	0.03057	0.3473031964	1.0000000000	2.11872	-0.64095	277	0	0	303	4	1	-1.60944	-5.71703
1	444814009	Viral sinusitis (disorder)	119	275272006	Brain damage - traumatic	1095	993	4	4	989	0	102	1.10272	0.01941	0.00000	0.00000	0.00000	1.0000000000	1.0000000000	3.62740	0.11173	478	0	0	515	4	4	-0.69315	-4.86561
96	283371005	Laceration of forearm	93	128613002	Seizure disorder	1095	75	39	2	73	37	983	0.74872	-0.01309	0.72788	3.08015	0.17201	1.0000000000	1.0000000000	2.67123	-0.29130	39	14	0	36	25	2	-2.60269	-2.94444
94	703151001	History of single seizure (situation)	93	128613002	Seizure disorder	1095	39	39	39	0	0	1056	28.07692	1.00000	0.00000	0.00000	0.00000	0.0000000000	0.0000000000	1.38904	4.06550	14	14	14	25	25	25	0.00000	0.00000
86	713197008	Recurrent rectal polyp	93	128613002	Seizure disorder	1095	22	39	1	21	38	1035	1.27622	0.00760	1.29699	9.89561	0.16999	0.5532483632	1.0000000000	0.78356	0.16524	12	14	0	10	25	1	-3.25810	-2.39790
75	431855005	Chronic kidney disease stage 1 (disorder)	93	128613002	Seizure disorder	1095	28	39	2	26	37	1030	2.00549	0.03130	2.14137	9.36132	0.48983	0.2629676428	0.9285317652	0.99726	0.58694	10	14	0	18	25	2	-2.60269	-2.30259
118	48333001	Burn injury(morphologic abnormality)	95	84757009	Epilepsy	1095	1	30	0	1	30	1064	0.00000	-0.00507	0.00000	0.00000	0.00000	1.0000000000	1.0000000000	0.02740	-0.03899	0	13	0	1	17	0	0.00000	0.00000
64	444448004	Injury of medial collateral ligament of knee	93	128613002	Seizure disorder	1095	32	39	0	32	39	1024	0.00000	-0.03334	0.00000	0.00000	0.00000	0.6249631818	1.0000000000	1.13973	-1.09743	17	14	0	15	25	0	0.00000	0.00000
120	162573006	Suspected lung cancer (situation)	95	84757009	Epilepsy	1095	8	30	1	7	29	1058	4.56250	0.05129	5.21182	43.74820	0.62090	0.1998532808	0.8434192785	0.21918	0.71409	0	13	0	8	17	1	-2.89037	-2.19722
47	359817006	Closed fracture of hip	93	128613002	Seizure disorder	1095	29	39	1	28	38	1028	0.96817	-0.00101	0.96617	7.28884	0.12807	1.0000000000	1.0000000000	1.03288	-0.02352	11	14	1	18	25	0	2.70805	2.48491
44	58150001	Fracture of clavicle	93	128613002	Seizure disorder	1095	112	39	3	109	36	947	0.75206	-0.01608	0.72401	2.39027	0.21930	0.7900489739	1.0000000000	3.98904	-0.31876	55	14	1	57	25	2	0.10536	0.64096
43	307731004	Injury of tendon of the rotator cuff of shoulder	93	128613002	Seizure disorder	1095	51	39	3	48	36	1008	1.65158	0.02768	1.75000	5.88543	0.52035	0.4218296554	1.0000000000	1.81644	0.50613	26	14	0	25	25	3	-2.23359	-2.23359
42	16114001	Fracture of ankle	93	128613002	Seizure disorder	1095	108	39	6	102	33	954	1.55983	0.03559	1.70053	4.15554	0.69589	0.2663999274	0.9357378021	3.84658	0.53039	48	14	2	60	25	4	0.09844	0.44629
41	283385000	Laceration of thigh	93	128613002	Seizure disorder	1095	105	39	2	103	37	953	0.53480	-0.02912	0.50013	2.10525	0.11881	0.5755027849	1.0000000000	3.73973	-0.65984	50	14	0	55	25	2	-2.60269	-3.34990
38	398254007	Preeclampsia	93	128613002	Seizure disorder	1095	101	39	3	98	36	958	0.83397	-0.01017	0.81463	2.69384	0.24635	1.0000000000	1.0000000000	3.59726	-0.20077	101	14	3	0	25	0	1.73460	3.54578
35	19169002	Miscarriage in first trimester	93	128613002	Seizure disorder	1095	174	39	3	171	36	885	0.48408	-0.04309	0.43129	1.41642	0.13132	0.1847241719	0.8181443419	6.19726	-0.84745	174	14	3	0	25	0	1.73460	4.07754
33	429007001	History of cardiac arrest (situation)	93	128613002	Seizure disorder	1095	42	39	3	39	36	1017	2.00549	0.03859	2.17308	7.36386	0.64128	0.1850424915	0.8181443419	1.49589	0.68045	24	14	0	18	25	3	-2.23359	-1.94591
32	410429000	Cardiac Arrest	93	128613002	Seizure disorder	1095	42	39	3	39	36	1017	2.00549	0.03859	2.17308	7.36386	0.64128	0.1850424915	0.8181443419	1.49589	0.68045	24	14	0	18	25	3	-2.23359	-1.94591
27	408512008	Body mass index 40+ - severely obese (finding)	93	128613002	Seizure disorder	1095	97	39	1	96	38	960	0.28945	-0.04257	0.26316	1.93797	0.03573	0.2471345174	0.9133257124	3.45479	-1.15536	67	14	1	30	25	0	2.70805	4.21951
21	15777000	Prediabetes	93	128613002	Seizure disorder	1095	333	39	6	327	33	729	0.50589	-0.06277	0.40534	0.97682	0.16820	0.0494438214	0.4284480396	11.86027	-0.87749	159	14	3	174	25	3	-0.49899	-0.08855
130	314994000	Metastasis from malignant tumor of prostate (disorder)	67	403191005	Second degree burn	1095	1	49	0	1	49	1045	0.00000	-0.00654	0.00000	0.00000	0.00000	1.0000000000	1.0000000000	0.04475	-0.06316	0	23	0	1	26	0	0.00000	0.00000
15	40055000	Chronic sinusitis (disorder)	93	128613002	Seizure disorder	1095	216	39	6	210	33	846	0.77991	-0.02097	0.73247	1.77101	0.30294	0.6813597339	1.0000000000	7.69315	-0.31252	104	14	3	112	25	3	-0.49899	-0.07210
14	10509002	Acute bronchitis (disorder)	93	128613002	Seizure disorder	1095	863	39	32	831	7	225	1.04109	0.01523	1.23775	2.84133	0.53919	0.6949029691	1.0000000000	30.73699	0.05630	418	14	11	445	25	21	0.03686	0.56390
125	1734006	Fracture of the vertebral column with spinal cord injury	67	403191005	Second degree burn	1095	5	49	0	5	49	1041	0.00000	-0.01466	0.00000	0.00000	0.00000	1.0000000000	1.0000000000	0.22374	-0.29130	3	23	0	2	26	0	0.00000	0.00000
118	48333001	Burn injury(morphologic abnormality)	67	403191005	Second degree burn	1095	1	49	0	1	49	1045	0.00000	-0.00654	0.00000	0.00000	0.00000	1.0000000000	1.0000000000	0.04475	-0.06316	0	23	0	1	26	0	0.00000	0.00000
117	230265002	Familial Alzheimer's disease of early onset (disorder)	67	403191005	Second degree burn	1095	6	49	0	6	49	1040	0.00000	-0.01607	0.00000	0.00000	0.00000	1.0000000000	1.0000000000	0.26849	-0.34312	2	23	0	4	26	0	0.00000	0.00000
109	90560007	Gout	67	403191005	Second degree burn	1095	4	49	0	4	49	1042	0.00000	-0.01311	0.00000	0.00000	0.00000	1.0000000000	1.0000000000	0.17900	-0.23756	0	23	0	4	26	0	0.00000	0.00000
102	90781000119102	Microalbuminuria due to type 2 diabetes mellitus (disorder)	67	403191005	Second degree burn	1095	6	49	1	5	48	1041	3.72449	0.04377	4.33750	37.85423	0.49701	0.2406784239	0.9095097439	0.26849	0.65688	3	23	1	3	26	0	3.17805	1.38629
98	1551000119108	Nonproliferative diabetic retinopathy due to type 2 diabetes mellitus (disorder)	67	403191005	Second degree burn	1095	12	49	1	11	48	1035	1.86224	0.01964	1.96023	15.49521	0.24798	0.4243272428	1.0000000000	0.53699	0.37990	7	23	0	5	26	1	-3.29584	-1.79176
97	403192003	Third degree burn	67	403191005	Second degree burn	1095	8	49	0	8	49	1038	0.00000	-0.01857	0.00000	0.00000	0.00000	1.0000000000	1.0000000000	0.35799	-0.44147	3	23	0	5	26	0	0.00000	0.00000
96	283371005	Laceration of forearm	67	403191005	Second degree burn	1095	75	49	6	69	43	977	1.78776	0.04623	1.97573	4.80329	0.81268	0.1403091566	0.7366230723	3.35616	0.68430	39	23	4	36	26	2	-0.72951	-0.56953
94	703151001	History of single seizure (situation)	67	403191005	Second degree burn	1095	39	49	3	36	46	1010	1.71900	0.02991	1.82971	6.16231	0.54328	0.2516174978	0.9133257124	1.74521	0.54309	14	23	0	25	26	3	-2.26868	-2.23359
93	128613002	Seizure disorder	67	403191005	Second degree burn	1095	39	49	3	36	46	1010	1.71900	0.02991	1.82971	6.16231	0.54328	0.2516174978	0.9133257124	1.74521	0.54309	14	23	0	25	26	3	-2.26868	-2.23359
89	47693006	Rupture of appendix	67	403191005	Second degree burn	1095	20	49	2	18	47	1028	2.23469	0.03645	2.43026	10.78156	0.54780	0.2241913097	0.8794911525	0.89498	0.66278	10	23	1	10	26	1	-0.11778	0.00000
86	713197008	Recurrent rectal polyp	67	403191005	Second degree burn	1095	22	49	1	21	48	1025	1.01577	0.00049	1.01687	7.71825	0.13397	1.0000000000	1.0000000000	0.98447	0.01124	12	23	1	10	26	0	3.17805	2.56495
75	431855005	Chronic kidney disease stage 1 (disorder)	67	403191005	Second degree burn	1095	28	49	2	26	47	1020	1.59621	0.02090	1.66939	7.24351	0.38474	0.3594523324	1.0000000000	1.25297	0.41314	10	23	1	18	26	1	-0.11778	-0.54654
69	233604007	Pneumonia	67	403191005	Second degree burn	1095	7	49	1	6	48	1040	3.19242	0.03806	3.61111	30.59094	0.42627	0.2748444085	0.9503524867	0.31324	0.60687	3	23	1	4	26	0	3.17805	1.38629
64	444448004	Injury of medial collateral ligament of knee	67	403191005	Second degree burn	1095	32	49	1	31	48	1015	0.69834	-0.01133	0.68212	5.10244	0.09119	1.0000000000	1.0000000000	1.43196	-0.28212	17	23	1	15	26	0	3.17805	2.89037
63	68496003	Polyp of colon	67	403191005	Second degree burn	1095	91	49	7	84	42	962	1.71900	0.04685	1.90873	4.38015	0.83176	0.1772450512	0.8029498763	4.07215	0.65740	43	23	3	48	26	4	0.14458	0.16508
49	88805009	Chronic congestive heart failure (disorder)	67	403191005	Second degree burn	1095	10	49	2	8	47	1038	4.46939	0.07209	5.52128	26.72037	1.14087	0.0701885852	0.5212482239	0.44749	1.05141	5	23	1	5	26	1	-0.11778	0.00000
47	359817006	Closed fracture of hip	67	403191005	Second degree burn	1095	29	49	1	28	48	1018	0.77058	-0.00819	0.75744	5.68452	0.10093	1.0000000000	1.0000000000	1.29772	-0.20020	11	23	0	18	26	1	-3.29584	-2.94444
44	58150001	Fracture of clavicle	67	403191005	Second degree burn	1095	112	49	6	106	43	940	1.19716	0.01440	1.23738	2.97560	0.51456	0.6276288483	1.0000000000	5.01187	0.21954	55	23	3	57	26	3	-0.10920	-0.03390
43	307731004	Injury of tendon of the rotator cuff of shoulder	67	403191005	Second degree burn	1095	51	49	3	48	46	998	1.31453	0.01505	1.35598	4.51679	0.40708	0.4939703825	1.0000000000	2.28219	0.28534	26	23	1	25	26	2	0.53900	0.69315
42	16114001	Fracture of ankle	67	403191005	Second degree burn	1095	108	49	5	103	44	943	1.03458	0.00248	1.04038	2.68229	0.40353	0.8096666592	1.0000000000	4.83288	0.04075	48	23	3	60	26	2	-0.47957	-0.60077
41	283385000	Laceration of thigh	67	403191005	Second degree burn	1095	105	49	6	99	43	947	1.27697	0.01952	1.33474	3.21435	0.55425	0.4598951198	1.0000000000	4.69863	0.29674	50	23	4	55	26	2	-0.72951	-0.74721
39	74400008	Appendicitis	67	403191005	Second degree burn	1095	51	49	3	48	46	998	1.31453	0.01505	1.35598	4.51679	0.40708	0.4939703825	1.0000000000	2.28219	0.28534	27	23	1	24	26	2	0.53900	0.76726
38	398254007	Preeclampsia	67	403191005	Second degree burn	1095	101	49	7	94	42	952	1.54880	0.03786	1.68794	3.86224	0.73769	0.2058090317	0.8544076578	4.51963	0.53543	101	23	7	0	26	0	1.45529	2.73622
35	19169002	Miscarriage in first trimester	67	403191005	Second degree burn	1095	174	49	10	164	39	882	1.28431	0.02675	1.37899	2.81733	0.67497	0.4216659212	1.0000000000	7.78630	0.32418	174	23	10	0	26	0	1.19392	2.91235
33	429007001	History of cardiac arrest (situation)	67	403191005	Second degree burn	1095	42	49	2	40	47	1006	1.06414	0.00277	1.07021	4.56216	0.25106	0.7117336087	1.0000000000	1.87945	0.05917	24	23	1	18	26	1	-0.11778	0.27444
32	410429000	Cardiac Arrest	67	403191005	Second degree burn	1095	42	49	2	40	47	1006	1.06414	0.00277	1.07021	4.56216	0.25106	0.7117336087	1.0000000000	1.87945	0.05917	24	23	1	18	26	1	-0.11778	0.27444
27	408512008	Body mass index 40+ - severely obese (finding)	67	403191005	Second degree burn	1095	97	49	4	93	45	953	0.92152	-0.00530	0.91087	2.58879	0.32049	1.0000000000	1.0000000000	4.34064	-0.09508	67	23	3	30	26	1	-1.13635	-0.28410
21	15777000	Prediabetes	67	403191005	Second degree burn	1095	333	49	18	315	31	731	1.20794	0.02975	1.34747	2.44455	0.74274	0.3418237202	1.0000000000	14.90137	0.25685	159	23	7	174	26	11	0.24226	0.34362
20	80394007	Hyperglycemia (disorder)	67	403191005	Second degree burn	1095	55	49	5	50	44	996	2.03154	0.05134	2.26364	5.95714	0.86015	0.0937600109	0.6065035930	2.46119	0.79370	23	23	2	32	26	3	0.25705	0.06899
18	302870006	Hypertriglyceridemia (disorder)	67	403191005	Second degree burn	1095	64	49	5	59	44	987	1.74585	0.04022	1.90100	4.97260	0.72674	0.2011812805	0.8478009028	2.86393	0.63489	28	23	2	36	26	3	0.25705	0.14310
15	40055000	Chronic sinusitis (disorder)	67	403191005	Second degree burn	1095	216	49	11	205	38	841	1.13804	0.01481	1.18755	2.36338	0.59672	0.5851173409	1.0000000000	9.66575	0.17005	104	23	4	112	26	7	0.35895	0.46262
14	10509002	Acute bronchitis (disorder)	67	403191005	Second degree burn	1095	863	49	44	819	5	227	1.13936	0.05817	2.43907	6.22276	0.95602	0.0714299313	0.5260167260	38.61826	0.18376	418	23	21	445	26	23	-0.01666	0.02700
125	1734006	Fracture of the vertebral column with spinal cord injury	41	283385000	Laceration of thigh	1095	5	105	1	4	104	986	2.08571	0.02395	2.37019	21.40399	0.26247	0.3964913401	1.0000000000	0.47945	0.43494	3	50	0	2	55	1	-4.02535	-1.09861
10	62106007	Concussion with no loss of consciousness	67	403191005	Second degree burn	1095	206	49	11	195	38	851	1.19328	0.02014	1.26329	2.51578	0.63436	0.4603111193	1.0000000000	9.21826	0.23188	96	23	4	110	26	7	0.35895	0.40261
6	39848009	Whiplash injury to neck	67	403191005	Second degree burn	1095	182	49	7	175	42	871	0.85950	-0.01358	0.82952	1.87678	0.36664	0.8442267353	1.0000000000	8.14429	-0.19287	92	23	5	90	26	2	-0.91629	-0.86337
118	48333001	Burn injury(morphologic abnormality)	41	283385000	Laceration of thigh	1095	1	105	0	1	105	989	0.00000	-0.00985	0.00000	0.00000	0.00000	1.0000000000	1.0000000000	0.09589	-0.13210	0	50	0	1	55	0	0.00000	0.00000
96	283371005	Laceration of forearm	41	283385000	Laceration of thigh	1095	75	105	11	64	94	926	1.52952	0.04676	1.69315	3.32205	0.86295	0.1506586350	0.7635574469	7.19178	0.55079	39	50	6	36	55	5	-0.25131	-0.08923
94	703151001	History of single seizure (situation)	41	283385000	Laceration of thigh	1095	39	105	2	37	103	953	0.53480	-0.02912	0.50013	2.10525	0.11881	0.5755027849	1.0000000000	3.73973	-0.65984	14	50	0	25	55	2	-3.34990	-2.60269
75	431855005	Chronic kidney disease stage 1 (disorder)	41	283385000	Laceration of thigh	1095	28	105	6	22	99	968	2.23469	0.06514	2.66667	6.73226	1.05627	0.0441223378	0.4038643180	2.68493	0.92572	10	50	2	18	55	4	0.56685	0.08701
44	58150001	Fracture of clavicle	41	283385000	Laceration of thigh	1095	112	105	11	101	94	889	1.02423	0.00266	1.03002	1.98811	0.53364	0.8664764624	1.0000000000	10.73973	0.03164	55	50	7	57	55	4	-0.59410	-0.54336
42	16114001	Fracture of ankle	41	283385000	Laceration of thigh	1095	108	105	11	97	94	893	1.06217	0.00670	1.07732	2.08186	0.55749	0.8629605976	1.0000000000	10.35616	0.07956	48	50	5	60	55	6	0.07878	-0.03704
33	429007001	History of cardiac arrest (situation)	41	283385000	Laceration of thigh	1095	42	105	5	37	100	953	1.24150	0.01571	1.28784	3.35111	0.49492	0.5902468084	1.0000000000	4.02740	0.25515	24	50	2	18	55	3	0.29627	0.61904
15	40055000	Chronic sinusitis (disorder)	41	283385000	Laceration of thigh	1095	216	105	25	191	80	799	1.20701	0.03342	1.30726	2.10425	0.81214	0.3014848842	0.9930335136	20.71233	0.26000	104	50	15	112	55	10	-0.40547	-0.43036
118	48333001	Burn injury(morphologic abnormality)	15	40055000	Chronic sinusitis (disorder)	1095	1	216	0	1	216	878	0.00000	-0.01499	0.00000	0.00000	0.00000	1.0000000000	1.0000000000	0.19726	-0.25974	0	104	0	1	112	0	0.00000	0.00000
114	449868002	Smokes tobacco daily	85	241929008	Acute allergic reaction	1095	9	47	0	9	47	1039	0.00000	-0.01928	0.00000	0.00000	0.00000	1.0000000000	1.0000000000	0.38630	-0.47124	2	25	0	7	22	0	0.00000	0.00000
118	48333001	Burn injury(morphologic abnormality)	85	241929008	Acute allergic reaction	1095	1	47	0	1	47	1047	0.00000	-0.00640	0.00000	0.00000	0.00000	1.0000000000	1.0000000000	0.04292	-0.06063	0	25	0	1	22	0	0.00000	0.00000
120	162573006	Suspected lung cancer (situation)	85	241929008	Acute allergic reaction	1095	8	47	0	8	47	1040	0.00000	-0.01817	0.00000	0.00000	0.00000	1.0000000000	1.0000000000	0.34338	-0.42587	0	25	0	8	22	0	0.00000	0.00000
127	431856006	Chronic kidney disease stage 2 (disorder)	85	241929008	Acute allergic reaction	1095	5	47	1	4	46	1044	4.65957	0.05249	5.67391	51.77943	0.62174	0.1972922687	0.8369901977	0.21461	0.71950	3	25	1	2	22	0	3.25810	1.38629
128	86849004	Suicidal deliberate poisoning	85	241929008	Acute allergic reaction	1095	1	47	0	1	47	1047	0.00000	-0.00640	0.00000	0.00000	0.00000	1.0000000000	1.0000000000	0.04292	-0.06063	0	25	0	1	22	0	0.00000	0.00000
130	314994000	Metastasis from malignant tumor of prostate (disorder)	85	241929008	Acute allergic reaction	1095	1	47	0	1	47	1047	0.00000	-0.00640	0.00000	0.00000	0.00000	1.0000000000	1.0000000000	0.04292	-0.06063	0	25	0	1	22	0	0.00000	0.00000
128	86849004	Suicidal deliberate poisoning	60	301011002	Escherichia coli urinary tract infection	1095	1	92	0	1	92	1002	0.00000	-0.00916	0.00000	0.00000	0.00000	1.0000000000	1.0000000000	0.08402	-0.11639	0	85	0	1	7	0	0.00000	0.00000
118	48333001	Burn injury(morphologic abnormality)	30	399211009	History of myocardial infarction (situation)	1095	1	31	0	1	31	1063	0.00000	-0.00516	0.00000	0.00000	0.00000	1.0000000000	1.0000000000	0.02831	-0.04028	0	2	0	1	29	0	0.00000	0.00000
130	314994000	Metastasis from malignant tumor of prostate (disorder)	30	399211009	History of myocardial infarction (situation)	1095	1	31	0	1	31	1063	0.00000	-0.00516	0.00000	0.00000	0.00000	1.0000000000	1.0000000000	0.02831	-0.04028	0	2	0	1	29	0	0.00000	0.00000
130	314994000	Metastasis from malignant tumor of prostate (disorder)	128	86849004	Suicidal deliberate poisoning	1095	1	1	1	0	0	1094	1095.00000	1.00000	0.00000	0.00000	0.00000	0.0009132420	0.0231688970	0.00091	0.99868	0	0	0	1	1	1	-0.69315	-0.69315
129	47505003	Posttraumatic stress disorder	128	86849004	Suicidal deliberate poisoning	1095	4	1	1	3	0	1091	273.75000	0.49931	0.00000	0.00000	0.00000	0.0036529680	0.0707538718	0.00365	0.99474	1	0	0	3	1	1	-0.69315	-1.38629
125	1734006	Fracture of the vertebral column with spinal cord injury	128	86849004	Suicidal deliberate poisoning	1095	5	1	0	5	1	1089	0.00000	-0.00205	0.00000	0.00000	0.00000	1.0000000000	1.0000000000	0.00457	-0.00657	3	0	0	2	1	0	0.00000	0.00000
124	1501000119109	Proliferative diabetic retinopathy due to type II diabetes mellitus (disorder)	128	86849004	Suicidal deliberate poisoning	1095	1	1	0	1	1	1093	0.00000	-0.00091	0.00000	0.00000	0.00000	1.0000000000	1.0000000000	0.00091	-0.00132	1	0	0	0	1	0	0.00000	0.00000
118	48333001	Burn injury(morphologic abnormality)	94	703151001	History of single seizure (situation)	1095	1	39	0	1	39	1055	0.00000	-0.00581	0.00000	0.00000	0.00000	1.0000000000	1.0000000000	0.03562	-0.05049	0	14	0	1	25	0	0.00000	0.00000
118	48333001	Burn injury(morphologic abnormality)	128	86849004	Suicidal deliberate poisoning	1095	1	1	0	1	1	1093	0.00000	-0.00091	0.00000	0.00000	0.00000	1.0000000000	1.0000000000	0.00091	-0.00132	0	0	0	1	1	0	0.00000	0.00000
117	230265002	Familial Alzheimer's disease of early onset (disorder)	128	86849004	Suicidal deliberate poisoning	1095	6	1	0	6	1	1088	0.00000	-0.00224	0.00000	0.00000	0.00000	1.0000000000	1.0000000000	0.00548	-0.00788	2	0	0	4	1	0	0.00000	0.00000
115	36923009	Major depression  single episode	128	86849004	Suicidal deliberate poisoning	1095	6	1	0	6	1	1088	0.00000	-0.00224	0.00000	0.00000	0.00000	1.0000000000	1.0000000000	0.00548	-0.00788	3	0	0	3	1	0	0.00000	0.00000
114	449868002	Smokes tobacco daily	128	86849004	Suicidal deliberate poisoning	1095	9	1	0	9	1	1085	0.00000	-0.00275	0.00000	0.00000	0.00000	1.0000000000	1.0000000000	0.00822	-0.01181	2	0	0	7	1	0	0.00000	0.00000
111	235919008	Cholelithiasis	128	86849004	Suicidal deliberate poisoning	1095	9	1	0	9	1	1085	0.00000	-0.00275	0.00000	0.00000	0.00000	1.0000000000	1.0000000000	0.00822	-0.01181	7	0	0	2	1	0	0.00000	0.00000
109	90560007	Gout	128	86849004	Suicidal deliberate poisoning	1095	4	1	0	4	1	1090	0.00000	-0.00183	0.00000	0.00000	0.00000	1.0000000000	1.0000000000	0.00365	-0.00526	0	0	0	4	1	0	0.00000	0.00000
107	40275004	Contact dermatitis	128	86849004	Suicidal deliberate poisoning	1095	18	1	0	18	1	1076	0.00000	-0.00391	0.00000	0.00000	0.00000	1.0000000000	1.0000000000	0.01644	-0.02352	9	0	0	9	1	0	0.00000	0.00000
106	24079001	Atopic dermatitis	128	86849004	Suicidal deliberate poisoning	1095	20	1	0	20	1	1074	0.00000	-0.00412	0.00000	0.00000	0.00000	1.0000000000	1.0000000000	0.01826	-0.02611	13	0	0	7	1	0	0.00000	0.00000
102	90781000119102	Microalbuminuria due to type 2 diabetes mellitus (disorder)	128	86849004	Suicidal deliberate poisoning	1095	6	1	0	6	1	1088	0.00000	-0.00224	0.00000	0.00000	0.00000	1.0000000000	1.0000000000	0.00548	-0.00788	3	0	0	3	1	0	0.00000	0.00000
101	433144002	Chronic kidney disease stage 3 (disorder)	128	86849004	Suicidal deliberate poisoning	1095	3	1	0	3	1	1091	0.00000	-0.00158	0.00000	0.00000	0.00000	1.0000000000	1.0000000000	0.00274	-0.00395	1	0	0	2	1	0	0.00000	0.00000
100	161622006	History of lower limb amputation (situation)	128	86849004	Suicidal deliberate poisoning	1095	1	1	0	1	1	1093	0.00000	-0.00091	0.00000	0.00000	0.00000	1.0000000000	1.0000000000	0.00091	-0.00132	0	0	0	1	1	0	0.00000	0.00000
98	1551000119108	Nonproliferative diabetic retinopathy due to type 2 diabetes mellitus (disorder)	128	86849004	Suicidal deliberate poisoning	1095	12	1	0	12	1	1082	0.00000	-0.00318	0.00000	0.00000	0.00000	1.0000000000	1.0000000000	0.01096	-0.01572	7	0	0	5	1	0	0.00000	0.00000
97	403192003	Third degree burn	128	86849004	Suicidal deliberate poisoning	1095	8	1	0	8	1	1086	0.00000	-0.00259	0.00000	0.00000	0.00000	1.0000000000	1.0000000000	0.00731	-0.01050	3	0	0	5	1	0	0.00000	0.00000
96	283371005	Laceration of forearm	128	86849004	Suicidal deliberate poisoning	1095	75	1	1	74	0	1020	14.60000	0.11150	0.00000	0.00000	0.00000	0.0684931507	0.5135368799	0.06849	0.90442	39	0	0	36	1	1	-0.69315	-3.61092
94	703151001	History of single seizure (situation)	128	86849004	Suicidal deliberate poisoning	1095	39	1	0	39	1	1055	0.00000	-0.00581	0.00000	0.00000	0.00000	1.0000000000	1.0000000000	0.03562	-0.05049	14	0	0	25	1	0	0.00000	0.00000
93	128613002	Seizure disorder	128	86849004	Suicidal deliberate poisoning	1095	39	1	0	39	1	1055	0.00000	-0.00581	0.00000	0.00000	0.00000	1.0000000000	1.0000000000	0.03562	-0.05049	14	0	0	25	1	0	0.00000	0.00000
89	47693006	Rupture of appendix	128	86849004	Suicidal deliberate poisoning	1095	20	1	0	20	1	1074	0.00000	-0.00412	0.00000	0.00000	0.00000	1.0000000000	1.0000000000	0.01826	-0.02611	10	0	0	10	1	0	0.00000	0.00000
130	314994000	Metastasis from malignant tumor of prostate (disorder)	78	239872002	Osteoarthritis of hip	1095	1	21	0	1	21	1073	0.00000	-0.00423	0.00000	0.00000	0.00000	1.0000000000	1.0000000000	0.01918	-0.02741	0	13	0	1	8	0	0.00000	0.00000
86	713197008	Recurrent rectal polyp	128	86849004	Suicidal deliberate poisoning	1095	22	1	0	22	1	1072	0.00000	-0.00433	0.00000	0.00000	0.00000	1.0000000000	1.0000000000	0.02009	-0.02870	12	0	0	10	1	0	0.00000	0.00000
82	94260004	Secondary malignant neoplasm of colon	128	86849004	Suicidal deliberate poisoning	1095	4	1	0	4	1	1090	0.00000	-0.00183	0.00000	0.00000	0.00000	1.0000000000	1.0000000000	0.00365	-0.00526	2	0	0	2	1	0	0.00000	0.00000
78	239872002	Osteoarthritis of hip	128	86849004	Suicidal deliberate poisoning	1095	21	1	0	21	1	1073	0.00000	-0.00423	0.00000	0.00000	0.00000	1.0000000000	1.0000000000	0.01918	-0.02741	13	0	0	8	1	0	0.00000	0.00000
76	127013003	Diabetic renal disease (disorder)	128	86849004	Suicidal deliberate poisoning	1095	28	1	1	27	0	1067	39.10714	0.18664	0.00000	0.00000	0.00000	0.0255707763	0.2905941929	0.02557	0.96357	10	0	0	18	1	1	-0.69315	-2.94444
75	431855005	Chronic kidney disease stage 1 (disorder)	128	86849004	Suicidal deliberate poisoning	1095	28	1	1	27	0	1067	39.10714	0.18664	0.00000	0.00000	0.00000	0.0255707763	0.2905941929	0.02557	0.96357	10	0	0	18	1	1	-0.69315	-2.94444
72	35999006	Blighted ovum	128	86849004	Suicidal deliberate poisoning	1095	53	1	0	53	1	1041	0.00000	-0.00682	0.00000	0.00000	0.00000	1.0000000000	1.0000000000	0.04840	-0.06819	53	0	0	0	1	0	0.00000	0.00000
71	201834006	Localized  primary osteoarthritis of the hand	128	86849004	Suicidal deliberate poisoning	1095	28	1	0	28	1	1066	0.00000	-0.00490	0.00000	0.00000	0.00000	1.0000000000	1.0000000000	0.02557	-0.03643	19	0	0	9	1	0	0.00000	0.00000
70	87433001	Pulmonary emphysema (disorder)	128	86849004	Suicidal deliberate poisoning	1095	17	1	0	17	1	1077	0.00000	-0.00380	0.00000	0.00000	0.00000	1.0000000000	1.0000000000	0.01553	-0.02223	9	0	0	8	1	0	0.00000	0.00000
69	233604007	Pneumonia	128	86849004	Suicidal deliberate poisoning	1095	7	1	0	7	1	1087	0.00000	-0.00243	0.00000	0.00000	0.00000	1.0000000000	1.0000000000	0.00639	-0.00919	3	0	0	4	1	0	0.00000	0.00000
67	403191005	Second degree burn	128	86849004	Suicidal deliberate poisoning	1095	49	1	0	49	1	1045	0.00000	-0.00654	0.00000	0.00000	0.00000	1.0000000000	1.0000000000	0.04475	-0.06316	23	0	0	26	1	0	0.00000	0.00000
64	444448004	Injury of medial collateral ligament of knee	128	86849004	Suicidal deliberate poisoning	1095	32	1	0	32	1	1062	0.00000	-0.00525	0.00000	0.00000	0.00000	1.0000000000	1.0000000000	0.02922	-0.04156	17	0	0	15	1	0	0.00000	0.00000
63	68496003	Polyp of colon	128	86849004	Suicidal deliberate poisoning	1095	91	1	0	91	1	1003	0.00000	-0.00910	0.00000	0.00000	0.00000	1.0000000000	1.0000000000	0.08311	-0.11517	43	0	0	48	1	0	0.00000	0.00000
59	262574004	Bullet wound	128	86849004	Suicidal deliberate poisoning	1095	20	1	0	20	1	1074	0.00000	-0.00412	0.00000	0.00000	0.00000	1.0000000000	1.0000000000	0.01826	-0.02611	9	0	0	11	1	0	0.00000	0.00000
58	239720000	Tear of meniscus of knee	128	86849004	Suicidal deliberate poisoning	1095	20	1	0	20	1	1074	0.00000	-0.00412	0.00000	0.00000	0.00000	1.0000000000	1.0000000000	0.01826	-0.02611	10	0	0	10	1	0	0.00000	0.00000
57	192127007	Child attention deficit disorder	128	86849004	Suicidal deliberate poisoning	1095	76	1	0	76	1	1018	0.00000	-0.00826	0.00000	0.00000	0.00000	1.0000000000	1.0000000000	0.06941	-0.09681	24	0	0	52	1	0	0.00000	0.00000
56	92691004	Carcinoma in situ of prostate (disorder)	128	86849004	Suicidal deliberate poisoning	1095	23	1	0	23	1	1071	0.00000	-0.00443	0.00000	0.00000	0.00000	1.0000000000	1.0000000000	0.02100	-0.02999	0	0	0	23	1	0	0.00000	0.00000
54	5602001	Opioid abuse (disorder)	128	86849004	Suicidal deliberate poisoning	1095	7	1	0	7	1	1087	0.00000	-0.00243	0.00000	0.00000	0.00000	1.0000000000	1.0000000000	0.00639	-0.00919	0	0	0	7	1	0	0.00000	0.00000
52	124171000119105	Chronic intractable migraine without aura	128	86849004	Suicidal deliberate poisoning	1095	51	1	1	50	0	1044	21.47059	0.13679	0.00000	0.00000	0.00000	0.0465753425	0.4136336033	0.04658	0.93432	21	0	0	30	1	1	-0.69315	-3.43399
50	446096008	Perennial allergic rhinitis	128	86849004	Suicidal deliberate poisoning	1095	26	1	0	26	1	1068	0.00000	-0.00472	0.00000	0.00000	0.00000	1.0000000000	1.0000000000	0.02374	-0.03386	14	0	0	12	1	0	0.00000	0.00000
49	88805009	Chronic congestive heart failure (disorder)	128	86849004	Suicidal deliberate poisoning	1095	10	1	0	10	1	1084	0.00000	-0.00290	0.00000	0.00000	0.00000	1.0000000000	1.0000000000	0.00913	-0.01312	5	0	0	5	1	0	0.00000	0.00000
47	359817006	Closed fracture of hip	128	86849004	Suicidal deliberate poisoning	1095	29	1	0	29	1	1065	0.00000	-0.00499	0.00000	0.00000	0.00000	1.0000000000	1.0000000000	0.02648	-0.03771	11	0	0	18	1	0	0.00000	0.00000
45	263102004	Fracture subluxation of wrist	128	86849004	Suicidal deliberate poisoning	1095	109	1	0	109	1	985	0.00000	-0.01005	0.00000	0.00000	0.00000	1.0000000000	1.0000000000	0.09954	-0.13690	51	0	0	58	1	0	0.00000	0.00000
44	58150001	Fracture of clavicle	128	86849004	Suicidal deliberate poisoning	1095	112	1	0	112	1	982	0.00000	-0.01021	0.00000	0.00000	0.00000	1.0000000000	1.0000000000	0.10228	-0.14049	55	0	0	57	1	0	0.00000	0.00000
43	307731004	Injury of tendon of the rotator cuff of shoulder	128	86849004	Suicidal deliberate poisoning	1095	51	1	0	51	1	1043	0.00000	-0.00668	0.00000	0.00000	0.00000	1.0000000000	1.0000000000	0.04658	-0.06568	26	0	0	25	1	0	0.00000	0.00000
42	16114001	Fracture of ankle	128	86849004	Suicidal deliberate poisoning	1095	108	1	0	108	1	986	0.00000	-0.01000	0.00000	0.00000	0.00000	1.0000000000	1.0000000000	0.09863	-0.13571	48	0	0	60	1	0	0.00000	0.00000
41	283385000	Laceration of thigh	128	86849004	Suicidal deliberate poisoning	1095	105	1	1	104	0	990	10.42857	0.09284	0.00000	0.00000	0.00000	0.0958904110	0.6155535021	0.09589	0.86790	50	0	0	55	1	1	-0.69315	-4.02535
39	74400008	Appendicitis	128	86849004	Suicidal deliberate poisoning	1095	51	1	0	51	1	1043	0.00000	-0.00668	0.00000	0.00000	0.00000	1.0000000000	1.0000000000	0.04658	-0.06568	27	0	0	24	1	0	0.00000	0.00000
38	398254007	Preeclampsia	128	86849004	Suicidal deliberate poisoning	1095	101	1	0	101	1	993	0.00000	-0.00964	0.00000	0.00000	0.00000	1.0000000000	1.0000000000	0.09224	-0.12729	101	0	0	0	1	0	0.00000	0.00000
35	19169002	Miscarriage in first trimester	128	86849004	Suicidal deliberate poisoning	1095	174	1	0	174	1	920	0.00000	-0.01314	0.00000	0.00000	0.00000	1.0000000000	1.0000000000	0.15890	-0.21276	174	0	0	0	1	0	0.00000	0.00000
33	429007001	History of cardiac arrest (situation)	128	86849004	Suicidal deliberate poisoning	1095	42	1	0	42	1	1052	0.00000	-0.00604	0.00000	0.00000	0.00000	1.0000000000	1.0000000000	0.03836	-0.05430	24	0	0	18	1	0	0.00000	0.00000
32	410429000	Cardiac Arrest	128	86849004	Suicidal deliberate poisoning	1095	42	1	0	42	1	1052	0.00000	-0.00604	0.00000	0.00000	0.00000	1.0000000000	1.0000000000	0.03836	-0.05430	24	0	0	18	1	0	0.00000	0.00000
30	399211009	History of myocardial infarction (situation)	128	86849004	Suicidal deliberate poisoning	1095	31	1	0	31	1	1063	0.00000	-0.00516	0.00000	0.00000	0.00000	1.0000000000	1.0000000000	0.02831	-0.04028	2	0	0	29	1	0	0.00000	0.00000
29	22298006	Myocardial Infarction	128	86849004	Suicidal deliberate poisoning	1095	31	1	0	31	1	1063	0.00000	-0.00516	0.00000	0.00000	0.00000	1.0000000000	1.0000000000	0.02831	-0.04028	2	0	0	29	1	0	0.00000	0.00000
27	408512008	Body mass index 40+ - severely obese (finding)	128	86849004	Suicidal deliberate poisoning	1095	97	1	0	97	1	997	0.00000	-0.00943	0.00000	0.00000	0.00000	1.0000000000	1.0000000000	0.08858	-0.12245	67	0	0	30	1	0	0.00000	0.00000
24	162864005	Body mass index 30+ - obesity (finding)	128	86849004	Suicidal deliberate poisoning	1095	439	1	0	439	1	655	0.00000	-0.02473	0.00000	0.00000	0.00000	1.0000000000	1.0000000000	0.40091	-0.48637	226	0	0	213	1	0	0.00000	0.00000
23	36971009	Sinusitis (disorder)	128	86849004	Suicidal deliberate poisoning	1095	190	1	1	189	0	905	5.76316	0.06598	0.00000	0.00000	0.00000	0.1735159817	0.7996618359	0.17352	0.76916	84	0	0	106	1	1	-0.69315	-4.67283
21	15777000	Prediabetes	128	86849004	Suicidal deliberate poisoning	1095	333	1	0	333	1	761	0.00000	-0.01999	0.00000	0.00000	0.00000	1.0000000000	1.0000000000	0.30411	-0.38307	159	0	0	174	1	0	0.00000	0.00000
20	80394007	Hyperglycemia (disorder)	128	86849004	Suicidal deliberate poisoning	1095	55	1	1	54	0	1040	19.90909	0.13147	0.00000	0.00000	0.00000	0.0502283105	0.4320205543	0.05023	0.92930	23	0	0	32	1	1	-0.69315	-3.49651
19	237602007	Metabolic syndrome X (disorder)	128	86849004	Suicidal deliberate poisoning	1095	64	1	1	63	0	1031	17.10937	0.12135	0.00000	0.00000	0.00000	0.0584474886	0.4685406893	0.05845	0.91805	28	0	0	36	1	1	-0.69315	-3.61092
18	302870006	Hypertriglyceridemia (disorder)	128	86849004	Suicidal deliberate poisoning	1095	64	1	1	63	0	1031	17.10937	0.12135	0.00000	0.00000	0.00000	0.0584474886	0.4685406893	0.05845	0.91805	28	0	0	36	1	1	-0.69315	-3.61092
17	368581000119106	Neuropathy due to type 2 diabetes mellitus (disorder)	128	86849004	Suicidal deliberate poisoning	1095	28	1	0	28	1	1066	0.00000	-0.00490	0.00000	0.00000	0.00000	1.0000000000	1.0000000000	0.02557	-0.03643	7	0	0	21	1	0	0.00000	0.00000
15	40055000	Chronic sinusitis (disorder)	128	86849004	Suicidal deliberate poisoning	1095	216	1	0	216	1	878	0.00000	-0.01499	0.00000	0.00000	0.00000	1.0000000000	1.0000000000	0.19726	-0.25974	104	0	0	112	1	0	0.00000	0.00000
14	10509002	Acute bronchitis (disorder)	128	86849004	Suicidal deliberate poisoning	1095	863	1	1	862	0	232	1.26883	0.01568	0.00000	0.00000	0.00000	1.0000000000	1.0000000000	0.78813	0.16155	418	0	0	445	1	1	-0.69315	-6.10032
13	370247008	Facial laceration	128	86849004	Suicidal deliberate poisoning	1095	109	1	0	109	1	985	0.00000	-0.01005	0.00000	0.00000	0.00000	1.0000000000	1.0000000000	0.09954	-0.13690	55	0	0	54	1	0	0.00000	0.00000
125	1734006	Fracture of the vertebral column with spinal cord injury	102	90781000119102	Microalbuminuria due to type 2 diabetes mellitus (disorder)	1095	5	6	0	5	6	1084	0.00000	-0.00503	0.00000	0.00000	0.00000	1.0000000000	1.0000000000	0.02740	-0.03899	3	3	0	2	3	0	0.00000	0.00000
10	62106007	Concussion with no loss of consciousness	128	86849004	Suicidal deliberate poisoning	1095	206	1	0	206	1	888	0.00000	-0.01455	0.00000	0.00000	0.00000	1.0000000000	1.0000000000	0.18813	-0.24869	96	0	0	110	1	0	0.00000	0.00000
7	75498004	Acute bacterial sinusitis (disorder)	128	86849004	Suicidal deliberate poisoning	1095	187	1	0	187	1	907	0.00000	-0.01372	0.00000	0.00000	0.00000	1.0000000000	1.0000000000	0.17078	-0.22747	89	0	0	98	1	0	0.00000	0.00000
6	39848009	Whiplash injury to neck	128	86849004	Suicidal deliberate poisoning	1095	182	1	0	182	1	912	0.00000	-0.01350	0.00000	0.00000	0.00000	1.0000000000	1.0000000000	0.16621	-0.22183	92	0	0	90	1	0	0.00000	0.00000
5	284549007	Laceration of hand	128	86849004	Suicidal deliberate poisoning	1095	104	1	0	104	1	990	0.00000	-0.00979	0.00000	0.00000	0.00000	1.0000000000	1.0000000000	0.09498	-0.13090	54	0	0	50	1	0	0.00000	0.00000
117	230265002	Familial Alzheimer's disease of early onset (disorder)	102	90781000119102	Microalbuminuria due to type 2 diabetes mellitus (disorder)	1095	6	6	0	6	6	1083	0.00000	-0.00551	0.00000	0.00000	0.00000	1.0000000000	1.0000000000	0.03288	-0.04667	2	3	0	4	3	0	0.00000	0.00000
1	444814009	Viral sinusitis (disorder)	128	86849004	Suicidal deliberate poisoning	1095	993	1	1	992	0	102	1.10272	0.00969	0.00000	0.00000	0.00000	1.0000000000	1.0000000000	0.90685	0.06881	478	0	0	515	1	1	-0.69315	-6.24611
109	90560007	Gout	102	90781000119102	Microalbuminuria due to type 2 diabetes mellitus (disorder)	1095	4	6	0	4	6	1085	0.00000	-0.00449	0.00000	0.00000	0.00000	1.0000000000	1.0000000000	0.02192	-0.03128	0	3	0	4	3	0	0.00000	0.00000
97	403192003	Third degree burn	102	90781000119102	Microalbuminuria due to type 2 diabetes mellitus (disorder)	1095	8	6	0	8	6	1081	0.00000	-0.00637	0.00000	0.00000	0.00000	1.0000000000	1.0000000000	0.04384	-0.06189	3	3	0	5	3	0	0.00000	0.00000
96	283371005	Laceration of forearm	102	90781000119102	Microalbuminuria due to type 2 diabetes mellitus (disorder)	1095	75	6	1	74	5	1015	2.43333	0.02885	2.74324	23.78626	0.31638	0.3473545015	1.0000000000	0.41096	0.50332	39	3	1	36	3	0	1.38629	3.68888
94	703151001	History of single seizure (situation)	102	90781000119102	Microalbuminuria due to type 2 diabetes mellitus (disorder)	1095	39	6	2	37	4	1052	9.35897	0.11924	14.21622	80.08857	2.52347	0.0169429154	0.2219774801	0.21370	1.30555	14	3	0	25	3	2	-0.91629	-2.60269
93	128613002	Seizure disorder	102	90781000119102	Microalbuminuria due to type 2 diabetes mellitus (disorder)	1095	39	6	2	37	4	1052	9.35897	0.11924	14.21622	80.08857	2.52347	0.0169429154	0.2219774801	0.21370	1.30555	14	3	0	25	3	2	-0.91629	-2.60269
89	47693006	Rupture of appendix	102	90781000119102	Microalbuminuria due to type 2 diabetes mellitus (disorder)	1095	20	6	0	20	6	1069	0.00000	-0.01012	0.00000	0.00000	0.00000	1.0000000000	1.0000000000	0.10959	-0.15003	10	3	0	10	3	0	0.00000	0.00000
86	713197008	Recurrent rectal polyp	102	90781000119102	Microalbuminuria due to type 2 diabetes mellitus (disorder)	1095	22	6	1	21	5	1068	8.29545	0.07754	10.17143	90.88773	1.13830	0.1149022765	0.6706198027	0.12055	0.83580	12	3	1	10	3	0	1.38629	2.56495
120	162573006	Suspected lung cancer (situation)	22	70704007	Sprain of wrist	1095	8	195	2	6	193	894	1.40385	0.01613	1.54404	7.70795	0.30930	0.6381889071	1.0000000000	1.42466	0.30718	0	90	0	8	105	2	-3.97968	-1.60944
75	431855005	Chronic kidney disease stage 1 (disorder)	102	90781000119102	Microalbuminuria due to type 2 diabetes mellitus (disorder)	1095	28	6	6	22	0	1067	39.10714	0.45821	0.00000	0.00000	0.00000	0.0000000002	0.0000000128	0.15342	2.60143	10	3	3	18	3	3	0.00000	-0.47957
69	233604007	Pneumonia	102	90781000119102	Microalbuminuria due to type 2 diabetes mellitus (disorder)	1095	7	6	0	7	6	1082	0.00000	-0.00595	0.00000	0.00000	0.00000	1.0000000000	1.0000000000	0.03836	-0.05430	3	3	0	4	3	0	0.00000	0.00000
64	444448004	Injury of medial collateral ligament of knee	102	90781000119102	Microalbuminuria due to type 2 diabetes mellitus (disorder)	1095	32	6	1	31	5	1058	5.70312	0.06057	6.82581	60.17440	0.77428	0.1633666582	0.7879650300	0.17534	0.76692	17	3	1	15	3	0	1.38629	2.89037
126	698754002	Chronic paralysis due to lesion of spinal cord	22	70704007	Sprain of wrist	1095	2	195	0	2	195	898	0.00000	-0.01991	0.00000	0.00000	0.00000	1.0000000000	1.0000000000	0.35616	-0.43953	2	90	0	0	105	0	0.00000	0.00000
49	88805009	Chronic congestive heart failure (disorder)	102	90781000119102	Microalbuminuria due to type 2 diabetes mellitus (disorder)	1095	10	6	0	10	6	1079	0.00000	-0.00713	0.00000	0.00000	0.00000	1.0000000000	1.0000000000	0.05479	-0.07696	5	3	0	5	3	0	0.00000	0.00000
47	359817006	Closed fracture of hip	102	90781000119102	Microalbuminuria due to type 2 diabetes mellitus (disorder)	1095	29	6	0	29	6	1060	0.00000	-0.01224	0.00000	0.00000	0.00000	1.0000000000	1.0000000000	0.15890	-0.21276	11	3	0	18	3	0	0.00000	0.00000
44	58150001	Fracture of clavicle	102	90781000119102	Microalbuminuria due to type 2 diabetes mellitus (disorder)	1095	112	6	1	111	5	978	1.62946	0.01577	1.76216	15.21882	0.20404	0.4774159561	1.0000000000	0.61370	0.30963	55	3	1	57	3	0	1.38629	4.02535
43	307731004	Injury of tendon of the rotator cuff of shoulder	102	90781000119102	Microalbuminuria due to type 2 diabetes mellitus (disorder)	1095	51	6	0	51	6	1038	0.00000	-0.01641	0.00000	0.00000	0.00000	1.0000000000	1.0000000000	0.27945	-0.35553	26	3	0	25	3	0	0.00000	0.00000
42	16114001	Fracture of ankle	102	90781000119102	Microalbuminuria due to type 2 diabetes mellitus (disorder)	1095	108	6	1	107	5	982	1.68981	0.01694	1.83551	15.85701	0.21247	0.4644932960	1.0000000000	0.59178	0.32936	48	3	0	60	3	1	-1.38629	-4.11087
41	283385000	Laceration of thigh	102	90781000119102	Microalbuminuria due to type 2 diabetes mellitus (disorder)	1095	105	6	1	104	5	985	1.73810	0.01784	1.89423	16.36815	0.21921	0.4546274954	1.0000000000	0.57534	0.34433	50	3	1	55	3	0	1.38629	3.93183
39	74400008	Appendicitis	102	90781000119102	Microalbuminuria due to type 2 diabetes mellitus (disorder)	1095	51	6	0	51	6	1038	0.00000	-0.01641	0.00000	0.00000	0.00000	1.0000000000	1.0000000000	0.27945	-0.35553	27	3	0	24	3	0	0.00000	0.00000
38	398254007	Preeclampsia	102	90781000119102	Microalbuminuria due to type 2 diabetes mellitus (disorder)	1095	101	6	2	99	4	990	3.61386	0.06185	5.00000	27.64225	0.90441	0.0988619010	0.6247730505	0.55342	0.94951	101	3	2	0	3	0	0.91629	3.94158
35	19169002	Miscarriage in first trimester	102	90781000119102	Microalbuminuria due to type 2 diabetes mellitus (disorder)	1095	174	6	1	173	5	916	1.04885	0.00158	1.05896	9.11992	0.12296	1.0000000000	1.0000000000	0.95342	0.03399	174	3	1	0	3	0	1.38629	5.16479
33	429007001	History of cardiac arrest (situation)	102	90781000119102	Microalbuminuria due to type 2 diabetes mellitus (disorder)	1095	42	6	0	42	6	1047	0.00000	-0.01482	0.00000	0.00000	0.00000	1.0000000000	1.0000000000	0.23014	-0.29882	24	3	0	18	3	0	0.00000	0.00000
32	410429000	Cardiac Arrest	102	90781000119102	Microalbuminuria due to type 2 diabetes mellitus (disorder)	1095	42	6	0	42	6	1047	0.00000	-0.01482	0.00000	0.00000	0.00000	1.0000000000	1.0000000000	0.23014	-0.29882	24	3	0	18	3	0	0.00000	0.00000
27	408512008	Body mass index 40+ - severely obese (finding)	102	90781000119102	Microalbuminuria due to type 2 diabetes mellitus (disorder)	1095	97	6	0	97	6	992	0.00000	-0.02314	0.00000	0.00000	0.00000	1.0000000000	1.0000000000	0.53151	-0.61495	67	3	0	30	3	0	0.00000	0.00000
21	15777000	Prediabetes	102	90781000119102	Microalbuminuria due to type 2 diabetes mellitus (disorder)	1095	333	6	5	328	1	761	2.74024	0.08539	11.60061	99.68275	1.35002	0.0114496112	0.1686320251	1.82466	1.08689	159	3	3	174	3	2	-0.22314	-0.48835
18	302870006	Hypertriglyceridemia (disorder)	102	90781000119102	Microalbuminuria due to type 2 diabetes mellitus (disorder)	1095	64	6	6	58	0	1031	17.10937	0.29792	0.00000	0.00000	0.00000	0.0000000317	0.0000020049	0.35068	2.37366	28	3	3	36	3	3	0.00000	-0.22957
130	314994000	Metastasis from malignant tumor of prostate (disorder)	76	127013003	Diabetic renal disease (disorder)	1095	1	28	1	0	27	1067	39.10714	0.18664	0.00000	0.00000	0.00000	0.0255707763	0.2905941929	0.02557	0.96357	0	10	0	1	18	1	-2.94444	-0.69315
129	47505003	Posttraumatic stress disorder	76	127013003	Diabetic renal disease (disorder)	1095	4	28	2	2	26	1065	19.55357	0.18199	40.96154	302.12436	5.55350	0.0036674654	0.0707538718	0.10228	1.44447	1	10	0	3	18	2	-2.30259	-0.91629
15	40055000	Chronic sinusitis (disorder)	102	90781000119102	Microalbuminuria due to type 2 diabetes mellitus (disorder)	1095	216	6	1	215	5	874	0.84491	-0.00571	0.81302	6.99516	0.09449	1.0000000000	1.0000000000	1.18356	-0.12668	104	3	0	112	3	1	-1.38629	-4.72739
14	10509002	Acute bronchitis (disorder)	102	90781000119102	Microalbuminuria due to type 2 diabetes mellitus (disorder)	1095	863	6	4	859	2	230	0.84589	-0.02206	0.53551	2.94192	0.09748	0.6126294740	1.0000000000	4.72877	-0.19630	418	3	2	445	3	2	0.00000	-0.06230
125	1734006	Fracture of the vertebral column with spinal cord injury	76	127013003	Diabetic renal disease (disorder)	1095	5	28	0	5	28	1062	0.00000	-0.01097	0.00000	0.00000	0.00000	1.0000000000	1.0000000000	0.12785	-0.17358	3	10	0	2	18	0	0.00000	0.00000
6	39848009	Whiplash injury to neck	102	90781000119102	Microalbuminuria due to type 2 diabetes mellitus (disorder)	1095	182	6	2	180	4	909	2.00549	0.03332	2.52500	13.88955	0.45902	0.2619364224	0.9281913645	0.99726	0.58694	92	3	2	90	3	0	0.91629	3.85015
118	48333001	Burn injury(morphologic abnormality)	76	127013003	Diabetic renal disease (disorder)	1095	1	28	0	1	28	1066	0.00000	-0.00490	0.00000	0.00000	0.00000	1.0000000000	1.0000000000	0.02557	-0.03643	0	10	0	1	18	0	0.00000	0.00000
117	230265002	Familial Alzheimer's disease of early onset (disorder)	76	127013003	Diabetic renal disease (disorder)	1095	6	28	1	5	27	1062	6.51786	0.06635	7.86667	69.64292	0.88860	0.1442534615	0.7404942507	0.15342	0.79408	2	10	1	4	18	0	2.39790	1.09861
109	90560007	Gout	76	127013003	Diabetic renal disease (disorder)	1095	4	28	0	4	28	1063	0.00000	-0.00981	0.00000	0.00000	0.00000	1.0000000000	1.0000000000	0.10228	-0.14049	0	10	0	4	18	0	0.00000	0.00000
106	24079001	Atopic dermatitis	76	127013003	Diabetic renal disease (disorder)	1095	20	28	0	20	28	1047	0.00000	-0.02210	0.00000	0.00000	0.00000	1.0000000000	1.0000000000	0.51142	-0.59590	13	10	0	7	18	0	0.00000	0.00000
102	90781000119102	Microalbuminuria due to type 2 diabetes mellitus (disorder)	76	127013003	Diabetic renal disease (disorder)	1095	6	28	6	0	22	1067	39.10714	0.45821	0.00000	0.00000	0.00000	0.0000000002	0.0000000128	0.15342	2.60143	3	10	3	3	18	3	-0.47957	0.00000
98	1551000119108	Nonproliferative diabetic retinopathy due to type 2 diabetes mellitus (disorder)	76	127013003	Diabetic renal disease (disorder)	1095	12	28	6	6	22	1061	19.55357	0.31637	48.22727	161.37009	14.41327	0.0000001327	0.0000076649	0.30685	2.42126	7	10	3	5	18	3	-0.47957	0.22314
97	403192003	Third degree burn	76	127013003	Diabetic renal disease (disorder)	1095	8	28	0	8	28	1059	0.00000	-0.01390	0.00000	0.00000	0.00000	1.0000000000	1.0000000000	0.20457	-0.26851	3	10	0	5	18	0	0.00000	0.00000
96	283371005	Laceration of forearm	76	127013003	Diabetic renal disease (disorder)	1095	75	28	4	71	24	996	2.08571	0.04769	2.33803	6.92297	0.78960	0.1189753943	0.6839332097	1.91781	0.77704	39	10	3	36	18	1	-1.47810	-0.97186
94	703151001	History of single seizure (situation)	76	127013003	Diabetic renal disease (disorder)	1095	39	28	2	37	26	1030	2.00549	0.03130	2.14137	9.36132	0.48983	0.2629676428	0.9285317652	0.99726	0.58694	14	10	0	25	18	2	-2.30259	-2.60269
93	128613002	Seizure disorder	76	127013003	Diabetic renal disease (disorder)	1095	39	28	2	37	26	1030	2.00549	0.03130	2.14137	9.36132	0.48983	0.2629676428	0.9285317652	0.99726	0.58694	14	10	0	25	18	2	-2.30259	-2.60269
89	47693006	Rupture of appendix	76	127013003	Diabetic renal disease (disorder)	1095	20	28	0	20	28	1047	0.00000	-0.02210	0.00000	0.00000	0.00000	1.0000000000	1.0000000000	0.51142	-0.59590	10	10	0	10	18	0	0.00000	0.00000
86	713197008	Recurrent rectal polyp	76	127013003	Diabetic renal disease (disorder)	1095	22	28	2	20	26	1047	3.55519	0.05927	4.02692	18.13306	0.89428	0.1063461212	0.6411444039	0.56256	0.94105	12	10	1	10	18	1	-0.54654	0.16705
75	431855005	Chronic kidney disease stage 1 (disorder)	76	127013003	Diabetic renal disease (disorder)	1095	28	28	28	0	0	1067	39.10714	1.00000	0.00000	0.00000	0.00000	0.0000000000	0.0000000000	0.71598	4.07895	10	10	10	18	18	18	0.00000	0.00000
72	35999006	Blighted ovum	76	127013003	Diabetic renal disease (disorder)	1095	53	28	2	51	26	1016	1.47574	0.01738	1.53243	6.63473	0.35395	0.6419780779	1.0000000000	1.35525	0.34908	53	10	2	0	18	0	1.79176	3.31419
69	233604007	Pneumonia	76	127013003	Diabetic renal disease (disorder)	1095	7	28	0	7	28	1060	0.00000	-0.01299	0.00000	0.00000	0.00000	1.0000000000	1.0000000000	0.17900	-0.23756	3	10	0	4	18	0	0.00000	0.00000
67	403191005	Second degree burn	76	127013003	Diabetic renal disease (disorder)	1095	49	28	2	47	26	1020	1.59621	0.02090	1.66939	7.24351	0.38474	0.3594523324	1.0000000000	1.25297	0.41314	23	10	1	26	18	1	-0.54654	-0.11778
64	444448004	Injury of medial collateral ligament of knee	76	127013003	Diabetic renal disease (disorder)	1095	32	28	3	29	25	1038	3.66629	0.07494	4.29517	15.03849	1.22675	0.0452227229	0.4084765375	0.81826	1.13744	17	10	2	15	18	1	-1.15268	-0.52130
63	68496003	Polyp of colon	76	127013003	Diabetic renal disease (disorder)	1095	91	28	5	86	23	981	2.14874	0.05602	2.47978	6.68646	0.91966	0.0755592281	0.5414358400	2.32694	0.85077	43	10	1	48	18	4	0.69315	1.21924
58	239720000	Tear of meniscus of knee	76	127013003	Diabetic renal disease (disorder)	1095	20	28	1	19	27	1048	1.95536	0.02111	2.04288	15.81901	0.26382	0.4070686830	1.0000000000	0.51142	0.40410	10	10	0	10	18	1	-2.94444	-2.39790
57	192127007	Child attention deficit disorder	76	127013003	Diabetic renal disease (disorder)	1095	76	28	5	71	23	996	2.57284	0.06958	3.04960	8.26181	1.12567	0.0392853481	0.3768817329	1.94338	1.02749	24	10	1	52	18	4	0.69315	0.57982
54	5602001	Opioid abuse (disorder)	76	127013003	Diabetic renal disease (disorder)	1095	7	28	1	6	27	1061	5.58673	0.05960	6.54938	56.29236	0.76199	0.1662561273	0.7915572889	0.17900	0.76244	0	10	0	7	18	1	-2.94444	-2.07944
50	446096008	Perennial allergic rhinitis	76	127013003	Diabetic renal disease (disorder)	1095	26	28	1	25	27	1042	1.50412	0.01274	1.54370	11.81242	0.20174	0.4940925552	1.0000000000	0.66484	0.26462	14	10	1	12	18	0	2.39790	2.70805
49	88805009	Chronic congestive heart failure (disorder)	76	127013003	Diabetic renal disease (disorder)	1095	10	28	0	10	28	1057	0.00000	-0.01555	0.00000	0.00000	0.00000	1.0000000000	1.0000000000	0.25571	-0.32850	5	10	0	5	18	0	0.00000	0.00000
47	359817006	Closed fracture of hip	76	127013003	Diabetic renal disease (disorder)	1095	29	28	0	29	28	1038	0.00000	-0.02672	0.00000	0.00000	0.00000	1.0000000000	1.0000000000	0.74155	-0.80037	11	10	0	18	18	0	0.00000	0.00000
44	58150001	Fracture of clavicle	76	127013003	Diabetic renal disease (disorder)	1095	112	28	3	109	25	958	1.04751	0.00260	1.05468	3.55045	0.31330	0.7594661643	1.0000000000	2.86393	0.04993	55	10	1	57	18	2	0.09531	0.64096
43	307731004	Injury of tendon of the rotator cuff of shoulder	76	127013003	Diabetic renal disease (disorder)	1095	51	28	5	46	23	1021	3.83403	0.10147	4.82514	13.26422	1.75525	0.0078196161	0.1290108046	1.30411	1.38075	26	10	2	25	18	3	-0.15415	0.40547
42	16114001	Fracture of ankle	76	127013003	Diabetic renal disease (disorder)	1095	108	28	3	105	25	962	1.08631	0.00462	1.09943	3.70311	0.32641	0.7511776610	1.0000000000	2.76164	0.08864	48	10	1	60	18	2	0.09531	0.45783
41	283385000	Laceration of thigh	76	127013003	Diabetic renal disease (disorder)	1095	105	28	6	99	22	968	2.23469	0.06514	2.66667	6.73226	1.05627	0.0441223378	0.4038643180	2.68493	0.92572	50	10	2	55	18	4	0.08701	0.56685
39	74400008	Appendicitis	76	127013003	Diabetic renal disease (disorder)	1095	51	28	1	50	27	1017	0.76681	-0.00835	0.75333	5.65634	0.10033	1.0000000000	1.0000000000	1.30411	-0.20421	27	10	0	24	18	1	-2.94444	-3.21888
38	398254007	Preeclampsia	76	127013003	Diabetic renal disease (disorder)	1095	101	28	4	97	24	970	1.54880	0.02834	1.66667	4.90233	0.56662	0.3182638415	1.0000000000	2.58265	0.48090	101	10	4	0	18	0	1.25276	3.26767
35	19169002	Miscarriage in first trimester	76	127013003	Diabetic renal disease (disorder)	1095	174	28	6	168	22	899	1.34852	0.02454	1.45942	3.65333	0.58300	0.4299439374	1.0000000000	4.44932	0.36128	174	10	6	0	18	0	0.98083	3.40120
33	429007001	History of cardiac arrest (situation)	76	127013003	Diabetic renal disease (disorder)	1095	42	28	1	41	27	1026	0.93112	-0.00223	0.92683	6.98809	0.12293	1.0000000000	1.0000000000	1.07397	-0.05240	24	10	1	18	18	0	2.39790	3.21888
32	410429000	Cardiac Arrest	76	127013003	Diabetic renal disease (disorder)	1095	42	28	1	41	27	1026	0.93112	-0.00223	0.92683	6.98809	0.12293	1.0000000000	1.0000000000	1.07397	-0.05240	24	10	1	18	18	0	2.39790	3.21888
30	399211009	History of myocardial infarction (situation)	76	127013003	Diabetic renal disease (disorder)	1095	31	28	0	31	28	1036	0.00000	-0.02765	0.00000	0.00000	0.00000	1.0000000000	1.0000000000	0.79269	-0.84213	2	10	0	29	18	0	0.00000	0.00000
27	408512008	Body mass index 40+ - severely obese (finding)	76	127013003	Diabetic renal disease (disorder)	1095	97	28	2	95	26	972	0.80633	-0.00978	0.78704	3.36727	0.18396	1.0000000000	1.0000000000	2.48037	-0.21428	67	10	1	30	18	1	-0.54654	0.78552
24	162864005	Body mass index 30+ - obesity (finding)	76	127013003	Diabetic renal disease (disorder)	1095	439	28	11	428	17	639	0.97991	-0.00266	0.96605	2.08276	0.44809	1.0000000000	1.0000000000	11.22557	-0.02687	226	10	5	213	18	6	-0.28768	0.23567
23	36971009	Sinusitis (disorder)	76	127013003	Diabetic renal disease (disorder)	1095	190	28	5	185	23	882	1.02914	0.00216	1.03643	2.76156	0.38898	1.0000000000	1.0000000000	4.85845	0.03444	84	10	1	106	18	4	0.69315	1.12847
21	15777000	Prediabetes	76	127013003	Diabetic renal disease (disorder)	1095	333	28	17	316	11	751	1.99646	0.10671	3.67290	7.93036	1.70108	0.0012044331	0.0286219356	8.51507	0.91971	159	10	7	174	18	10	-0.14232	0.25373
20	80394007	Hyperglycemia (disorder)	76	127013003	Diabetic renal disease (disorder)	1095	55	28	22	33	6	1034	15.64286	0.54549	114.88889	302.14565	43.68574	0.0000000000	0.0000000000	1.40639	3.25669	23	10	8	32	18	14	-0.01575	0.16496
18	302870006	Hypertriglyceridemia (disorder)	76	127013003	Diabetic renal disease (disorder)	1095	64	28	28	36	0	1031	17.10937	0.65018	0.00000	0.00000	0.00000	0.0000000000	0.0000000000	1.63653	3.45934	28	10	10	36	18	18	0.00000	0.23639
17	368581000119106	Neuropathy due to type 2 diabetes mellitus (disorder)	76	127013003	Diabetic renal disease (disorder)	1095	28	28	12	16	16	1051	16.76020	0.41358	49.26562	120.76726	20.09735	0.0000000000	0.0000000000	0.71598	2.92141	7	10	3	21	18	9	0.36772	0.00000
15	40055000	Chronic sinusitis (disorder)	76	127013003	Diabetic renal disease (disorder)	1095	216	28	5	211	23	856	0.90526	-0.00761	0.88193	2.34699	0.33140	1.0000000000	1.0000000000	5.52329	-0.12064	104	10	1	112	18	4	0.69315	1.28666
14	10509002	Acute bronchitis (disorder)	76	127013003	Diabetic renal disease (disorder)	1095	863	28	26	837	2	230	1.17820	0.05568	3.57228	15.16227	0.84164	0.0967726909	0.6177968585	22.06758	0.22709	418	10	9	445	18	17	0.02508	0.55721
13	370247008	Facial laceration	76	127013003	Diabetic renal disease (disorder)	1095	109	28	2	107	26	960	0.71756	-0.01521	0.69015	2.94817	0.16156	1.0000000000	1.0000000000	2.78721	-0.33617	55	10	0	54	18	2	-2.30259	-3.33220
125	1734006	Fracture of the vertebral column with spinal cord injury	50	446096008	Perennial allergic rhinitis	1095	5	26	0	5	26	1064	0.00000	-0.01056	0.00000	0.00000	0.00000	1.0000000000	1.0000000000	0.11872	-0.16185	3	14	0	2	12	0	0.00000	0.00000
10	62106007	Concussion with no loss of consciousness	76	127013003	Diabetic renal disease (disorder)	1095	206	28	6	200	22	867	1.13904	0.01084	1.18227	2.95392	0.47319	0.6323500003	1.0000000000	5.26758	0.15945	96	10	2	110	18	4	0.08701	0.54192
7	75498004	Acute bacterial sinusitis (disorder)	76	127013003	Diabetic renal disease (disorder)	1095	187	28	8	179	20	888	1.67303	0.04948	1.98436	4.57582	0.86054	0.1227696876	0.6908155882	4.78174	0.63842	89	10	3	98	18	5	-0.05972	0.39789
6	39848009	Whiplash injury to neck	76	127013003	Diabetic renal disease (disorder)	1095	182	28	7	175	21	892	1.50412	0.03646	1.69905	4.05796	0.71138	0.2987807959	0.9870898856	4.65388	0.50076	92	10	4	90	18	3	-0.69315	-0.25593
5	284549007	Laceration of hand	76	127013003	Diabetic renal disease (disorder)	1095	104	28	4	100	24	967	1.50412	0.02646	1.61167	4.73797	0.54822	0.3305764698	1.0000000000	2.65936	0.45034	54	10	2	50	18	2	-0.51083	0.07411
117	230265002	Familial Alzheimer's disease of early onset (disorder)	50	446096008	Perennial allergic rhinitis	1095	6	26	0	6	26	1063	0.00000	-0.01158	0.00000	0.00000	0.00000	1.0000000000	1.0000000000	0.14247	-0.19215	2	14	0	4	12	0	0.00000	0.00000
109	90560007	Gout	50	446096008	Perennial allergic rhinitis	1095	4	26	0	4	26	1065	0.00000	-0.00944	0.00000	0.00000	0.00000	1.0000000000	1.0000000000	0.09498	-0.13090	0	14	0	4	12	0	0.00000	0.00000
102	90781000119102	Microalbuminuria due to type 2 diabetes mellitus (disorder)	50	446096008	Perennial allergic rhinitis	1095	6	26	1	5	25	1064	7.01923	0.06968	8.51200	75.55267	0.95899	0.1345612681	0.7211103856	0.14247	0.80785	3	14	1	3	12	0	2.70805	1.38629
98	1551000119108	Nonproliferative diabetic retinopathy due to type 2 diabetes mellitus (disorder)	50	446096008	Perennial allergic rhinitis	1095	12	26	0	12	26	1057	0.00000	-0.01642	0.00000	0.00000	0.00000	1.0000000000	1.0000000000	0.28493	-0.36169	7	14	0	5	12	0	0.00000	0.00000
97	403192003	Third degree burn	50	446096008	Perennial allergic rhinitis	1095	8	26	0	8	26	1061	0.00000	-0.01338	0.00000	0.00000	0.00000	1.0000000000	1.0000000000	0.18995	-0.25091	3	14	0	5	12	0	0.00000	0.00000
96	283371005	Laceration of forearm	50	446096008	Perennial allergic rhinitis	1095	75	26	1	74	25	995	0.56154	-0.01854	0.53784	4.02485	0.07187	1.0000000000	1.0000000000	1.78082	-0.47551	39	14	1	36	12	0	2.70805	3.68888
94	703151001	History of single seizure (situation)	50	446096008	Perennial allergic rhinitis	1095	39	26	1	38	25	1031	1.07988	0.00239	1.08526	8.22069	0.14327	0.6148254185	1.0000000000	0.92603	0.05437	14	14	1	25	12	0	2.70805	2.70805
93	128613002	Seizure disorder	50	446096008	Perennial allergic rhinitis	1095	39	26	1	38	25	1031	1.07988	0.00239	1.08526	8.22069	0.14327	0.6148254185	1.0000000000	0.92603	0.05437	14	14	1	25	12	0	2.70805	2.70805
89	47693006	Rupture of appendix	50	446096008	Perennial allergic rhinitis	1095	20	26	1	19	25	1050	2.10577	0.02352	2.21053	17.16473	0.28468	0.3842327652	1.0000000000	0.47489	0.43940	10	14	0	10	12	1	-2.56495	-2.39790
86	713197008	Recurrent rectal polyp	50	446096008	Perennial allergic rhinitis	1095	22	26	0	22	26	1047	0.00000	-0.02233	0.00000	0.00000	0.00000	1.0000000000	1.0000000000	0.52237	-0.60632	12	14	0	10	12	0	0.00000	0.00000
75	431855005	Chronic kidney disease stage 1 (disorder)	50	446096008	Perennial allergic rhinitis	1095	28	26	1	27	25	1042	1.50412	0.01274	1.54370	11.81242	0.20174	0.4940925552	1.0000000000	0.66484	0.26462	10	14	1	18	12	0	2.70805	2.39790
72	35999006	Blighted ovum	50	446096008	Perennial allergic rhinitis	1095	53	26	1	52	25	1017	0.79463	-0.00722	0.78231	5.88617	0.10397	1.0000000000	1.0000000000	1.25845	-0.17533	53	14	1	0	12	0	2.70805	3.98898
69	233604007	Pneumonia	50	446096008	Perennial allergic rhinitis	1095	7	26	0	7	26	1062	0.00000	-0.01251	0.00000	0.00000	0.00000	1.0000000000	1.0000000000	0.16621	-0.22183	3	14	0	4	12	0	0.00000	0.00000
67	403191005	Second degree burn	50	446096008	Perennial allergic rhinitis	1095	49	26	1	48	25	1021	0.85950	-0.00474	0.85083	6.41151	0.11291	1.0000000000	1.0000000000	1.16347	-0.11335	23	14	1	26	12	0	2.70805	3.17805
64	444448004	Injury of medial collateral ligament of knee	50	446096008	Perennial allergic rhinitis	1095	32	26	0	32	26	1037	0.00000	-0.02706	0.00000	0.00000	0.00000	1.0000000000	1.0000000000	0.75982	-0.81543	17	14	0	15	12	0	0.00000	0.00000
63	68496003	Polyp of colon	50	446096008	Perennial allergic rhinitis	1095	91	26	0	91	26	978	0.00000	-0.04695	0.00000	0.00000	0.00000	0.1596173236	0.7788331663	2.16073	-1.66026	43	14	0	48	12	0	0.00000	0.00000
118	48333001	Burn injury(morphologic abnormality)	96	283371005	Laceration of forearm	1095	1	75	0	1	75	1019	0.00000	-0.00820	0.00000	0.00000	0.00000	1.0000000000	1.0000000000	0.06849	-0.09558	0	39	0	1	36	0	0.00000	0.00000
49	88805009	Chronic congestive heart failure (disorder)	50	446096008	Perennial allergic rhinitis	1095	10	26	0	10	26	1059	0.00000	-0.01497	0.00000	0.00000	0.00000	1.0000000000	1.0000000000	0.23744	-0.30736	5	14	0	5	12	0	0.00000	0.00000
47	359817006	Closed fracture of hip	50	446096008	Perennial allergic rhinitis	1095	29	26	1	28	25	1041	1.45225	0.01163	1.48714	11.36542	0.19459	0.5064201967	1.0000000000	0.68858	0.24419	11	14	0	18	12	1	-2.56495	-2.94444
44	58150001	Fracture of clavicle	50	446096008	Perennial allergic rhinitis	1095	112	26	4	108	22	961	1.50412	0.02654	1.61785	4.78200	0.54735	0.3297865146	1.0000000000	2.65936	0.45034	55	14	2	57	12	2	0.13353	-0.03449
43	307731004	Injury of tendon of the rotator cuff of shoulder	50	446096008	Perennial allergic rhinitis	1095	51	26	0	51	26	1018	0.00000	-0.03447	0.00000	0.00000	0.00000	0.6289637132	1.0000000000	1.21096	-1.14467	26	14	0	25	12	0	0.00000	0.00000
42	16114001	Fracture of ankle	50	446096008	Perennial allergic rhinitis	1095	108	26	1	107	25	962	0.38996	-0.03147	0.35963	2.68061	0.04825	0.5044246601	1.0000000000	2.56438	-0.83365	48	14	0	60	12	1	-2.56495	-4.11087
41	283385000	Laceration of thigh	50	446096008	Perennial allergic rhinitis	1095	105	26	1	104	25	965	0.40110	-0.03042	0.37115	2.76725	0.04978	0.5032707867	1.0000000000	2.49315	-0.80453	50	14	0	55	12	1	-2.56495	-4.02535
39	74400008	Appendicitis	50	446096008	Perennial allergic rhinitis	1095	51	26	3	48	23	1021	2.47738	0.05092	2.77446	9.56311	0.80493	0.1164803352	0.6771287302	1.21096	0.85533	27	14	2	24	12	1	-0.48551	-0.54473
38	398254007	Preeclampsia	50	446096008	Perennial allergic rhinitis	1095	101	26	4	97	22	972	1.66794	0.03320	1.82193	5.39515	0.61526	0.2909939237	0.9768039197	2.39817	0.55717	101	14	4	0	12	0	1.50408	3.26767
35	19169002	Miscarriage in first trimester	50	446096008	Perennial allergic rhinitis	1095	174	26	3	171	23	898	0.72613	-0.01856	0.68497	2.30669	0.20340	0.7857930552	1.0000000000	4.13151	-0.35938	174	14	3	0	12	0	1.73460	4.07754
33	429007001	History of cardiac arrest (situation)	50	446096008	Perennial allergic rhinitis	1095	42	26	0	42	26	1027	0.00000	-0.03115	0.00000	0.00000	0.00000	0.6203565875	1.0000000000	0.99726	-0.99802	24	14	0	18	12	0	0.00000	0.00000
32	410429000	Cardiac Arrest	50	446096008	Perennial allergic rhinitis	1095	42	26	0	42	26	1027	0.00000	-0.03115	0.00000	0.00000	0.00000	0.6203565875	1.0000000000	0.99726	-0.99802	24	14	0	18	12	0	0.00000	0.00000
27	408512008	Body mass index 40+ - severely obese (finding)	50	446096008	Perennial allergic rhinitis	1095	97	26	2	95	24	974	0.86836	-0.00640	0.85439	3.67086	0.19886	1.0000000000	1.0000000000	2.30320	-0.13890	67	14	1	30	12	1	0.14310	0.78552
21	15777000	Prediabetes	50	446096008	Perennial allergic rhinitis	1095	333	26	6	327	20	742	0.75884	-0.02486	0.68073	1.71080	0.27087	0.5199510325	1.0000000000	7.90685	-0.34756	159	14	3	174	12	3	0.12516	-0.08855
20	80394007	Hyperglycemia (disorder)	50	446096008	Perennial allergic rhinitis	1095	55	26	1	54	25	1015	0.76573	-0.00840	0.75185	5.65319	0.09999	1.0000000000	1.0000000000	1.30594	-0.20535	23	14	1	32	12	0	2.70805	3.17805
18	302870006	Hypertriglyceridemia (disorder)	50	446096008	Perennial allergic rhinitis	1095	64	26	1	63	25	1006	0.65805	-0.01329	0.63873	4.79058	0.08516	1.0000000000	1.0000000000	1.51963	-0.33321	28	14	1	36	12	0	2.70805	3.36730
130	314994000	Metastasis from malignant tumor of prostate (disorder)	24	162864005	Body mass index 30+ - obesity (finding)	1095	1	439	0	1	439	655	0.00000	-0.02473	0.00000	0.00000	0.00000	1.0000000000	1.0000000000	0.40091	-0.48637	0	226	0	1	213	0	0.00000	0.00000
15	40055000	Chronic sinusitis (disorder)	50	446096008	Perennial allergic rhinitis	1095	216	26	4	212	22	857	0.77991	-0.01701	0.73499	2.15548	0.25062	0.8030052300	1.0000000000	5.12877	-0.29367	104	14	1	112	12	3	1.09861	1.00764
14	10509002	Acute bronchitis (disorder)	50	446096008	Perennial allergic rhinitis	1095	863	26	20	843	6	226	0.97602	-0.00721	0.89363	2.25149	0.35469	0.8087782265	1.0000000000	20.49132	-0.03337	418	14	10	445	12	10	0.08701	-0.06117
125	1734006	Fracture of the vertebral column with spinal cord injury	24	162864005	Body mass index 30+ - obesity (finding)	1095	5	439	0	5	439	651	0.00000	-0.05541	0.00000	0.00000	0.00000	0.0869144868	0.5823934082	2.00457	-1.58716	3	226	0	2	213	0	0.00000	0.00000
10	62106007	Concussion with no loss of consciousness	50	446096008	Perennial allergic rhinitis	1095	206	26	3	203	23	866	0.61333	-0.02903	0.55644	1.87122	0.16546	0.4505953864	1.0000000000	4.89132	-0.55859	96	14	1	110	12	2	0.76214	0.54936
120	162573006	Suspected lung cancer (situation)	103	157141000119108	Proteinuria due to type 2 diabetes mellitus (disorder)	1095	8	3	0	8	3	1084	0.00000	-0.00450	0.00000	0.00000	0.00000	1.0000000000	1.0000000000	0.02192	-0.03128	0	1	0	8	2	0	0.00000	0.00000
6	39848009	Whiplash injury to neck	50	446096008	Perennial allergic rhinitis	1095	182	26	4	178	22	891	0.92561	-0.00518	0.91011	2.67313	0.30986	1.0000000000	1.0000000000	4.32146	-0.08989	92	14	3	90	12	1	-0.83035	-1.05559
118	48333001	Burn injury(morphologic abnormality)	24	162864005	Body mass index 30+ - obesity (finding)	1095	1	439	0	1	439	655	0.00000	-0.02473	0.00000	0.00000	0.00000	1.0000000000	1.0000000000	0.40091	-0.48637	0	226	0	1	213	0	0.00000	0.00000
117	230265002	Familial Alzheimer's disease of early onset (disorder)	24	162864005	Body mass index 30+ - obesity (finding)	1095	6	439	3	3	436	653	1.24715	0.01501	1.49771	7.45455	0.30091	0.6887277043	1.0000000000	2.40548	0.23214	2	226	1	4	213	2	0.74746	0.00000
126	698754002	Chronic paralysis due to lesion of spinal cord	103	157141000119108	Proteinuria due to type 2 diabetes mellitus (disorder)	1095	2	3	0	2	3	1090	0.00000	-0.00224	0.00000	0.00000	0.00000	1.0000000000	1.0000000000	0.00548	-0.00788	2	1	0	0	2	0	0.00000	0.00000
127	431856006	Chronic kidney disease stage 2 (disorder)	103	157141000119108	Proteinuria due to type 2 diabetes mellitus (disorder)	1095	5	3	2	3	1	1089	146.00000	0.51474	726.00000	10321.88356	51.06394	0.0000499947	0.0018362088	0.01370	1.56533	3	1	1	2	2	1	-0.40547	0.28768
128	86849004	Suicidal deliberate poisoning	103	157141000119108	Proteinuria due to type 2 diabetes mellitus (disorder)	1095	1	3	0	1	3	1091	0.00000	-0.00158	0.00000	0.00000	0.00000	1.0000000000	1.0000000000	0.00274	-0.00395	0	1	0	1	2	0	0.00000	0.00000
130	314994000	Metastasis from malignant tumor of prostate (disorder)	103	157141000119108	Proteinuria due to type 2 diabetes mellitus (disorder)	1095	1	3	0	1	3	1091	0.00000	-0.00158	0.00000	0.00000	0.00000	1.0000000000	1.0000000000	0.00274	-0.00395	0	1	0	1	2	0	0.00000	0.00000
131	93761005	Primary malignant neoplasm of colon	103	157141000119108	Proteinuria due to type 2 diabetes mellitus (disorder)	1095	5	3	0	5	3	1087	0.00000	-0.00355	0.00000	0.00000	0.00000	1.0000000000	1.0000000000	0.01370	-0.01963	3	1	0	2	2	0	0.00000	0.00000
109	90560007	Gout	24	162864005	Body mass index 30+ - obesity (finding)	1095	4	439	1	3	438	653	0.62358	-0.01865	0.49696	4.79299	0.05153	0.6532944618	1.0000000000	1.60365	-0.38054	0	226	0	4	213	1	-5.36598	-1.60944
102	90781000119102	Microalbuminuria due to type 2 diabetes mellitus (disorder)	24	162864005	Body mass index 30+ - obesity (finding)	1095	6	439	2	4	437	652	0.83144	-0.01024	0.74600	4.09049	0.13605	1.0000000000	1.0000000000	2.40548	-0.18290	3	226	1	3	213	1	0.05897	0.00000
98	1551000119108	Nonproliferative diabetic retinopathy due to type 2 diabetes mellitus (disorder)	24	162864005	Body mass index 30+ - obesity (finding)	1095	12	439	6	6	433	650	1.24715	0.02128	1.50115	4.68485	0.48101	0.5585196326	1.0000000000	4.81096	0.26858	7	226	3	5	213	3	0.05844	0.22314
97	403192003	Third degree burn	24	162864005	Body mass index 30+ - obesity (finding)	1095	8	439	2	6	437	650	0.62358	-0.02642	0.49580	2.46778	0.09961	0.4869543036	1.0000000000	3.20731	-0.48793	3	226	1	5	213	1	0.05897	-0.40547
96	283371005	Laceration of forearm	24	162864005	Body mass index 30+ - obesity (finding)	1095	75	439	42	33	397	623	1.39681	0.08802	1.99725	3.20514	1.24457	0.0047418961	0.0869741935	30.06849	0.46888	39	226	24	36	213	18	-0.20864	-0.13353
94	703151001	History of single seizure (situation)	24	162864005	Body mass index 30+ - obesity (finding)	1095	39	439	10	29	429	627	0.63957	-0.05666	0.50398	1.04493	0.24307	0.0677535335	0.5105068816	15.63562	-0.59677	14	226	2	25	213	8	1.41748	0.66238
93	128613002	Seizure disorder	24	162864005	Body mass index 30+ - obesity (finding)	1095	39	439	10	29	429	627	0.63957	-0.05666	0.50398	1.04493	0.24307	0.0677535335	0.5105068816	15.63562	-0.59677	14	226	2	25	213	8	1.41748	0.66238
89	47693006	Rupture of appendix	24	162864005	Body mass index 30+ - obesity (finding)	1095	20	439	13	7	426	649	1.62130	0.06933	2.82931	7.14899	1.11974	0.0354307547	0.3555648164	8.01826	0.63451	10	226	6	10	213	7	0.20726	0.09353
86	713197008	Recurrent rectal polyp	24	162864005	Body mass index 30+ - obesity (finding)	1095	22	439	15	7	424	649	1.70066	0.08207	3.27999	8.11164	1.32628	0.0081238877	0.1325982198	8.82009	0.70426	12	226	10	10	213	5	-0.61381	-0.31015
75	431855005	Chronic kidney disease stage 1 (disorder)	24	162864005	Body mass index 30+ - obesity (finding)	1095	28	439	11	17	428	639	0.97991	-0.00266	0.96605	2.08276	0.44809	1.0000000000	1.0000000000	11.22557	-0.02687	10	226	5	18	213	6	0.23567	-0.28768
72	35999006	Blighted ovum	24	162864005	Body mass index 30+ - obesity (finding)	1095	53	439	35	18	404	638	1.64718	0.11940	3.07068	5.49523	1.71587	0.0001369311	0.0045877143	21.24840	0.69430	53	226	35	0	213	0	2.00917	0.92199
69	233604007	Pneumonia	24	162864005	Body mass index 30+ - obesity (finding)	1095	7	439	5	2	434	654	1.78165	0.05129	3.76728	19.50484	0.72764	0.1237735138	0.6913144812	2.80639	0.65654	3	226	2	4	213	3	0.45953	0.06899
67	403191005	Second degree burn	24	162864005	Body mass index 30+ - obesity (finding)	1095	49	439	20	29	419	627	1.01808	0.00320	1.03201	1.84867	0.57612	1.0000000000	1.0000000000	19.64475	0.02461	23	226	10	26	213	10	0.05666	-0.08701
64	444448004	Injury of medial collateral ligament of knee	24	162864005	Body mass index 30+ - obesity (finding)	1095	32	439	18	14	421	642	1.40305	0.05721	1.96064	3.98459	0.96474	0.0675459439	0.5101371685	12.82922	0.45828	17	226	9	15	213	9	0.05691	0.08004
63	68496003	Polyp of colon	24	162864005	Body mass index 30+ - obesity (finding)	1095	91	439	65	26	374	630	1.78165	0.19251	4.21123	6.75453	2.62557	0.0000000005	0.0000000356	36.48311	0.81623	43	226	34	48	213	31	-0.02886	-0.11802
50	446096008	Perennial allergic rhinitis	24	162864005	Body mass index 30+ - obesity (finding)	1095	26	439	8	18	431	638	0.76748	-0.02966	0.65790	1.52660	0.28353	0.4191330820	1.0000000000	10.42374	-0.34404	14	226	3	12	213	5	0.56005	0.51083
49	88805009	Chronic congestive heart failure (disorder)	24	162864005	Body mass index 30+ - obesity (finding)	1095	10	439	7	3	432	653	1.74601	0.05859	3.52701	13.71384	0.90710	0.0997183687	0.6255159994	4.00913	0.67544	5	226	3	5	213	4	0.34151	0.16990
47	359817006	Closed fracture of hip	24	162864005	Body mass index 30+ - obesity (finding)	1095	29	439	14	15	425	641	1.20415	0.02755	1.40769	2.94627	0.67257	0.4428989632	1.0000000000	11.62648	0.24851	11	226	6	18	213	8	0.33626	-0.13720
44	58150001	Fracture of clavicle	24	162864005	Body mass index 30+ - obesity (finding)	1095	112	439	63	49	376	607	1.40305	0.11129	2.07561	3.08058	1.39848	0.0003350420	0.0099694858	44.90228	0.47951	55	226	34	57	213	29	-0.08732	-0.12478
43	307731004	Injury of tendon of the rotator cuff of shoulder	24	162864005	Body mass index 30+ - obesity (finding)	1095	51	439	25	26	414	630	1.22270	0.04027	1.46321	2.56888	0.83343	0.1904506889	0.8251609808	20.44658	0.27776	26	226	17	25	213	8	-0.65887	-0.48908
42	16114001	Fracture of ankle	24	162864005	Body mass index 30+ - obesity (finding)	1095	108	439	62	46	377	610	1.43192	0.11688	2.18083	3.26136	1.45830	0.0001733326	0.0056985524	43.29863	0.50809	48	226	27	60	213	35	0.27947	0.02312
41	283385000	Laceration of thigh	24	162864005	Body mass index 30+ - obesity (finding)	1095	105	439	61	44	378	612	1.44907	0.11964	2.24459	3.37649	1.49214	0.0000973340	0.0033505794	42.09589	0.52472	50	226	29	55	213	32	0.13845	0.00198
39	74400008	Appendicitis	24	162864005	Body mass index 30+ - obesity (finding)	1095	51	439	29	22	410	634	1.41833	0.07564	2.03836	3.59679	1.15517	0.0183593407	0.2349246247	20.44658	0.48422	27	226	16	24	213	13	-0.13924	-0.05736
38	398254007	Preeclampsia	24	162864005	Body mass index 30+ - obesity (finding)	1095	101	439	61	40	378	616	1.50646	0.13207	2.48519	3.77790	1.63481	0.0000171041	0.0006793655	40.49224	0.57943	101	226	61	0	213	0	1.54861	0.97672
35	19169002	Miscarriage in first trimester	24	162864005	Body mass index 30+ - obesity (finding)	1095	174	439	110	64	329	592	1.57686	0.20511	3.09271	4.32912	2.20941	0.0000000000	0.0000000020	69.75890	0.64958	174	226	110	0	213	0	1.11663	0.94849
33	429007001	History of cardiac arrest (situation)	24	162864005	Body mass index 30+ - obesity (finding)	1095	42	439	23	19	416	637	1.36593	0.05978	1.85362	3.44593	0.99709	0.0543436599	0.4513043013	16.83836	0.42805	24	226	15	18	213	8	-0.54197	-0.22314
32	410429000	Cardiac Arrest	24	162864005	Body mass index 30+ - obesity (finding)	1095	42	439	23	19	416	637	1.36593	0.05978	1.85362	3.44593	0.99709	0.0543436599	0.4513043013	16.83836	0.42805	24	226	15	18	213	8	-0.54197	-0.22314
27	408512008	Body mass index 40+ - severely obese (finding)	24	162864005	Body mass index 30+ - obesity (finding)	1095	97	439	97	0	342	656	2.49431	0.38110	0.00000	0.00000	0.00000	0.0000000000	0.0000000000	38.88858	1.29681	67	226	67	30	213	30	-0.61638	0.00000
21	15777000	Prediabetes	24	162864005	Body mass index 30+ - obesity (finding)	1095	333	439	139	194	300	462	1.04117	0.02226	1.10340	1.43366	0.84922	0.4619078665	1.0000000000	133.50411	0.05778	159	226	73	174	213	66	-0.03157	-0.13471
20	80394007	Hyperglycemia (disorder)	24	162864005	Body mass index 30+ - obesity (finding)	1095	55	439	24	31	415	625	1.08842	0.01663	1.16595	2.01516	0.67461	0.5759507976	1.0000000000	22.05023	0.11715	23	226	11	32	213	13	0.21458	-0.11325
115	36923009	Major depression  single episode	48	55680006	Drug overdose	1095	6	50	0	6	50	1039	0.00000	-0.01624	0.00000	0.00000	0.00000	1.0000000000	1.0000000000	0.27397	-0.34933	3	24	0	3	26	0	0.00000	0.00000
18	302870006	Hypertriglyceridemia (disorder)	24	162864005	Body mass index 30+ - obesity (finding)	1095	64	439	24	40	415	616	0.93536	-0.01317	0.89060	1.49973	0.52888	0.6954104148	1.0000000000	25.65845	-0.09266	28	226	11	36	213	13	0.21458	-0.06120
117	230265002	Familial Alzheimer's disease of early onset (disorder)	48	55680006	Drug overdose	1095	6	50	1	5	49	1040	3.65000	0.04303	4.24490	37.03214	0.48658	0.2450339970	0.9133257124	0.27397	0.65067	2	24	0	4	26	1	-3.29584	-1.60944
118	48333001	Burn injury(morphologic abnormality)	48	55680006	Drug overdose	1095	1	50	0	1	50	1044	0.00000	-0.00661	0.00000	0.00000	0.00000	1.0000000000	1.0000000000	0.04566	-0.06442	0	24	0	1	26	0	0.00000	0.00000
15	40055000	Chronic sinusitis (disorder)	24	162864005	Body mass index 30+ - obesity (finding)	1095	216	439	118	98	321	558	1.36263	0.14705	2.09308	2.82820	1.54903	0.0000019892	0.0000980944	86.59726	0.44200	104	226	66	112	213	52	-0.14139	-0.20248
14	10509002	Acute bronchitis (disorder)	24	162864005	Body mass index 30+ - obesity (finding)	1095	863	439	392	471	47	185	1.13299	0.20982	3.27596	4.63519	2.31532	0.0000000000	0.0000000001	345.98813	0.17964	418	226	201	445	213	191	0.00434	-0.07812
13	370247008	Facial laceration	24	162864005	Body mass index 30+ - obesity (finding)	1095	109	439	49	60	390	596	1.12129	0.03299	1.24803	1.85886	0.83793	0.3032600225	0.9949586182	43.69954	0.16167	55	226	28	54	213	21	-0.20567	-0.18633
123	195967001	Asthma	48	55680006	Drug overdose	1095	2	50	0	2	50	1043	0.00000	-0.00936	0.00000	0.00000	0.00000	1.0000000000	1.0000000000	0.09132	-0.12608	1	24	0	1	26	0	0.00000	0.00000
10	62106007	Concussion with no loss of consciousness	24	162864005	Body mass index 30+ - obesity (finding)	1095	206	439	92	114	347	542	1.11396	0.04488	1.26053	1.71170	0.92828	0.1554893606	0.7747075658	82.58813	0.15393	96	226	42	110	213	50	0.19319	0.02643
125	1734006	Fracture of the vertebral column with spinal cord injury	48	55680006	Drug overdose	1095	5	50	0	5	50	1040	0.00000	-0.01481	0.00000	0.00000	0.00000	1.0000000000	1.0000000000	0.22831	-0.29668	3	24	0	2	26	0	0.00000	0.00000
126	698754002	Chronic paralysis due to lesion of spinal cord	48	55680006	Drug overdose	1095	2	50	0	2	50	1043	0.00000	-0.00936	0.00000	0.00000	0.00000	1.0000000000	1.0000000000	0.09132	-0.12608	2	24	0	0	26	0	0.00000	0.00000
7	75498004	Acute bacterial sinusitis (disorder)	24	162864005	Body mass index 30+ - obesity (finding)	1095	187	439	94	93	345	563	1.25382	0.09423	1.64943	2.26339	1.20201	0.0023709517	0.0496711550	74.97078	0.32248	89	226	56	98	213	38	-0.27131	-0.32369
6	39848009	Whiplash injury to neck	24	162864005	Body mass index 30+ - obesity (finding)	1095	182	439	93	89	346	567	1.27456	0.10028	1.71238	2.35797	1.24355	0.0011957394	0.0286000005	72.96621	0.34579	92	226	53	90	213	40	-0.18359	-0.17221
129	47505003	Posttraumatic stress disorder	48	55680006	Drug overdose	1095	4	50	1	3	49	1042	5.47500	0.05927	7.08844	69.38713	0.72414	0.1707326340	0.7972585288	0.18265	0.75798	1	24	0	3	26	1	-3.29584	-1.38629
130	314994000	Metastasis from malignant tumor of prostate (disorder)	48	55680006	Drug overdose	1095	1	50	1	0	49	1045	21.90000	0.13822	0.00000	0.00000	0.00000	0.0456621005	0.4094197322	0.04566	0.93558	0	24	0	1	26	1	-3.29584	-0.69315
131	93761005	Primary malignant neoplasm of colon	48	55680006	Drug overdose	1095	5	50	1	4	49	1041	4.38000	0.05007	5.31122	48.41367	0.58267	0.2087375545	0.8610424124	0.22831	0.70332	3	24	0	2	26	1	-3.29584	-1.09861
132	69896004	Rheumatoid arthritis	48	55680006	Drug overdose	1095	3	50	1	2	49	1043	7.30000	0.07223	10.64286	119.38864	0.94875	0.1309405339	0.7119259731	0.13699	0.81479	2	24	1	1	26	0	3.21888	1.09861
130	314994000	Metastasis from malignant tumor of prostate (disorder)	57	192127007	Child attention deficit disorder	1095	1	76	0	1	76	1018	0.00000	-0.00826	0.00000	0.00000	0.00000	1.0000000000	1.0000000000	0.06941	-0.09681	0	24	0	1	52	0	0.00000	0.00000
130	314994000	Metastasis from malignant tumor of prostate (disorder)	111	235919008	Cholelithiasis	1095	1	9	0	1	9	1085	0.00000	-0.00275	0.00000	0.00000	0.00000	1.0000000000	1.0000000000	0.00822	-0.01181	0	7	0	1	2	0	0.00000	0.00000
129	47505003	Posttraumatic stress disorder	111	235919008	Cholelithiasis	1095	4	9	0	4	9	1082	0.00000	-0.00551	0.00000	0.00000	0.00000	1.0000000000	1.0000000000	0.03288	-0.04667	1	7	0	3	2	0	0.00000	0.00000
125	1734006	Fracture of the vertebral column with spinal cord injury	111	235919008	Cholelithiasis	1095	5	9	0	5	9	1081	0.00000	-0.00617	0.00000	0.00000	0.00000	1.0000000000	1.0000000000	0.04110	-0.05810	3	7	0	2	2	0	0.00000	0.00000
118	48333001	Burn injury(morphologic abnormality)	111	235919008	Cholelithiasis	1095	1	9	0	1	9	1085	0.00000	-0.00275	0.00000	0.00000	0.00000	1.0000000000	1.0000000000	0.00822	-0.01181	0	7	0	1	2	0	0.00000	0.00000
117	230265002	Familial Alzheimer's disease of early onset (disorder)	111	235919008	Cholelithiasis	1095	6	9	0	6	9	1080	0.00000	-0.00676	0.00000	0.00000	0.00000	1.0000000000	1.0000000000	0.04932	-0.06945	2	7	0	4	2	0	0.00000	0.00000
115	36923009	Major depression  single episode	111	235919008	Cholelithiasis	1095	6	9	0	6	9	1080	0.00000	-0.00676	0.00000	0.00000	0.00000	1.0000000000	1.0000000000	0.04932	-0.06945	3	7	0	3	2	0	0.00000	0.00000
114	449868002	Smokes tobacco daily	111	235919008	Cholelithiasis	1095	9	9	0	9	9	1077	0.00000	-0.00829	0.00000	0.00000	0.00000	1.0000000000	1.0000000000	0.07397	-0.10296	2	7	0	7	2	0	0.00000	0.00000
109	90560007	Gout	111	235919008	Cholelithiasis	1095	4	9	0	4	9	1082	0.00000	-0.00551	0.00000	0.00000	0.00000	1.0000000000	1.0000000000	0.03288	-0.04667	0	7	0	4	2	0	0.00000	0.00000
107	40275004	Contact dermatitis	111	235919008	Cholelithiasis	1095	18	9	0	18	9	1068	0.00000	-0.01177	0.00000	0.00000	0.00000	1.0000000000	1.0000000000	0.14795	-0.19905	9	7	0	9	2	0	0.00000	0.00000
106	24079001	Atopic dermatitis	111	235919008	Cholelithiasis	1095	20	9	0	20	9	1066	0.00000	-0.01242	0.00000	0.00000	0.00000	1.0000000000	1.0000000000	0.16438	-0.21957	13	7	0	7	2	0	0.00000	0.00000
102	90781000119102	Microalbuminuria due to type 2 diabetes mellitus (disorder)	111	235919008	Cholelithiasis	1095	6	9	0	6	9	1080	0.00000	-0.00676	0.00000	0.00000	0.00000	1.0000000000	1.0000000000	0.04932	-0.06945	3	7	0	3	2	0	0.00000	0.00000
98	1551000119108	Nonproliferative diabetic retinopathy due to type 2 diabetes mellitus (disorder)	111	235919008	Cholelithiasis	1095	12	9	0	12	9	1074	0.00000	-0.00958	0.00000	0.00000	0.00000	1.0000000000	1.0000000000	0.09863	-0.13571	7	7	0	5	2	0	0.00000	0.00000
97	403192003	Third degree burn	111	235919008	Cholelithiasis	1095	8	9	0	8	9	1078	0.00000	-0.00781	0.00000	0.00000	0.00000	1.0000000000	1.0000000000	0.06575	-0.09187	3	7	0	5	2	0	0.00000	0.00000
96	283371005	Laceration of forearm	111	235919008	Cholelithiasis	1095	75	9	1	74	8	1012	1.62222	0.01536	1.70946	13.85147	0.21097	0.4732325387	1.0000000000	0.61644	0.30718	39	7	1	36	2	0	2.07944	3.68888
94	703151001	History of single seizure (situation)	111	235919008	Cholelithiasis	1095	39	9	0	39	9	1047	0.00000	-0.01749	0.00000	0.00000	0.00000	1.0000000000	1.0000000000	0.32055	-0.40114	14	7	0	25	2	0	0.00000	0.00000
93	128613002	Seizure disorder	111	235919008	Cholelithiasis	1095	39	9	0	39	9	1047	0.00000	-0.01749	0.00000	0.00000	0.00000	1.0000000000	1.0000000000	0.32055	-0.40114	14	7	0	25	2	0	0.00000	0.00000
89	47693006	Rupture of appendix	111	235919008	Cholelithiasis	1095	20	9	0	20	9	1066	0.00000	-0.01242	0.00000	0.00000	0.00000	1.0000000000	1.0000000000	0.16438	-0.21957	10	7	0	10	2	0	0.00000	0.00000
86	713197008	Recurrent rectal polyp	111	235919008	Cholelithiasis	1095	22	9	0	22	9	1064	0.00000	-0.01304	0.00000	0.00000	0.00000	1.0000000000	1.0000000000	0.18082	-0.23979	12	7	0	10	2	0	0.00000	0.00000
82	94260004	Secondary malignant neoplasm of colon	111	235919008	Cholelithiasis	1095	4	9	0	4	9	1082	0.00000	-0.00551	0.00000	0.00000	0.00000	1.0000000000	1.0000000000	0.03288	-0.04667	2	7	0	2	2	0	0.00000	0.00000
78	239872002	Osteoarthritis of hip	111	235919008	Cholelithiasis	1095	21	9	0	21	9	1065	0.00000	-0.01273	0.00000	0.00000	0.00000	1.0000000000	1.0000000000	0.17260	-0.22971	13	7	0	8	2	0	0.00000	0.00000
76	127013003	Diabetic renal disease (disorder)	111	235919008	Cholelithiasis	1095	28	9	0	28	9	1058	0.00000	-0.01475	0.00000	0.00000	0.00000	1.0000000000	1.0000000000	0.23014	-0.29882	10	7	0	18	2	0	0.00000	0.00000
75	431855005	Chronic kidney disease stage 1 (disorder)	111	235919008	Cholelithiasis	1095	28	9	0	28	9	1058	0.00000	-0.01475	0.00000	0.00000	0.00000	1.0000000000	1.0000000000	0.23014	-0.29882	10	7	0	18	2	0	0.00000	0.00000
72	35999006	Blighted ovum	111	235919008	Cholelithiasis	1095	53	9	2	51	7	1035	4.59119	0.07373	5.79832	28.61657	1.17486	0.0665389404	0.5048217971	0.43562	1.06329	53	7	2	0	2	0	1.50408	3.31419
71	201834006	Localized  primary osteoarthritis of the hand	111	235919008	Cholelithiasis	1095	28	9	1	27	8	1059	4.34524	0.04933	4.90278	40.58755	0.59223	0.2086364532	0.8610424124	0.23014	0.70118	19	7	1	9	2	0	2.07944	2.99573
118	48333001	Burn injury(morphologic abnormality)	2	43878008	Streptococcal sore throat (disorder)	1095	1	523	0	1	523	571	0.00000	-0.02891	0.00000	0.00000	0.00000	1.0000000000	1.0000000000	0.47763	-0.56328	0	246	0	1	277	0	0.00000	0.00000
69	233604007	Pneumonia	111	235919008	Cholelithiasis	1095	7	9	0	7	9	1079	0.00000	-0.00730	0.00000	0.00000	0.00000	1.0000000000	1.0000000000	0.05753	-0.08070	3	7	0	4	2	0	0.00000	0.00000
120	162573006	Suspected lung cancer (situation)	2	43878008	Streptococcal sore throat (disorder)	1095	8	523	4	4	519	568	1.04685	0.00384	1.09441	4.39833	0.27232	1.0000000000	1.0000000000	3.82100	0.05259	0	246	0	8	277	4	-4.25206	-1.09861
67	403191005	Second degree burn	111	235919008	Cholelithiasis	1095	49	9	2	47	7	1039	4.96599	0.07814	6.31611	31.23450	1.27722	0.0577709668	0.4685406893	0.40274	1.09672	23	7	1	26	2	1	0.98083	-0.11778
123	195967001	Asthma	2	43878008	Streptococcal sore throat (disorder)	1095	2	523	1	1	522	571	1.04685	0.00192	1.09387	17.53278	0.06825	1.0000000000	1.0000000000	0.95525	0.03265	1	246	0	1	277	1	-5.62762	-0.69315
64	444448004	Injury of medial collateral ligament of knee	111	235919008	Cholelithiasis	1095	32	9	0	32	9	1054	0.00000	-0.01579	0.00000	0.00000	0.00000	1.0000000000	1.0000000000	0.26301	-0.33687	17	7	0	15	2	0	0.00000	0.00000
63	68496003	Polyp of colon	111	235919008	Cholelithiasis	1095	91	9	1	90	8	996	1.33700	0.00924	1.38333	11.18438	0.17110	0.5433587273	1.0000000000	0.74795	0.19434	43	7	0	48	2	1	-1.09861	-3.89182
126	698754002	Chronic paralysis due to lesion of spinal cord	2	43878008	Streptococcal sore throat (disorder)	1095	2	523	0	2	523	570	0.00000	-0.04090	0.00000	0.00000	0.00000	0.5005451070	1.0000000000	0.95525	-0.96735	2	246	0	0	277	0	0.00000	0.00000
127	431856006	Chronic kidney disease stage 2 (disorder)	2	43878008	Streptococcal sore throat (disorder)	1095	5	523	3	2	520	570	1.25621	0.01659	1.64423	9.87901	0.27366	0.6741781596	1.0000000000	2.38813	0.23951	3	246	2	2	277	1	-0.80734	-0.18232
128	86849004	Suicidal deliberate poisoning	2	43878008	Streptococcal sore throat (disorder)	1095	1	523	0	1	523	571	0.00000	-0.02891	0.00000	0.00000	0.00000	1.0000000000	1.0000000000	0.47763	-0.56328	0	246	0	1	277	0	0.00000	0.00000
59	262574004	Bullet wound	111	235919008	Cholelithiasis	1095	20	9	0	20	9	1066	0.00000	-0.01242	0.00000	0.00000	0.00000	1.0000000000	1.0000000000	0.16438	-0.21957	9	7	0	11	2	0	0.00000	0.00000
58	239720000	Tear of meniscus of knee	111	235919008	Cholelithiasis	1095	20	9	1	19	8	1067	6.08333	0.06312	7.01974	58.93898	0.83606	0.1533925818	0.7711941449	0.16438	0.78043	10	7	1	10	2	0	2.07944	2.39790
57	192127007	Child attention deficit disorder	111	235919008	Cholelithiasis	1095	76	9	0	76	9	1010	0.00000	-0.02486	0.00000	0.00000	0.00000	1.0000000000	1.0000000000	0.62466	-0.70014	24	7	0	52	2	0	0.00000	0.00000
132	69896004	Rheumatoid arthritis	2	43878008	Streptococcal sore throat (disorder)	1095	3	523	3	0	520	572	2.09369	0.05481	0.00000	0.00000	0.00000	0.1086321343	0.6488370819	1.43288	0.71734	2	246	2	1	277	1	-0.80734	0.00000
54	5602001	Opioid abuse (disorder)	111	235919008	Cholelithiasis	1095	7	9	0	7	9	1079	0.00000	-0.00730	0.00000	0.00000	0.00000	1.0000000000	1.0000000000	0.05753	-0.08070	0	7	0	7	2	0	0.00000	0.00000
52	124171000119105	Chronic intractable migraine without aura	111	235919008	Cholelithiasis	1095	51	9	0	51	9	1035	0.00000	-0.02012	0.00000	0.00000	0.00000	1.0000000000	1.0000000000	0.41918	-0.50506	21	7	0	30	2	0	0.00000	0.00000
50	446096008	Perennial allergic rhinitis	111	235919008	Cholelithiasis	1095	26	9	0	26	9	1060	0.00000	-0.01420	0.00000	0.00000	0.00000	1.0000000000	1.0000000000	0.21370	-0.27941	14	7	0	12	2	0	0.00000	0.00000
49	88805009	Chronic congestive heart failure (disorder)	111	235919008	Cholelithiasis	1095	10	9	0	10	9	1076	0.00000	-0.00874	0.00000	0.00000	0.00000	1.0000000000	1.0000000000	0.08219	-0.11396	5	7	0	5	2	0	0.00000	0.00000
47	359817006	Closed fracture of hip	111	235919008	Cholelithiasis	1095	29	9	0	29	9	1057	0.00000	-0.01502	0.00000	0.00000	0.00000	1.0000000000	1.0000000000	0.23836	-0.30843	11	7	0	18	2	0	0.00000	0.00000
44	58150001	Fracture of clavicle	111	235919008	Cholelithiasis	1095	112	9	1	111	8	975	1.08631	0.00265	1.09797	8.86025	0.13606	1.0000000000	1.0000000000	0.92055	0.05848	55	7	0	57	2	1	-1.09861	-4.06044
43	307731004	Injury of tendon of the rotator cuff of shoulder	111	235919008	Cholelithiasis	1095	51	9	0	51	9	1035	0.00000	-0.02012	0.00000	0.00000	0.00000	1.0000000000	1.0000000000	0.41918	-0.50506	26	7	0	25	2	0	0.00000	0.00000
42	16114001	Fracture of ankle	111	235919008	Cholelithiasis	1095	108	9	1	107	8	979	1.12654	0.00381	1.14369	9.23200	0.14168	0.6086580832	1.0000000000	0.88767	0.08339	48	7	1	60	2	0	2.07944	3.89182
41	283385000	Laceration of thigh	111	235919008	Cholelithiasis	1095	105	9	1	104	8	982	1.15873	0.00471	1.18029	9.52975	0.14618	0.5977768862	1.0000000000	0.86301	0.10236	50	7	1	55	2	0	2.07944	3.93183
39	74400008	Appendicitis	111	235919008	Cholelithiasis	1095	51	9	0	51	9	1035	0.00000	-0.02012	0.00000	0.00000	0.00000	1.0000000000	1.0000000000	0.41918	-0.50506	27	7	0	24	2	0	0.00000	0.00000
38	398254007	Preeclampsia	111	235919008	Cholelithiasis	1095	101	9	1	100	8	986	1.20462	0.00594	1.23250	9.95480	0.15260	0.5828505756	1.0000000000	0.83014	0.12805	101	7	1	0	2	0	2.07944	4.62497
35	19169002	Miscarriage in first trimester	111	235919008	Cholelithiasis	1095	174	9	2	172	7	914	1.39847	0.01577	1.51827	7.37033	0.31276	0.6408981043	1.0000000000	1.43014	0.30392	174	7	2	0	2	0	1.50408	4.47734
33	429007001	History of cardiac arrest (situation)	111	235919008	Cholelithiasis	1095	42	9	0	42	9	1044	0.00000	-0.01818	0.00000	0.00000	0.00000	1.0000000000	1.0000000000	0.34521	-0.42783	24	7	0	18	2	0	0.00000	0.00000
32	410429000	Cardiac Arrest	111	235919008	Cholelithiasis	1095	42	9	0	42	9	1044	0.00000	-0.01818	0.00000	0.00000	0.00000	1.0000000000	1.0000000000	0.34521	-0.42783	24	7	0	18	2	0	0.00000	0.00000
30	399211009	History of myocardial infarction (situation)	111	235919008	Cholelithiasis	1095	31	9	0	31	9	1055	0.00000	-0.01554	0.00000	0.00000	0.00000	1.0000000000	1.0000000000	0.25479	-0.32745	2	7	0	29	2	0	0.00000	0.00000
27	408512008	Body mass index 40+ - severely obese (finding)	111	235919008	Cholelithiasis	1095	97	9	0	97	9	989	0.00000	-0.02838	0.00000	0.00000	0.00000	1.0000000000	1.0000000000	0.79726	-0.84580	67	7	0	30	2	0	0.00000	0.00000
24	162864005	Body mass index 30+ - obesity (finding)	111	235919008	Cholelithiasis	1095	439	9	4	435	5	651	1.10858	0.00809	1.19724	4.48346	0.31971	1.0000000000	1.0000000000	3.60822	0.11772	226	7	4	213	2	0	1.01160	4.05178
23	36971009	Sinusitis (disorder)	111	235919008	Cholelithiasis	1095	190	9	2	188	7	898	1.28070	0.01171	1.36474	6.62120	0.28130	0.6593574246	1.0000000000	1.56164	0.22789	84	7	1	106	2	1	0.98083	-0.23018
21	15777000	Prediabetes	111	235919008	Cholelithiasis	1095	333	9	5	328	4	758	1.82683	0.04976	2.88872	10.82615	0.77079	0.1407364023	0.7371027084	2.73699	0.68309	159	7	3	174	2	2	0.51083	-0.48835
20	80394007	Hyperglycemia (disorder)	111	235919008	Cholelithiasis	1095	55	9	0	55	9	1031	0.00000	-0.02093	0.00000	0.00000	0.00000	1.0000000000	1.0000000000	0.45205	-0.53810	23	7	0	32	2	0	0.00000	0.00000
18	302870006	Hypertriglyceridemia (disorder)	111	235919008	Cholelithiasis	1095	64	9	0	64	9	1022	0.00000	-0.02268	0.00000	0.00000	0.00000	1.0000000000	1.0000000000	0.52603	-0.60978	28	7	0	36	2	0	0.00000	0.00000
17	368581000119106	Neuropathy due to type 2 diabetes mellitus (disorder)	111	235919008	Cholelithiasis	1095	28	9	0	28	9	1058	0.00000	-0.01475	0.00000	0.00000	0.00000	1.0000000000	1.0000000000	0.23014	-0.29882	7	7	0	21	2	0	0.00000	0.00000
129	47505003	Posttraumatic stress disorder	85	241929008	Acute allergic reaction	1095	4	47	0	4	47	1044	0.00000	-0.01282	0.00000	0.00000	0.00000	1.0000000000	1.0000000000	0.17169	-0.22859	1	25	0	3	22	0	0.00000	0.00000
15	40055000	Chronic sinusitis (disorder)	111	235919008	Cholelithiasis	1095	216	9	2	214	7	872	1.12654	0.00571	1.16422	5.64413	0.24014	0.6935767206	1.0000000000	1.77534	0.11230	104	7	2	112	2	0	1.50408	3.97029
14	10509002	Acute bronchitis (disorder)	111	235919008	Cholelithiasis	1095	863	9	7	856	2	230	0.98687	-0.00231	0.94042	4.55747	0.19405	1.0000000000	1.0000000000	7.09315	-0.01670	418	7	6	445	2	1	-0.32542	-1.84234
13	370247008	Facial laceration	111	235919008	Cholelithiasis	1095	109	9	2	107	7	979	2.23242	0.03730	2.61415	12.74361	0.53625	0.2232636120	0.8794911525	0.89589	0.66209	55	7	2	54	2	0	1.50408	3.34990
125	1734006	Fracture of the vertebral column with spinal cord injury	85	241929008	Acute allergic reaction	1095	5	47	0	5	47	1043	0.00000	-0.01434	0.00000	0.00000	0.00000	1.0000000000	1.0000000000	0.21461	-0.28050	3	25	0	2	22	0	0.00000	0.00000
124	1501000119109	Proliferative diabetic retinopathy due to type II diabetes mellitus (disorder)	85	241929008	Acute allergic reaction	1095	1	47	0	1	47	1047	0.00000	-0.00640	0.00000	0.00000	0.00000	1.0000000000	1.0000000000	0.04292	-0.06063	1	25	0	0	22	0	0.00000	0.00000
10	62106007	Concussion with no loss of consciousness	111	235919008	Cholelithiasis	1095	206	9	0	206	9	880	0.00000	-0.04382	0.00000	0.00000	0.00000	0.2220372390	0.8794911525	1.69315	-1.42929	96	7	0	110	2	0	0.00000	0.00000
121	254637007	Non-small cell lung cancer (disorder)	85	241929008	Acute allergic reaction	1095	8	47	0	8	47	1040	0.00000	-0.01817	0.00000	0.00000	0.00000	1.0000000000	1.0000000000	0.34338	-0.42587	0	25	0	8	22	0	0.00000	0.00000
7	75498004	Acute bacterial sinusitis (disorder)	111	235919008	Cholelithiasis	1095	187	9	1	186	8	900	0.65062	-0.01443	0.60484	4.86492	0.07520	1.0000000000	1.0000000000	1.53699	-0.34312	89	7	1	98	2	0	2.07944	4.49981
6	39848009	Whiplash injury to neck	111	235919008	Cholelithiasis	1095	182	9	1	181	8	905	0.66850	-0.01347	0.62500	5.02774	0.07769	1.0000000000	1.0000000000	1.49589	-0.31955	92	7	0	90	2	1	-1.09861	-4.51086
5	284549007	Laceration of hand	111	235919008	Cholelithiasis	1095	104	9	1	103	8	983	1.16987	0.00501	1.19296	9.63289	0.14774	0.5940905237	1.0000000000	0.85479	0.10874	54	7	1	50	2	0	2.07944	4.00733
117	230265002	Familial Alzheimer's disease of early onset (disorder)	85	241929008	Acute allergic reaction	1095	6	47	0	6	47	1042	0.00000	-0.01572	0.00000	0.00000	0.00000	1.0000000000	1.0000000000	0.25753	-0.33060	2	25	0	4	22	0	0.00000	0.00000
115	36923009	Major depression  single episode	85	241929008	Acute allergic reaction	1095	6	47	0	6	47	1042	0.00000	-0.01572	0.00000	0.00000	0.00000	1.0000000000	1.0000000000	0.25753	-0.33060	3	25	0	3	22	0	0.00000	0.00000
1	444814009	Viral sinusitis (disorder)	111	235919008	Cholelithiasis	1095	993	9	9	984	0	102	1.10272	0.02918	0.00000	0.00000	0.00000	1.0000000000	1.0000000000	8.16164	0.12632	478	7	7	515	2	2	0.00000	-1.31666
112	49436004	Atrial Fibrillation	85	241929008	Acute allergic reaction	1095	35	47	1	34	46	1014	0.66565	-0.01287	0.64834	4.84074	0.08683	1.0000000000	1.0000000000	1.50228	-0.32325	9	25	0	26	22	1	-3.13549	-3.29584
111	235919008	Cholelithiasis	85	241929008	Acute allergic reaction	1095	9	47	1	8	46	1040	2.58865	0.03063	2.82609	23.07202	0.34617	0.3272081453	1.0000000000	0.38630	0.52876	7	25	1	2	22	0	3.25810	2.07944
109	90560007	Gout	85	241929008	Acute allergic reaction	1095	4	47	0	4	47	1044	0.00000	-0.01282	0.00000	0.00000	0.00000	1.0000000000	1.0000000000	0.17169	-0.22859	0	25	0	4	22	0	0.00000	0.00000
108	40930008	Hypothyroidism (disorder)	85	241929008	Acute allergic reaction	1095	13	47	0	13	47	1035	0.00000	-0.02321	0.00000	0.00000	0.00000	1.0000000000	1.0000000000	0.55799	-0.63969	11	25	0	2	22	0	0.00000	0.00000
107	40275004	Contact dermatitis	85	241929008	Acute allergic reaction	1095	18	47	0	18	47	1030	0.00000	-0.02738	0.00000	0.00000	0.00000	1.0000000000	1.0000000000	0.77260	-0.82587	9	25	0	9	22	0	0.00000	0.00000
106	24079001	Atopic dermatitis	85	241929008	Acute allergic reaction	1095	20	47	9	11	38	1037	10.48404	0.27395	22.32775	57.07501	8.73462	0.0000000266	0.0000017075	0.85845	2.42783	13	25	6	7	22	3	-0.47804	-0.05129
105	363406005	Malignant tumor of colon	85	241929008	Acute allergic reaction	1095	6	47	0	6	47	1042	0.00000	-0.01572	0.00000	0.00000	0.00000	1.0000000000	1.0000000000	0.25753	-0.33060	4	25	0	2	22	0	0.00000	0.00000
104	367498001	Seasonal allergic rhinitis	85	241929008	Acute allergic reaction	1095	20	47	13	7	34	1041	15.14362	0.40854	56.86134	151.54733	21.33467	0.0000000000	0.0000000000	0.85845	2.91326	9	25	5	11	22	8	0.47000	0.16462
102	90781000119102	Microalbuminuria due to type 2 diabetes mellitus (disorder)	85	241929008	Acute allergic reaction	1095	6	47	1	5	46	1043	3.88298	0.04532	4.53478	39.60768	0.51920	0.2319044370	0.8920331834	0.25753	0.66940	3	25	1	3	22	0	3.25810	1.38629
101	433144002	Chronic kidney disease stage 3 (disorder)	85	241929008	Acute allergic reaction	1095	3	47	1	2	46	1046	7.76596	0.07510	11.36957	127.67529	1.01247	0.1234270883	0.6913144812	0.12877	0.82525	1	25	1	2	22	0	3.25810	0.69315
100	161622006	History of lower limb amputation (situation)	85	241929008	Acute allergic reaction	1095	1	47	0	1	47	1047	0.00000	-0.00640	0.00000	0.00000	0.00000	1.0000000000	1.0000000000	0.04292	-0.06063	0	25	0	1	22	0	0.00000	0.00000
99	30832001	Rupture of patellar tendon	85	241929008	Acute allergic reaction	1095	23	47	0	23	47	1025	0.00000	-0.03102	0.00000	0.00000	0.00000	0.6198990965	1.0000000000	0.98721	-0.99075	14	25	0	9	22	0	0.00000	0.00000
98	1551000119108	Nonproliferative diabetic retinopathy due to type 2 diabetes mellitus (disorder)	85	241929008	Acute allergic reaction	1095	12	47	0	12	47	1036	0.00000	-0.02229	0.00000	0.00000	0.00000	1.0000000000	1.0000000000	0.51507	-0.59938	7	25	0	5	22	0	0.00000	0.00000
97	403192003	Third degree burn	85	241929008	Acute allergic reaction	1095	8	47	0	8	47	1040	0.00000	-0.01817	0.00000	0.00000	0.00000	1.0000000000	1.0000000000	0.34338	-0.42587	3	25	0	5	22	0	0.00000	0.00000
96	283371005	Laceration of forearm	85	241929008	Acute allergic reaction	1095	75	47	4	71	43	977	1.24255	0.01393	1.28005	3.66707	0.44682	0.5568530806	1.0000000000	3.21918	0.24497	39	25	3	36	22	1	-0.90190	-0.97186
95	84757009	Epilepsy	85	241929008	Acute allergic reaction	1095	30	47	2	28	45	1020	1.55319	0.01966	1.61905	7.00850	0.37402	0.3722514286	1.0000000000	1.28767	0.39108	13	25	2	17	22	0	2.60269	2.01490
94	703151001	History of single seizure (situation)	85	241929008	Acute allergic reaction	1095	39	47	2	37	45	1011	1.19476	0.00793	1.21441	5.19724	0.28377	0.6821109741	1.0000000000	1.67397	0.16598	14	25	2	25	22	0	2.60269	2.07944
93	128613002	Seizure disorder	85	241929008	Acute allergic reaction	1095	39	47	2	37	45	1011	1.19476	0.00793	1.21441	5.19724	0.28377	0.6821109741	1.0000000000	1.67397	0.16598	14	25	2	25	22	0	2.60269	2.07944
89	47693006	Rupture of appendix	85	241929008	Acute allergic reaction	1095	20	47	0	20	47	1028	0.00000	-0.02889	0.00000	0.00000	0.00000	1.0000000000	1.0000000000	0.85845	-0.89410	10	25	0	10	22	0	0.00000	0.00000
86	713197008	Recurrent rectal polyp	85	241929008	Acute allergic reaction	1095	22	47	1	21	46	1027	1.05899	0.00179	1.06315	8.07645	0.13995	1.0000000000	1.0000000000	0.94429	0.04075	12	25	0	10	22	1	-3.13549	-2.39790
82	94260004	Secondary malignant neoplasm of colon	85	241929008	Acute allergic reaction	1095	4	47	0	4	47	1044	0.00000	-0.01282	0.00000	0.00000	0.00000	1.0000000000	1.0000000000	0.17169	-0.22859	2	25	0	2	22	0	0.00000	0.00000
80	6072007	Bleeding from anus	85	241929008	Acute allergic reaction	1095	4	47	0	4	47	1044	0.00000	-0.01282	0.00000	0.00000	0.00000	1.0000000000	1.0000000000	0.17169	-0.22859	2	25	0	2	22	0	0.00000	0.00000
78	239872002	Osteoarthritis of hip	85	241929008	Acute allergic reaction	1095	21	47	0	21	47	1027	0.00000	-0.02961	0.00000	0.00000	0.00000	1.0000000000	1.0000000000	0.90137	-0.92704	13	25	0	8	22	0	0.00000	0.00000
76	127013003	Diabetic renal disease (disorder)	85	241929008	Acute allergic reaction	1095	28	47	1	27	46	1021	0.83207	-0.00576	0.82206	6.18258	0.10930	1.0000000000	1.0000000000	1.20183	-0.13870	10	25	1	18	22	0	3.25810	2.39790
75	431855005	Chronic kidney disease stage 1 (disorder)	85	241929008	Acute allergic reaction	1095	28	47	1	27	46	1021	0.83207	-0.00576	0.82206	6.18258	0.10930	1.0000000000	1.0000000000	1.20183	-0.13870	10	25	1	18	22	0	3.25810	2.39790
73	196416002	Impacted molars	85	241929008	Acute allergic reaction	1095	49	47	0	49	47	999	0.00000	-0.04584	0.00000	0.00000	0.00000	0.2648801038	0.9337821491	2.10320	-1.63375	25	25	0	24	22	0	0.00000	0.00000
72	35999006	Blighted ovum	85	241929008	Acute allergic reaction	1095	53	47	2	51	45	997	0.87916	-0.00577	0.86885	3.68201	0.20502	1.0000000000	1.0000000000	2.27489	-0.12648	53	25	2	0	22	0	2.60269	3.31419
71	201834006	Localized  primary osteoarthritis of the hand	85	241929008	Acute allergic reaction	1095	28	47	0	28	47	1020	0.00000	-0.03431	0.00000	0.00000	0.00000	0.6285419130	1.0000000000	1.20183	-1.13870	19	25	0	9	22	0	0.00000	0.00000
70	87433001	Pulmonary emphysema (disorder)	85	241929008	Acute allergic reaction	1095	17	47	0	17	47	1031	0.00000	-0.02659	0.00000	0.00000	0.00000	1.0000000000	1.0000000000	0.72968	-0.79051	9	25	0	8	22	0	0.00000	0.00000
69	233604007	Pneumonia	85	241929008	Acute allergic reaction	1095	7	47	0	7	47	1041	0.00000	-0.01699	0.00000	0.00000	0.00000	1.0000000000	1.0000000000	0.30046	-0.37902	3	25	0	4	22	0	0.00000	0.00000
68	26929004	Alzheimer's disease (disorder)	85	241929008	Acute allergic reaction	1095	23	47	0	23	47	1025	0.00000	-0.03102	0.00000	0.00000	0.00000	0.6198990965	1.0000000000	0.98721	-0.99075	15	25	0	8	22	0	0.00000	0.00000
67	403191005	Second degree burn	85	241929008	Acute allergic reaction	1095	49	47	3	46	44	1002	1.42640	0.01954	1.48518	4.96209	0.44452	0.4630281811	1.0000000000	2.10320	0.36625	23	25	2	26	22	1	-0.53280	-0.77011
65	239873007	Osteoarthritis of knee	85	241929008	Acute allergic reaction	1095	57	47	0	57	47	991	0.00000	-0.04963	0.00000	0.00000	0.00000	0.1685254091	0.7953568293	2.44658	-1.78516	30	25	0	27	22	0	0.00000	0.00000
64	444448004	Injury of medial collateral ligament of knee	85	241929008	Acute allergic reaction	1095	32	47	2	30	45	1018	1.45612	0.01676	1.50815	6.50809	0.34949	0.6441747356	1.0000000000	1.37352	0.33794	17	25	0	15	22	2	-2.48491	-2.14007
63	68496003	Polyp of colon	85	241929008	Acute allergic reaction	1095	91	47	2	89	45	959	0.51204	-0.03111	0.47890	2.00704	0.11427	0.4221429844	1.0000000000	3.90594	-0.70957	43	25	0	48	22	2	-2.48491	-3.21888
62	185086009	Chronic obstructive bronchitis (disorder)	85	241929008	Acute allergic reaction	1095	6	47	0	6	47	1042	0.00000	-0.01572	0.00000	0.00000	0.00000	1.0000000000	1.0000000000	0.25753	-0.33060	4	25	0	2	22	0	0.00000	0.00000
59	262574004	Bullet wound	85	241929008	Acute allergic reaction	1095	20	47	0	20	47	1028	0.00000	-0.02889	0.00000	0.00000	0.00000	1.0000000000	1.0000000000	0.85845	-0.89410	9	25	0	11	22	0	0.00000	0.00000
58	239720000	Tear of meniscus of knee	85	241929008	Acute allergic reaction	1095	20	47	1	19	46	1029	1.16489	0.00476	1.17735	8.98649	0.15425	0.5874067513	1.0000000000	0.85845	0.10590	10	25	1	10	22	0	3.25810	2.39790
57	192127007	Child attention deficit disorder	85	241929008	Acute allergic reaction	1095	76	47	5	71	42	977	1.53275	0.03081	1.63816	4.26990	0.62849	0.3695266995	1.0000000000	3.26210	0.49340	24	25	3	52	22	2	-0.25131	-1.09861
56	92691004	Carcinoma in situ of prostate (disorder)	85	241929008	Acute allergic reaction	1095	23	47	1	22	46	1026	1.01295	0.00040	1.01383	7.68606	0.13373	1.0000000000	1.0000000000	0.98721	0.00925	0	25	0	23	22	1	-3.13549	-3.17805
54	5602001	Opioid abuse (disorder)	85	241929008	Acute allergic reaction	1095	7	47	0	7	47	1041	0.00000	-0.01699	0.00000	0.00000	0.00000	1.0000000000	1.0000000000	0.30046	-0.37902	0	25	0	7	22	0	0.00000	0.00000
52	124171000119105	Chronic intractable migraine without aura	85	241929008	Acute allergic reaction	1095	51	47	0	51	47	997	0.00000	-0.04681	0.00000	0.00000	0.00000	0.1635688968	0.7879650300	2.18904	-1.67312	21	25	0	30	22	0	0.00000	0.00000
50	446096008	Perennial allergic rhinitis	85	241929008	Acute allergic reaction	1095	26	47	10	16	37	1032	8.96072	0.26292	17.43243	41.00838	7.41043	0.0000000253	0.0000016331	1.11598	2.37810	14	25	6	12	22	4	-0.22957	-0.18232
49	88805009	Chronic congestive heart failure (disorder)	85	241929008	Acute allergic reaction	1095	10	47	0	10	47	1038	0.00000	-0.02033	0.00000	0.00000	0.00000	1.0000000000	1.0000000000	0.42922	-0.51523	5	25	0	5	22	0	0.00000	0.00000
47	359817006	Closed fracture of hip	85	241929008	Acute allergic reaction	1095	29	47	3	26	44	1022	2.41012	0.04925	2.68007	9.19301	0.78133	0.1241607109	0.6913144812	1.24475	0.83345	11	25	1	18	22	2	0.77319	0.18232
46	62564004	Concussion with loss of consciousness	85	241929008	Acute allergic reaction	1095	67	47	3	64	44	984	1.04319	0.00233	1.04830	3.46846	0.31683	0.7616560105	1.0000000000	2.87580	0.04551	36	25	2	31	22	1	-0.53280	-0.52130
45	263102004	Fracture subluxation of wrist	85	241929008	Acute allergic reaction	1095	109	47	9	100	38	948	1.92368	0.06504	2.24526	4.77820	1.05504	0.0431237443	0.3985498161	4.67854	0.81641	51	25	5	58	22	4	-0.08004	-0.32493
44	58150001	Fracture of clavicle	85	241929008	Acute allergic reaction	1095	112	47	4	108	43	940	0.83207	-0.01200	0.80965	2.29921	0.28511	1.0000000000	1.0000000000	4.80731	-0.21594	55	25	3	57	22	1	-0.90190	-1.09861
43	307731004	Injury of tendon of the rotator cuff of shoulder	85	241929008	Acute allergic reaction	1095	51	47	2	49	45	999	0.91364	-0.00404	0.90612	3.84406	0.21359	1.0000000000	1.0000000000	2.18904	-0.08816	26	25	1	25	22	1	0.12260	0.03774
42	16114001	Fracture of ankle	85	241929008	Acute allergic reaction	1095	108	47	6	102	41	946	1.29433	0.02062	1.35725	3.27453	0.56256	0.4541553185	1.0000000000	4.63562	0.31278	48	25	4	60	22	2	-0.50391	-0.86904
41	283385000	Laceration of thigh	85	241929008	Acute allergic reaction	1095	105	47	1	104	46	944	0.22188	-0.05366	0.19732	1.44567	0.02693	0.0784623992	0.5538932862	4.50685	-1.46123	50	25	1	55	22	0	3.25810	3.93183
39	74400008	Appendicitis	85	241929008	Acute allergic reaction	1095	51	47	5	46	42	1002	2.28411	0.06010	2.59317	6.86250	0.97989	0.0624371316	0.4854500809	2.18904	0.91184	27	25	4	24	22	1	-1.15449	-1.17118
38	398254007	Preeclampsia	85	241929008	Acute allergic reaction	1095	101	47	3	98	44	950	0.69202	-0.02079	0.66095	2.16796	0.20150	0.7947397934	1.0000000000	4.33516	-0.41553	101	25	3	0	22	0	2.23359	3.54578
35	19169002	Miscarriage in first trimester	85	241929008	Acute allergic reaction	1095	174	47	8	166	39	882	1.07117	0.00655	1.08990	2.37420	0.50033	0.8381766849	1.0000000000	7.46849	0.08782	174	25	8	0	22	0	1.41707	3.12457
33	429007001	History of cardiac arrest (situation)	85	241929008	Acute allergic reaction	1095	42	47	0	42	47	1006	0.00000	-0.04229	0.00000	0.00000	0.00000	0.2537355766	0.9133257124	1.80274	-1.48684	24	25	0	18	22	0	0.00000	0.00000
32	410429000	Cardiac Arrest	85	241929008	Acute allergic reaction	1095	42	47	0	42	47	1006	0.00000	-0.04229	0.00000	0.00000	0.00000	0.2537355766	0.9133257124	1.80274	-1.48684	24	25	0	18	22	0	0.00000	0.00000
30	399211009	History of myocardial infarction (situation)	85	241929008	Acute allergic reaction	1095	31	47	1	30	46	1018	0.75154	-0.00898	0.73768	5.52844	0.09843	1.0000000000	1.0000000000	1.33059	-0.22070	2	25	0	29	22	1	-3.13549	-3.40120
29	22298006	Myocardial Infarction	85	241929008	Acute allergic reaction	1095	31	47	1	30	46	1018	0.75154	-0.00898	0.73768	5.52844	0.09843	1.0000000000	1.0000000000	1.33059	-0.22070	2	25	0	29	22	1	-3.13549	-3.40120
28	53741008	Coronary Heart Disease	85	241929008	Acute allergic reaction	1095	80	47	1	79	46	969	0.29122	-0.04214	0.26665	1.95925	0.03629	0.2487427231	0.9133257124	3.43379	-1.14854	24	25	0	56	22	1	-3.13549	-4.04305
27	408512008	Body mass index 40+ - severely obese (finding)	85	241929008	Acute allergic reaction	1095	97	47	5	92	42	956	1.20092	0.01327	1.23706	3.20378	0.47766	0.6002786812	1.0000000000	4.16347	0.21662	67	25	4	30	22	1	-1.15449	-0.55760
26	33737001	Fracture of rib	85	241929008	Acute allergic reaction	1095	54	47	1	53	46	995	0.43144	-0.02742	0.40812	3.01663	0.05522	0.7250678405	1.0000000000	2.31781	-0.73023	32	25	0	22	22	1	-3.13549	-3.13549
24	162864005	Body mass index 30+ - obesity (finding)	85	241929008	Acute allergic reaction	1095	439	47	14	425	33	623	0.74298	-0.04453	0.62189	1.17609	0.32884	0.1709730531	0.7972585288	18.84292	-0.40366	226	25	9	213	22	5	-0.35726	-0.51270
23	36971009	Sinusitis (disorder)	85	241929008	Acute allergic reaction	1095	190	47	9	181	38	867	1.10358	0.01005	1.13449	2.38740	0.53910	0.6959107310	1.0000000000	8.15525	0.12733	84	25	5	106	22	4	-0.08004	-0.43499
21	15777000	Prediabetes	85	241929008	Acute allergic reaction	1095	333	47	10	323	37	725	0.69964	-0.04205	0.60664	1.23483	0.29803	0.1956342541	0.8340316782	14.29315	-0.47538	159	25	5	174	22	5	0.10536	-0.08752
20	80394007	Hyperglycemia (disorder)	85	241929008	Acute allergic reaction	1095	55	47	2	53	45	995	0.84720	-0.00744	0.83438	3.53249	0.19708	1.0000000000	1.0000000000	2.36073	-0.16381	23	25	2	32	22	0	2.60269	2.52573
19	237602007	Metabolic syndrome X (disorder)	85	241929008	Acute allergic reaction	1095	64	47	2	62	45	986	0.72806	-0.01435	0.70681	2.98153	0.16756	1.0000000000	1.0000000000	2.74703	-0.32079	28	25	2	36	22	0	2.60269	2.70805
18	302870006	Hypertriglyceridemia (disorder)	85	241929008	Acute allergic reaction	1095	64	47	2	62	45	986	0.72806	-0.01435	0.70681	2.98153	0.16756	1.0000000000	1.0000000000	2.74703	-0.32079	28	25	2	36	22	0	2.60269	2.70805
17	368581000119106	Neuropathy due to type 2 diabetes mellitus (disorder)	85	241929008	Acute allergic reaction	1095	28	47	1	27	46	1021	0.83207	-0.00576	0.82206	6.18258	0.10930	1.0000000000	1.0000000000	1.20183	-0.13870	7	25	1	21	22	0	3.25810	2.07944
129	47505003	Posttraumatic stress disorder	59	262574004	Bullet wound	1095	4	20	0	4	20	1071	0.00000	-0.00826	0.00000	0.00000	0.00000	1.0000000000	1.0000000000	0.07306	-0.10173	1	9	0	3	11	0	0.00000	0.00000
15	40055000	Chronic sinusitis (disorder)	85	241929008	Acute allergic reaction	1095	216	47	9	207	38	841	0.97074	-0.00307	0.96224	2.02149	0.45803	1.0000000000	1.0000000000	9.27123	-0.03861	104	25	6	112	22	3	-0.47804	-0.73760
14	10509002	Acute bronchitis (disorder)	85	241929008	Acute allergic reaction	1095	863	47	36	827	11	221	0.97187	-0.01149	0.87457	1.74600	0.43808	0.7155267157	1.0000000000	37.04201	-0.04007	418	25	20	445	22	16	-0.05407	-0.27432
13	370247008	Facial laceration	85	241929008	Acute allergic reaction	1095	109	47	4	105	43	943	0.85497	-0.01021	0.83544	2.37359	0.29405	1.0000000000	1.0000000000	4.67854	-0.18359	55	25	1	54	22	3	1.13783	1.08091
125	1734006	Fracture of the vertebral column with spinal cord injury	59	262574004	Bullet wound	1095	5	20	0	5	20	1070	0.00000	-0.00924	0.00000	0.00000	0.00000	1.0000000000	1.0000000000	0.09132	-0.12608	3	9	0	2	11	0	0.00000	0.00000
10	62106007	Concussion with no loss of consciousness	85	241929008	Acute allergic reaction	1095	206	47	11	195	36	853	1.24406	0.02488	1.33661	2.67261	0.66846	0.4442311669	1.0000000000	8.84201	0.28601	96	25	5	110	22	6	0.25131	0.04385
9	44465007	Sprain of ankle	85	241929008	Acute allergic reaction	1095	362	47	15	347	32	701	0.96538	-0.00515	0.94696	1.77207	0.50603	1.0000000000	1.0000000000	15.53790	-0.04770	185	25	9	177	22	6	-0.21131	-0.34709
8	233678006	Childhood asthma	85	241929008	Acute allergic reaction	1095	45	47	17	28	30	1020	8.80142	0.34202	20.64286	41.71734	10.21464	0.0000000000	0.0000000000	1.93151	2.61828	25	25	10	20	22	7	-0.16862	-0.09716
7	75498004	Acute bacterial sinusitis (disorder)	85	241929008	Acute allergic reaction	1095	187	47	6	181	41	867	0.74753	-0.02426	0.70098	1.67578	0.29322	0.5526991982	1.0000000000	8.02648	-0.36681	89	25	5	98	22	1	-1.34373	-1.66126
6	39848009	Whiplash injury to neck	85	241929008	Acute allergic reaction	1095	182	47	6	176	41	872	0.76806	-0.02193	0.72506	1.73390	0.30319	0.5531780112	1.0000000000	7.81187	-0.33209	92	25	3	90	22	3	0.11333	0.02128
5	284549007	Laceration of hand	85	241929008	Acute allergic reaction	1095	104	47	0	104	47	944	0.00000	-0.06860	0.00000	0.00000	0.00000	0.0181753006	0.2342772228	4.46393	-2.44994	54	25	0	50	22	0	0.00000	0.00000
117	230265002	Familial Alzheimer's disease of early onset (disorder)	59	262574004	Bullet wound	1095	6	20	0	6	20	1069	0.00000	-0.01012	0.00000	0.00000	0.00000	1.0000000000	1.0000000000	0.10959	-0.15003	2	9	0	4	11	0	0.00000	0.00000
115	36923009	Major depression  single episode	59	262574004	Bullet wound	1095	6	20	0	6	20	1069	0.00000	-0.01012	0.00000	0.00000	0.00000	1.0000000000	1.0000000000	0.10959	-0.15003	3	9	0	3	11	0	0.00000	0.00000
1	444814009	Viral sinusitis (disorder)	85	241929008	Acute allergic reaction	1095	993	47	42	951	5	97	0.98541	-0.00964	0.85678	2.21644	0.33120	0.7956037186	1.0000000000	42.62192	-0.02072	478	25	23	515	22	19	-0.03343	-0.25484
109	90560007	Gout	59	262574004	Bullet wound	1095	4	20	0	4	20	1071	0.00000	-0.00826	0.00000	0.00000	0.00000	1.0000000000	1.0000000000	0.07306	-0.10173	0	9	0	4	11	0	0.00000	0.00000
106	24079001	Atopic dermatitis	59	262574004	Bullet wound	1095	20	20	0	20	20	1055	0.00000	-0.01860	0.00000	0.00000	0.00000	1.0000000000	1.0000000000	0.36530	-0.44921	13	9	0	7	11	0	0.00000	0.00000
102	90781000119102	Microalbuminuria due to type 2 diabetes mellitus (disorder)	59	262574004	Bullet wound	1095	6	20	0	6	20	1069	0.00000	-0.01012	0.00000	0.00000	0.00000	1.0000000000	1.0000000000	0.10959	-0.15003	3	9	0	3	11	0	0.00000	0.00000
98	1551000119108	Nonproliferative diabetic retinopathy due to type 2 diabetes mellitus (disorder)	59	262574004	Bullet wound	1095	12	20	0	12	20	1063	0.00000	-0.01436	0.00000	0.00000	0.00000	1.0000000000	1.0000000000	0.21918	-0.28591	7	9	0	5	11	0	0.00000	0.00000
97	403192003	Third degree burn	59	262574004	Bullet wound	1095	8	20	0	8	20	1067	0.00000	-0.01170	0.00000	0.00000	0.00000	1.0000000000	1.0000000000	0.14612	-0.19676	3	9	0	5	11	0	0.00000	0.00000
96	283371005	Laceration of forearm	59	262574004	Bullet wound	1095	75	20	0	75	20	1000	0.00000	-0.03699	0.00000	0.00000	0.00000	0.3909895050	1.0000000000	1.36986	-1.24480	39	9	0	36	11	0	0.00000	0.00000
94	703151001	History of single seizure (situation)	59	262574004	Bullet wound	1095	39	20	0	39	20	1036	0.00000	-0.02621	0.00000	0.00000	0.00000	1.0000000000	1.0000000000	0.71233	-0.77596	14	9	0	25	11	0	0.00000	0.00000
93	128613002	Seizure disorder	59	262574004	Bullet wound	1095	39	20	0	39	20	1036	0.00000	-0.02621	0.00000	0.00000	0.00000	1.0000000000	1.0000000000	0.71233	-0.77596	14	9	0	25	11	0	0.00000	0.00000
89	47693006	Rupture of appendix	59	262574004	Bullet wound	1095	20	20	0	20	20	1055	0.00000	-0.01860	0.00000	0.00000	0.00000	1.0000000000	1.0000000000	0.36530	-0.44921	10	9	0	10	11	0	0.00000	0.00000
86	713197008	Recurrent rectal polyp	59	262574004	Bullet wound	1095	22	20	0	22	20	1053	0.00000	-0.01953	0.00000	0.00000	0.00000	1.0000000000	1.0000000000	0.40183	-0.48731	12	9	0	10	11	0	0.00000	0.00000
82	94260004	Secondary malignant neoplasm of colon	59	262574004	Bullet wound	1095	4	20	0	4	20	1071	0.00000	-0.00826	0.00000	0.00000	0.00000	1.0000000000	1.0000000000	0.07306	-0.10173	2	9	0	2	11	0	0.00000	0.00000
76	127013003	Diabetic renal disease (disorder)	59	262574004	Bullet wound	1095	28	20	0	28	20	1047	0.00000	-0.02210	0.00000	0.00000	0.00000	1.0000000000	1.0000000000	0.51142	-0.59590	10	9	0	18	11	0	0.00000	0.00000
75	431855005	Chronic kidney disease stage 1 (disorder)	59	262574004	Bullet wound	1095	28	20	0	28	20	1047	0.00000	-0.02210	0.00000	0.00000	0.00000	1.0000000000	1.0000000000	0.51142	-0.59590	10	9	0	18	11	0	0.00000	0.00000
72	35999006	Blighted ovum	59	262574004	Bullet wound	1095	53	20	0	53	20	1022	0.00000	-0.03076	0.00000	0.00000	0.00000	0.6192657233	1.0000000000	0.96804	-0.97676	53	9	0	0	11	0	0.00000	0.00000
71	201834006	Localized  primary osteoarthritis of the hand	59	262574004	Bullet wound	1095	28	20	0	28	20	1047	0.00000	-0.02210	0.00000	0.00000	0.00000	1.0000000000	1.0000000000	0.51142	-0.59590	19	9	0	9	11	0	0.00000	0.00000
69	233604007	Pneumonia	59	262574004	Bullet wound	1095	7	20	0	7	20	1068	0.00000	-0.01094	0.00000	0.00000	0.00000	1.0000000000	1.0000000000	0.12785	-0.17358	3	9	0	4	11	0	0.00000	0.00000
67	403191005	Second degree burn	59	262574004	Bullet wound	1095	49	20	1	48	19	1027	1.11735	0.00346	1.12610	8.58797	0.14766	0.6030116966	1.0000000000	0.89498	0.07782	23	9	0	26	11	1	-2.48491	-3.29584
64	444448004	Injury of medial collateral ligament of knee	59	262574004	Bullet wound	1095	32	20	0	32	20	1043	0.00000	-0.02367	0.00000	0.00000	0.00000	1.0000000000	1.0000000000	0.58447	-0.66400	17	9	0	15	11	0	0.00000	0.00000
63	68496003	Polyp of colon	59	262574004	Bullet wound	1095	91	20	2	89	18	986	1.20330	0.00835	1.23096	5.39076	0.28109	0.6792911859	1.0000000000	1.66210	0.17240	43	9	2	48	11	0	1.70475	3.11352
58	239720000	Tear of meniscus of knee	59	262574004	Bullet wound	1095	20	20	0	20	20	1055	0.00000	-0.01860	0.00000	0.00000	0.00000	1.0000000000	1.0000000000	0.36530	-0.44921	10	9	0	10	11	0	0.00000	0.00000
57	192127007	Child attention deficit disorder	59	262574004	Bullet wound	1095	76	20	1	75	19	1000	0.72039	-0.01042	0.70175	5.31406	0.09267	1.0000000000	1.0000000000	1.38813	-0.25588	24	9	0	52	11	1	-2.48491	-3.97029
54	5602001	Opioid abuse (disorder)	59	262574004	Bullet wound	1095	7	20	1	6	19	1069	7.82143	0.07463	9.37719	81.72348	1.07597	0.1213724093	0.6889733259	0.12785	0.82642	0	9	0	7	11	1	-2.48491	-2.07944
50	446096008	Perennial allergic rhinitis	59	262574004	Bullet wound	1095	26	20	1	25	19	1050	2.10577	0.02352	2.21053	17.16473	0.28468	0.3842327652	1.0000000000	0.47489	0.43940	14	9	0	12	11	1	-2.48491	-2.56495
49	88805009	Chronic congestive heart failure (disorder)	59	262574004	Bullet wound	1095	10	20	0	10	20	1065	0.00000	-0.01309	0.00000	0.00000	0.00000	1.0000000000	1.0000000000	0.18265	-0.24202	5	9	0	5	11	0	0.00000	0.00000
47	359817006	Closed fracture of hip	59	262574004	Bullet wound	1095	29	20	1	28	19	1047	1.88793	0.01998	1.96805	15.22059	0.25447	0.4181826721	1.0000000000	0.52968	0.38677	11	9	1	18	11	0	2.30259	2.48491
44	58150001	Fracture of clavicle	59	262574004	Bullet wound	1095	112	20	2	110	18	965	0.97768	-0.00103	0.97475	4.25694	0.22320	1.0000000000	1.0000000000	2.04566	-0.02179	55	9	1	57	11	1	-0.18232	-0.03509
43	307731004	Injury of tendon of the rotator cuff of shoulder	59	262574004	Bullet wound	1095	51	20	0	51	20	1024	0.00000	-0.03015	0.00000	0.00000	0.00000	1.0000000000	1.0000000000	0.93151	-0.94973	26	9	0	25	11	0	0.00000	0.00000
42	16114001	Fracture of ankle	59	262574004	Bullet wound	1095	108	20	1	107	19	968	0.50694	-0.02225	0.47614	3.59210	0.06311	0.7122123271	1.0000000000	1.97260	-0.57173	48	9	0	60	11	1	-2.48491	-4.11087
41	283385000	Laceration of thigh	59	262574004	Bullet wound	1095	105	20	3	102	17	973	1.56429	0.02507	1.68339	5.84171	0.48510	0.4299438688	1.0000000000	1.91781	0.45511	50	9	3	55	11	0	1.38629	2.87168
39	74400008	Appendicitis	59	262574004	Bullet wound	1095	51	20	1	50	19	1025	1.07353	0.00222	1.07895	8.22193	0.14159	0.6180548828	1.0000000000	0.93151	0.05027	27	9	1	24	11	0	2.30259	3.33220
38	398254007	Preeclampsia	59	262574004	Bullet wound	1095	101	20	1	100	19	975	0.54208	-0.01991	0.51316	3.87372	0.06798	1.0000000000	1.0000000000	1.84475	-0.50830	101	9	1	0	11	0	2.30259	4.62497
35	19169002	Miscarriage in first trimester	59	262574004	Bullet wound	1095	174	20	2	172	18	903	0.62931	-0.02198	0.58333	2.53691	0.13413	0.7565265678	1.0000000000	3.17808	-0.47788	174	9	2	0	11	0	1.70475	4.47734
33	429007001	History of cardiac arrest (situation)	59	262574004	Bullet wound	1095	42	20	1	41	19	1034	1.30357	0.00827	1.32734	10.15675	0.17346	0.5458048964	1.0000000000	0.76712	0.17860	24	9	1	18	11	0	2.30259	3.21888
32	410429000	Cardiac Arrest	59	262574004	Bullet wound	1095	42	20	1	41	19	1034	1.30357	0.00827	1.32734	10.15675	0.17346	0.5458048964	1.0000000000	0.76712	0.17860	24	9	1	18	11	0	2.30259	3.21888
30	399211009	History of myocardial infarction (situation)	59	262574004	Bullet wound	1095	31	20	1	30	19	1045	1.76613	0.01784	1.83333	14.14710	0.23758	0.4398197230	1.0000000000	0.56621	0.35272	2	9	0	29	11	1	-2.48491	-3.40120
27	408512008	Body mass index 40+ - severely obese (finding)	59	262574004	Bullet wound	1095	97	20	2	95	18	980	1.12887	0.00548	1.14620	5.01497	0.26197	0.6952591165	1.0000000000	1.77169	0.11420	67	9	0	30	11	2	-1.87180	-2.77259
24	162864005	Body mass index 30+ - obesity (finding)	59	262574004	Bullet wound	1095	439	20	8	431	12	644	0.99772	-0.00025	0.99613	2.45715	0.40383	1.0000000000	1.0000000000	8.01826	-0.00292	226	9	3	213	11	5	0.22314	0.56005
23	36971009	Sinusitis (disorder)	59	262574004	Bullet wound	1095	190	20	3	187	17	888	0.86447	-0.00847	0.83800	2.88848	0.24312	1.0000000000	1.0000000000	3.47032	-0.16038	84	9	1	106	11	2	0.43078	0.45367
21	15777000	Prediabetes	59	262574004	Bullet wound	1095	333	20	8	325	12	750	1.31532	0.02843	1.53846	3.79924	0.62298	0.3366811480	1.0000000000	6.08219	0.34573	159	9	3	174	11	5	0.22314	0.41104
20	80394007	Hyperglycemia (disorder)	59	262574004	Bullet wound	1095	55	20	1	54	19	1021	0.99545	-0.00014	0.99513	7.57260	0.13077	1.0000000000	1.0000000000	1.00457	-0.00329	23	9	0	32	11	1	-2.48491	-3.49651
18	302870006	Hypertriglyceridemia (disorder)	59	262574004	Bullet wound	1095	64	20	1	63	19	1012	0.85547	-0.00491	0.84545	6.41754	0.11138	1.0000000000	1.0000000000	1.16895	-0.11700	28	9	0	36	11	1	-2.48491	-3.61092
17	368581000119106	Neuropathy due to type 2 diabetes mellitus (disorder)	59	262574004	Bullet wound	1095	28	20	1	27	19	1048	1.95536	0.02111	2.04288	15.81901	0.26382	0.4070686830	1.0000000000	0.51142	0.40410	7	9	0	21	11	1	-2.48491	-3.09104
15	40055000	Chronic sinusitis (disorder)	59	262574004	Bullet wound	1095	216	20	3	213	17	862	0.76042	-0.01620	0.71417	2.45928	0.20739	0.7798663570	1.0000000000	3.94521	-0.30603	104	9	1	112	11	2	0.43078	0.61091
14	10509002	Acute bronchitis (disorder)	59	262574004	Bullet wound	1095	863	20	17	846	3	229	1.07851	0.02065	1.53388	5.27952	0.44565	0.7817760539	1.0000000000	15.76256	0.10275	418	9	8	445	11	9	-0.04474	0.05413
13	370247008	Facial laceration	59	262574004	Bullet wound	1095	109	20	2	107	18	968	1.00459	0.00021	1.00519	4.39134	0.23009	1.0000000000	1.0000000000	1.99087	0.00440	55	9	0	54	11	2	-1.87180	-3.33220
125	1734006	Fracture of the vertebral column with spinal cord injury	33	429007001	History of cardiac arrest (situation)	1095	5	42	1	4	41	1049	5.21429	0.05700	6.39634	58.50650	0.69929	0.1779227643	0.8046398895	0.19178	0.74688	3	24	0	2	18	1	-2.94444	-1.09861
10	62106007	Concussion with no loss of consciousness	59	262574004	Bullet wound	1095	206	20	3	203	17	872	0.79733	-0.01331	0.75804	2.61125	0.22006	1.0000000000	1.0000000000	3.76256	-0.25174	96	9	1	110	11	2	0.43078	0.54936
7	75498004	Acute bacterial sinusitis (disorder)	59	262574004	Bullet wound	1095	187	20	2	185	18	890	0.58556	-0.02565	0.53453	2.32350	0.12297	0.5549989788	1.0000000000	3.41553	-0.55762	89	9	1	98	11	1	-0.18232	-0.09531
6	39848009	Whiplash injury to neck	59	262574004	Bullet wound	1095	182	20	2	180	18	895	0.60165	-0.02426	0.55247	2.40190	0.12708	0.5562916701	1.0000000000	3.32420	-0.52747	92	9	1	90	11	1	-0.18232	0.02174
5	284549007	Laceration of hand	59	262574004	Bullet wound	1095	104	20	1	103	19	972	0.52644	-0.02092	0.49668	3.74829	0.06581	0.7129039389	1.0000000000	1.89954	-0.53583	54	9	0	50	11	1	-2.48491	-3.93183
1	444814009	Viral sinusitis (disorder)	59	262574004	Bullet wound	1095	993	20	18	975	2	100	0.99245	-0.00321	0.92308	4.03600	0.21112	0.7089717148	1.0000000000	18.13699	-0.01036	478	9	7	515	11	11	0.13353	0.37083
96	283371005	Laceration of forearm	33	429007001	History of cardiac arrest (situation)	1095	75	42	6	69	36	984	2.08571	0.05880	2.37681	5.83474	0.96821	0.0612581076	0.4826962916	2.87671	0.85252	39	24	3	36	18	3	0.25131	0.07411
94	703151001	History of single seizure (situation)	33	429007001	History of cardiac arrest (situation)	1095	39	42	3	36	39	1017	2.00549	0.03859	2.17308	7.36386	0.64128	0.1850424915	0.8181443419	1.49589	0.68045	14	24	0	25	18	3	-1.94591	-2.23359
75	431855005	Chronic kidney disease stage 1 (disorder)	33	429007001	History of cardiac arrest (situation)	1095	28	42	1	27	41	1026	0.93112	-0.00223	0.92683	6.98809	0.12293	1.0000000000	1.0000000000	1.07397	-0.05240	10	24	1	18	18	0	3.21888	2.39790
116	370143000	Major depression disorder	66	55822004	Hyperlipidemia	1095	8	119	0	8	119	968	0.00000	-0.02996	0.00000	0.00000	0.00000	1.0000000000	1.0000000000	0.86941	-0.90258	3	64	0	5	55	0	0.00000	0.00000
117	230265002	Familial Alzheimer's disease of early onset (disorder)	66	55822004	Hyperlipidemia	1095	6	119	2	4	117	972	3.06723	0.05358	4.15385	22.92474	0.75266	0.1313058225	0.7128030364	0.65205	0.86070	2	64	0	4	55	2	-3.34990	-1.09861
118	48333001	Burn injury(morphologic abnormality)	66	55822004	Hyperlipidemia	1095	1	119	0	1	119	975	0.00000	-0.01056	0.00000	0.00000	0.00000	1.0000000000	1.0000000000	0.10868	-0.14884	0	64	0	1	55	0	0.00000	0.00000
119	275272006	Brain damage - traumatic	66	55822004	Hyperlipidemia	1095	4	119	0	4	119	972	0.00000	-0.02114	0.00000	0.00000	0.00000	1.0000000000	1.0000000000	0.43470	-0.52075	0	64	0	4	55	0	0.00000	0.00000
120	162573006	Suspected lung cancer (situation)	66	55822004	Hyperlipidemia	1095	8	119	0	8	119	968	0.00000	-0.02996	0.00000	0.00000	0.00000	1.0000000000	1.0000000000	0.86941	-0.90258	0	64	0	8	55	0	0.00000	0.00000
121	254637007	Non-small cell lung cancer (disorder)	66	55822004	Hyperlipidemia	1095	8	119	0	8	119	968	0.00000	-0.02996	0.00000	0.00000	0.00000	1.0000000000	1.0000000000	0.86941	-0.90258	0	64	0	8	55	0	0.00000	0.00000
123	195967001	Asthma	66	55822004	Hyperlipidemia	1095	2	119	0	2	119	974	0.00000	-0.01494	0.00000	0.00000	0.00000	1.0000000000	1.0000000000	0.21735	-0.28375	1	64	0	1	55	0	0.00000	0.00000
124	1501000119109	Proliferative diabetic retinopathy due to type II diabetes mellitus (disorder)	66	55822004	Hyperlipidemia	1095	1	119	1	0	118	976	9.20168	0.08659	0.00000	0.00000	0.00000	0.1086757991	0.6488370819	0.10868	0.85116	1	64	1	0	55	0	4.17439	0.69315
125	1734006	Fracture of the vertebral column with spinal cord injury	66	55822004	Hyperlipidemia	1095	5	119	1	4	118	972	1.84034	0.01987	2.05932	18.57841	0.22827	0.4380553985	1.0000000000	0.54338	0.37391	3	64	1	2	55	0	4.17439	1.38629
126	698754002	Chronic paralysis due to lesion of spinal cord	66	55822004	Hyperlipidemia	1095	2	119	1	1	118	975	4.60084	0.05378	8.26271	132.97209	0.51343	0.2056297113	0.8544076578	0.21735	0.71625	2	64	1	0	55	0	4.17439	1.09861
127	431856006	Chronic kidney disease stage 2 (disorder)	66	55822004	Hyperlipidemia	1095	5	119	1	4	118	972	1.84034	0.01987	2.05932	18.57841	0.22827	0.4380553985	1.0000000000	0.54338	0.37391	3	64	0	2	55	1	-4.02535	-1.09861
128	86849004	Suicidal deliberate poisoning	66	55822004	Hyperlipidemia	1095	1	119	0	1	119	975	0.00000	-0.01056	0.00000	0.00000	0.00000	1.0000000000	1.0000000000	0.10868	-0.14884	0	64	0	1	55	0	0.00000	0.00000
130	314994000	Metastasis from malignant tumor of prostate (disorder)	66	55822004	Hyperlipidemia	1095	1	119	0	1	119	975	0.00000	-0.01056	0.00000	0.00000	0.00000	1.0000000000	1.0000000000	0.10868	-0.14884	0	64	0	1	55	0	0.00000	0.00000
131	93761005	Primary malignant neoplasm of colon	66	55822004	Hyperlipidemia	1095	5	119	2	3	117	973	3.68067	0.06340	5.54416	33.52162	0.91695	0.0940666764	0.6075918218	0.54338	0.95887	3	64	1	2	55	1	0.14904	0.28768
132	69896004	Rheumatoid arthritis	66	55822004	Hyperlipidemia	1095	3	119	2	1	117	975	6.13445	0.09397	16.66667	185.21492	1.49976	0.0326561260	0.3329331866	0.32603	1.17785	2	64	1	1	55	1	0.14904	0.40547
44	58150001	Fracture of clavicle	33	429007001	History of cardiac arrest (situation)	1095	112	42	7	105	35	948	1.62946	0.04243	1.80571	4.16669	0.78254	0.1871321590	0.8181443419	4.29589	0.59513	55	24	5	57	18	2	-0.54473	-0.89948
42	16114001	Fracture of ankle	33	429007001	History of cardiac arrest (situation)	1095	108	42	3	105	39	948	0.72421	-0.01822	0.69451	2.28628	0.21097	0.7913261509	1.0000000000	4.14247	-0.36246	48	24	1	60	18	2	0.91629	0.45783
130	314994000	Metastasis from malignant tumor of prostate (disorder)	7	75498004	Acute bacterial sinusitis (disorder)	1095	1	187	0	1	187	907	0.00000	-0.01372	0.00000	0.00000	0.00000	1.0000000000	1.0000000000	0.17078	-0.22747	0	89	0	1	98	0	0.00000	0.00000
15	40055000	Chronic sinusitis (disorder)	33	429007001	History of cardiac arrest (situation)	1095	216	42	10	206	32	847	1.20701	0.02049	1.28489	2.65616	0.62155	0.5519762780	1.0000000000	8.28493	0.24454	104	24	5	112	18	5	0.23180	-0.07083
125	1734006	Fracture of the vertebral column with spinal cord injury	7	75498004	Acute bacterial sinusitis (disorder)	1095	5	187	2	3	185	905	2.34225	0.04126	3.26126	19.65410	0.54115	0.2039274487	0.8524167357	0.85388	0.69441	3	89	1	2	98	1	-0.09531	0.28768
118	48333001	Burn injury(morphologic abnormality)	7	75498004	Acute bacterial sinusitis (disorder)	1095	1	187	0	1	187	907	0.00000	-0.01372	0.00000	0.00000	0.00000	1.0000000000	1.0000000000	0.17078	-0.22747	0	89	0	1	98	0	0.00000	0.00000
117	230265002	Familial Alzheimer's disease of early onset (disorder)	7	75498004	Acute bacterial sinusitis (disorder)	1095	6	187	2	4	185	904	1.95187	0.03206	2.44324	13.43764	0.44423	0.2729941919	0.9482956140	1.02466	0.56728	2	89	1	4	98	1	-0.09531	-0.51083
109	90560007	Gout	7	75498004	Acute bacterial sinusitis (disorder)	1095	4	187	0	4	187	904	0.00000	-0.02748	0.00000	0.00000	0.00000	1.0000000000	1.0000000000	0.68311	-0.75113	0	89	0	4	98	0	0.00000	0.00000
102	90781000119102	Microalbuminuria due to type 2 diabetes mellitus (disorder)	7	75498004	Acute bacterial sinusitis (disorder)	1095	6	187	3	3	184	905	2.92781	0.06494	4.91848	24.56039	0.98498	0.0657939624	0.5022081753	1.02466	0.98232	3	89	1	3	98	2	0.58779	0.47000
98	1551000119108	Nonproliferative diabetic retinopathy due to type 2 diabetes mellitus (disorder)	7	75498004	Acute bacterial sinusitis (disorder)	1095	12	187	4	8	183	900	1.95187	0.04547	2.45902	8.25210	0.73275	0.1329514026	0.7164538997	2.04932	0.71344	7	89	2	5	98	2	-0.09431	0.25131
97	403192003	Third degree burn	7	75498004	Acute bacterial sinusitis (disorder)	1095	8	187	3	5	184	903	2.19586	0.04656	2.94457	12.42947	0.69757	0.1419383399	0.7403058513	1.36621	0.75742	3	89	2	5	98	1	-0.77741	-0.87547
96	283371005	Laceration of forearm	7	75498004	Acute bacterial sinusitis (disorder)	1095	75	187	13	62	174	846	1.01497	0.00184	1.01947	1.89462	0.54856	1.0000000000	1.0000000000	12.80822	0.01990	39	89	7	36	98	6	-0.23419	-0.06318
94	703151001	History of single seizure (situation)	7	75498004	Acute bacterial sinusitis (disorder)	1095	39	187	7	32	180	876	1.05101	0.00445	1.06458	2.44974	0.46264	0.8298213551	1.0000000000	6.66027	0.06260	14	89	3	25	98	4	0.18450	-0.24640
93	128613002	Seizure disorder	7	75498004	Acute bacterial sinusitis (disorder)	1095	39	187	7	32	180	876	1.05101	0.00445	1.06458	2.44974	0.46264	0.8298213551	1.0000000000	6.66027	0.06260	14	89	3	25	98	4	0.18450	-0.24640
89	47693006	Rupture of appendix	7	75498004	Acute bacterial sinusitis (disorder)	1095	20	187	8	12	179	896	2.34225	0.08308	3.33706	8.28101	1.34476	0.0122407715	0.1758584161	3.41553	1.02734	10	89	4	10	98	4	-0.09237	0.00000
86	713197008	Recurrent rectal polyp	7	75498004	Acute bacterial sinusitis (disorder)	1095	22	187	4	18	183	890	1.06466	0.00420	1.08075	3.23066	0.36154	0.7799905968	1.0000000000	3.75708	0.07185	12	89	2	10	98	2	-0.09431	0.15415
114	449868002	Smokes tobacco daily	11	38341003	Hypertension	1095	9	278	4	5	274	812	1.75060	0.03986	2.37080	8.89177	0.63212	0.2430618998	0.9129642090	2.28493	0.60606	2	131	1	7	147	3	0.97078	-0.10536
75	431855005	Chronic kidney disease stage 1 (disorder)	7	75498004	Acute bacterial sinusitis (disorder)	1095	28	187	8	20	179	888	1.67303	0.04948	1.98436	4.57582	0.86054	0.1227696876	0.6908155882	4.78174	0.63842	10	89	3	18	98	5	0.39789	-0.05972
116	370143000	Major depression disorder	11	38341003	Hypertension	1095	8	278	1	7	277	810	0.49236	-0.02540	0.41774	3.41042	0.05117	0.6875063945	1.0000000000	2.03105	-0.59982	3	131	0	5	147	1	-4.99721	-1.79176
72	35999006	Blighted ovum	7	75498004	Acute bacterial sinusitis (disorder)	1095	53	187	10	43	177	865	1.10483	0.01073	1.13651	2.30437	0.56053	0.7088493021	1.0000000000	9.05114	0.13014	53	89	10	0	98	0	2.29253	1.84055
119	275272006	Brain damage - traumatic	11	38341003	Hypertension	1095	4	278	1	3	277	814	0.98471	-0.00054	0.97954	9.45560	0.10147	1.0000000000	1.0000000000	1.01553	-0.01116	0	131	0	4	147	1	-4.99721	-1.60944
120	162573006	Suspected lung cancer (situation)	11	38341003	Hypertension	1095	8	278	5	3	273	814	2.46178	0.07315	4.96947	20.93077	1.17987	0.0286404444	0.3115313765	2.03105	0.98514	0	131	0	8	147	5	-3.41444	-0.95551
69	233604007	Pneumonia	7	75498004	Acute bacterial sinusitis (disorder)	1095	7	187	0	7	187	901	0.00000	-0.03640	0.00000	0.00000	0.00000	0.6103161835	1.0000000000	1.19543	-1.13451	3	89	0	4	98	0	0.00000	0.00000
67	403191005	Second degree burn	7	75498004	Acute bacterial sinusitis (disorder)	1095	49	187	8	41	179	867	0.95602	-0.00432	0.94509	2.05027	0.43565	1.0000000000	1.0000000000	8.36804	-0.05782	23	89	2	26	98	6	0.96508	0.85175
64	444448004	Injury of medial collateral ligament of knee	7	75498004	Acute bacterial sinusitis (disorder)	1095	32	187	13	19	174	889	2.37884	0.10857	3.49577	7.21012	1.69489	0.0011912309	0.0285700138	5.46484	1.11474	17	89	8	15	98	5	-0.53002	-0.24686
63	68496003	Polyp of colon	7	75498004	Acute bacterial sinusitis (disorder)	1095	91	187	17	74	170	834	1.09391	0.01283	1.12703	1.95801	0.64872	0.6631903007	1.0000000000	15.54064	0.12198	43	89	8	48	98	9	0.01967	0.00656
128	86849004	Suicidal deliberate poisoning	11	38341003	Hypertension	1095	1	278	1	0	277	817	3.93885	0.05183	0.00000	0.00000	0.00000	0.2538812785	0.9133257124	0.25388	0.67360	0	131	0	1	147	1	-4.99721	-0.69315
130	314994000	Metastasis from malignant tumor of prostate (disorder)	11	38341003	Hypertension	1095	1	278	1	0	277	817	3.93885	0.05183	0.00000	0.00000	0.00000	0.2538812785	0.9133257124	0.25388	0.67360	0	131	0	1	147	1	-4.99721	-0.69315
131	93761005	Primary malignant neoplasm of colon	11	38341003	Hypertension	1095	5	278	2	3	276	814	1.57554	0.02274	1.96618	11.82826	0.32683	0.6058967312	1.0000000000	1.26941	0.40265	3	131	1	2	147	1	-0.11441	0.28768
132	69896004	Rheumatoid arthritis	11	38341003	Hypertension	1095	3	278	0	3	278	814	0.00000	-0.03057	0.00000	0.00000	0.00000	0.5753543664	1.0000000000	0.76164	-0.81692	2	131	0	1	147	0	0.00000	0.00000
50	446096008	Perennial allergic rhinitis	7	75498004	Acute bacterial sinusitis (disorder)	1095	26	187	2	24	185	884	0.45043	-0.03890	0.39820	1.69956	0.09330	0.2909636342	0.9768039197	4.44018	-0.85869	14	89	1	12	98	1	-0.09531	0.14310
49	88805009	Chronic congestive heart failure (disorder)	7	75498004	Acute bacterial sinusitis (disorder)	1095	10	187	2	8	185	900	1.17112	0.00746	1.21622	5.77357	0.25620	0.6829703339	1.0000000000	1.70776	0.14786	5	89	1	5	98	1	-0.09531	0.00000
47	359817006	Closed fracture of hip	7	75498004	Acute bacterial sinusitis (disorder)	1095	29	187	7	22	180	886	1.41342	0.03095	1.56616	3.72146	0.65911	0.3159439229	1.0000000000	4.95251	0.42650	11	89	3	18	98	4	0.18450	-0.16430
44	58150001	Fracture of clavicle	7	75498004	Acute bacterial sinusitis (disorder)	1095	112	187	17	95	170	813	0.88880	-0.01703	0.85579	1.47143	0.49773	0.6908696240	1.0000000000	19.12694	-0.16113	55	89	10	57	98	7	-0.41552	-0.34117
43	307731004	Injury of tendon of the rotator cuff of shoulder	7	75498004	Acute bacterial sinusitis (disorder)	1095	51	187	12	39	175	869	1.37779	0.03789	1.52791	2.97719	0.78413	0.2502003190	0.9133257124	8.70959	0.42103	26	89	5	25	98	7	0.22581	0.30472
42	16114001	Fracture of ankle	7	75498004	Acute bacterial sinusitis (disorder)	1095	108	187	21	87	166	821	1.13859	0.02081	1.19381	1.97788	0.72056	0.5009021139	1.0000000000	18.44384	0.17819	48	89	9	60	98	12	0.17217	0.05407
41	283385000	Laceration of thigh	7	75498004	Acute bacterial sinusitis (disorder)	1095	105	187	22	83	165	825	1.22689	0.03353	1.32530	2.18250	0.80478	0.2754960255	0.9505356881	17.93151	0.28084	50	89	10	55	98	12	0.07696	0.07197
39	74400008	Appendicitis	7	75498004	Acute bacterial sinusitis (disorder)	1095	51	187	11	40	176	868	1.26298	0.02638	1.35625	2.69498	0.68253	0.3470866848	1.0000000000	8.70959	0.30555	27	89	6	24	98	5	-0.26317	-0.05311
38	398254007	Preeclampsia	7	75498004	Acute bacterial sinusitis (disorder)	1095	101	187	19	82	168	826	1.10155	0.01469	1.13923	1.92751	0.67333	0.6768599228	1.0000000000	17.24840	0.13223	101	89	19	0	98	0	1.73769	1.84305
35	19169002	Miscarriage in first trimester	7	75498004	Acute bacterial sinusitis (disorder)	1095	174	187	38	136	149	772	1.27881	0.05500	1.44769	2.15996	0.97030	0.0784904860	0.5538932862	29.71507	0.34453	174	89	38	0	98	0	1.20660	1.71900
33	429007001	History of cardiac arrest (situation)	7	75498004	Acute bacterial sinusitis (disorder)	1095	42	187	5	37	182	871	0.69710	-0.02745	0.64672	1.66794	0.25075	0.5290871426	1.0000000000	7.17260	-0.44583	24	89	3	18	98	2	-0.48885	-0.10536
32	410429000	Cardiac Arrest	7	75498004	Acute bacterial sinusitis (disorder)	1095	42	187	5	37	182	871	0.69710	-0.02745	0.64672	1.66794	0.25075	0.5290871426	1.0000000000	7.17260	-0.44583	24	89	3	18	98	2	-0.48885	-0.10536
27	408512008	Body mass index 40+ - severely obese (finding)	7	75498004	Acute bacterial sinusitis (disorder)	1095	97	187	24	73	163	835	1.44881	0.06350	1.68418	2.75121	1.03098	0.0467210300	0.4138417772	16.56530	0.50920	67	89	20	30	98	4	-1.54306	-0.66989
21	15777000	Prediabetes	7	75498004	Acute bacterial sinusitis (disorder)	1095	333	187	70	263	117	645	1.23091	0.06927	1.46729	2.03901	1.05587	0.0234421617	0.2784510081	56.86849	0.29504	159	89	30	174	98	40	0.13955	0.16345
20	80394007	Hyperglycemia (disorder)	7	75498004	Acute bacterial sinusitis (disorder)	1095	55	187	13	42	174	866	1.38405	0.04008	1.54050	2.93037	0.80985	0.1973763624	0.8369901977	9.39269	0.42986	23	89	5	32	98	8	0.34986	0.11333
18	302870006	Hypertriglyceridemia (disorder)	7	75498004	Acute bacterial sinusitis (disorder)	1095	64	187	15	49	172	859	1.37241	0.04211	1.52883	2.78873	0.83813	0.1710483090	0.7972585288	10.92968	0.42352	28	89	6	36	98	9	0.28651	0.12516
15	40055000	Chronic sinusitis (disorder)	7	75498004	Acute bacterial sinusitis (disorder)	1095	216	187	109	107	78	801	2.95492	0.43978	10.46118	14.90196	7.34375	0.0000000000	0.0000000000	36.88767	1.53770	104	89	52	112	98	57	-0.00286	0.01176
14	10509002	Acute bronchitis (disorder)	7	75498004	Acute bacterial sinusitis (disorder)	1095	863	187	168	695	19	213	1.13991	0.12246	2.70988	4.46163	1.64592	0.0000209510	0.0008210172	147.37991	0.18773	418	89	81	445	98	87	-0.01310	0.00742
13	370247008	Facial laceration	7	75498004	Acute bacterial sinusitis (disorder)	1095	109	187	25	84	162	824	1.34303	0.05176	1.51382	2.43971	0.93931	0.1062736027	0.6411444039	18.61461	0.40658	55	89	10	54	98	15	0.27320	0.34575
10	62106007	Concussion with no loss of consciousness	7	75498004	Acute bacterial sinusitis (disorder)	1095	206	187	44	162	143	746	1.25071	0.05477	1.41690	2.06818	0.97072	0.0803345365	0.5609996513	35.17991	0.31474	96	89	20	110	98	24	0.06965	0.03807
6	39848009	Whiplash injury to neck	7	75498004	Acute bacterial sinusitis (disorder)	1095	182	187	35	147	152	761	1.12608	0.02555	1.19204	1.79204	0.79293	0.3897777163	1.0000000000	31.08128	0.16627	92	89	24	90	98	11	-0.74412	-0.64169
128	86849004	Suicidal deliberate poisoning	28	53741008	Coronary Heart Disease	1095	1	80	0	1	80	1014	0.00000	-0.00849	0.00000	0.00000	0.00000	1.0000000000	1.0000000000	0.07306	-0.10173	0	24	0	1	56	0	0.00000	0.00000
118	48333001	Burn injury(morphologic abnormality)	75	431855005	Chronic kidney disease stage 1 (disorder)	1095	1	28	0	1	28	1066	0.00000	-0.00490	0.00000	0.00000	0.00000	1.0000000000	1.0000000000	0.02557	-0.03643	0	10	0	1	18	0	0.00000	0.00000
130	314994000	Metastasis from malignant tumor of prostate (disorder)	120	162573006	Suspected lung cancer (situation)	1095	1	8	0	1	8	1086	0.00000	-0.00259	0.00000	0.00000	0.00000	1.0000000000	1.0000000000	0.00731	-0.01050	0	0	0	1	8	0	0.00000	0.00000
129	47505003	Posttraumatic stress disorder	120	162573006	Suspected lung cancer (situation)	1095	4	8	0	4	8	1083	0.00000	-0.00519	0.00000	0.00000	0.00000	1.0000000000	1.0000000000	0.02922	-0.04156	1	0	0	3	8	0	0.00000	0.00000
128	86849004	Suicidal deliberate poisoning	120	162573006	Suspected lung cancer (situation)	1095	1	8	0	1	8	1086	0.00000	-0.00259	0.00000	0.00000	0.00000	1.0000000000	1.0000000000	0.00731	-0.01050	0	0	0	1	8	0	0.00000	0.00000
125	1734006	Fracture of the vertebral column with spinal cord injury	120	162573006	Suspected lung cancer (situation)	1095	5	8	0	5	8	1082	0.00000	-0.00581	0.00000	0.00000	0.00000	1.0000000000	1.0000000000	0.03653	-0.05176	3	0	0	2	8	0	0.00000	0.00000
124	1501000119109	Proliferative diabetic retinopathy due to type II diabetes mellitus (disorder)	120	162573006	Suspected lung cancer (situation)	1095	1	8	0	1	8	1086	0.00000	-0.00259	0.00000	0.00000	0.00000	1.0000000000	1.0000000000	0.00731	-0.01050	1	0	0	0	8	0	0.00000	0.00000
118	48333001	Burn injury(morphologic abnormality)	120	162573006	Suspected lung cancer (situation)	1095	1	8	0	1	8	1086	0.00000	-0.00259	0.00000	0.00000	0.00000	1.0000000000	1.0000000000	0.00731	-0.01050	0	0	0	1	8	0	0.00000	0.00000
117	230265002	Familial Alzheimer's disease of early onset (disorder)	120	162573006	Suspected lung cancer (situation)	1095	6	8	0	6	8	1081	0.00000	-0.00637	0.00000	0.00000	0.00000	1.0000000000	1.0000000000	0.04384	-0.06189	2	0	0	4	8	0	0.00000	0.00000
115	36923009	Major depression  single episode	120	162573006	Suspected lung cancer (situation)	1095	6	8	0	6	8	1081	0.00000	-0.00637	0.00000	0.00000	0.00000	1.0000000000	1.0000000000	0.04384	-0.06189	3	0	0	3	8	0	0.00000	0.00000
114	449868002	Smokes tobacco daily	120	162573006	Suspected lung cancer (situation)	1095	9	8	1	8	7	1079	15.20833	0.11096	19.26786	175.23894	2.11854	0.0640919301	0.4928640393	0.06575	0.90813	2	0	0	7	8	1	-2.19722	-2.07944
111	235919008	Cholelithiasis	120	162573006	Suspected lung cancer (situation)	1095	9	8	0	9	8	1078	0.00000	-0.00781	0.00000	0.00000	0.00000	1.0000000000	1.0000000000	0.06575	-0.09187	7	0	0	2	8	0	0.00000	0.00000
109	90560007	Gout	120	162573006	Suspected lung cancer (situation)	1095	4	8	0	4	8	1083	0.00000	-0.00519	0.00000	0.00000	0.00000	1.0000000000	1.0000000000	0.02922	-0.04156	0	0	0	4	8	0	0.00000	0.00000
108	40930008	Hypothyroidism (disorder)	120	162573006	Suspected lung cancer (situation)	1095	13	8	0	13	8	1074	0.00000	-0.00940	0.00000	0.00000	0.00000	1.0000000000	1.0000000000	0.09498	-0.13090	11	0	0	2	8	0	0.00000	0.00000
107	40275004	Contact dermatitis	120	162573006	Suspected lung cancer (situation)	1095	18	8	0	18	8	1069	0.00000	-0.01109	0.00000	0.00000	0.00000	1.0000000000	1.0000000000	0.13151	-0.17825	9	0	0	9	8	0	0.00000	0.00000
106	24079001	Atopic dermatitis	120	162573006	Suspected lung cancer (situation)	1095	20	8	0	20	8	1067	0.00000	-0.01170	0.00000	0.00000	0.00000	1.0000000000	1.0000000000	0.14612	-0.19676	13	0	0	7	8	0	0.00000	0.00000
105	363406005	Malignant tumor of colon	120	162573006	Suspected lung cancer (situation)	1095	6	8	0	6	8	1081	0.00000	-0.00637	0.00000	0.00000	0.00000	1.0000000000	1.0000000000	0.04384	-0.06189	4	0	0	2	8	0	0.00000	0.00000
102	90781000119102	Microalbuminuria due to type 2 diabetes mellitus (disorder)	120	162573006	Suspected lung cancer (situation)	1095	6	8	1	5	7	1082	22.81250	0.13890	30.91429	299.83803	3.18736	0.0431395216	0.3985498161	0.04384	0.93811	3	0	0	3	8	1	-2.19722	-1.38629
101	433144002	Chronic kidney disease stage 3 (disorder)	120	162573006	Suspected lung cancer (situation)	1095	3	8	0	3	8	1084	0.00000	-0.00450	0.00000	0.00000	0.00000	1.0000000000	1.0000000000	0.02192	-0.03128	1	0	0	2	8	0	0.00000	0.00000
100	161622006	History of lower limb amputation (situation)	120	162573006	Suspected lung cancer (situation)	1095	1	8	0	1	8	1086	0.00000	-0.00259	0.00000	0.00000	0.00000	1.0000000000	1.0000000000	0.00731	-0.01050	0	0	0	1	8	0	0.00000	0.00000
98	1551000119108	Nonproliferative diabetic retinopathy due to type 2 diabetes mellitus (disorder)	120	162573006	Suspected lung cancer (situation)	1095	12	8	0	12	8	1075	0.00000	-0.00903	0.00000	0.00000	0.00000	1.0000000000	1.0000000000	0.08767	-0.12124	7	0	0	5	8	0	0.00000	0.00000
97	403192003	Third degree burn	120	162573006	Suspected lung cancer (situation)	1095	8	8	0	8	8	1079	0.00000	-0.00736	0.00000	0.00000	0.00000	1.0000000000	1.0000000000	0.05845	-0.08195	3	0	0	5	8	0	0.00000	0.00000
96	283371005	Laceration of forearm	120	162573006	Suspected lung cancer (situation)	1095	75	8	1	74	7	1013	1.82500	0.01919	1.95560	16.10676	0.23744	0.4341934482	1.0000000000	0.54795	0.36965	39	0	0	36	8	1	-2.19722	-3.61092
94	703151001	History of single seizure (situation)	120	162573006	Suspected lung cancer (situation)	1095	39	8	1	38	7	1049	3.50962	0.04137	3.94361	32.85942	0.47329	0.2525427859	0.9133257124	0.28493	0.63831	14	0	0	25	8	1	-2.19722	-3.25810
93	128613002	Seizure disorder	120	162573006	Suspected lung cancer (situation)	1095	39	8	1	38	7	1049	3.50962	0.04137	3.94361	32.85942	0.47329	0.2525427859	0.9133257124	0.28493	0.63831	14	0	0	25	8	1	-2.19722	-3.25810
89	47693006	Rupture of appendix	120	162573006	Suspected lung cancer (situation)	1095	20	8	0	20	8	1067	0.00000	-0.01170	0.00000	0.00000	0.00000	1.0000000000	1.0000000000	0.14612	-0.19676	10	0	0	10	8	0	0.00000	0.00000
86	713197008	Recurrent rectal polyp	120	162573006	Suspected lung cancer (situation)	1095	22	8	0	22	8	1065	0.00000	-0.01228	0.00000	0.00000	0.00000	1.0000000000	1.0000000000	0.16073	-0.21503	12	0	0	10	8	0	0.00000	0.00000
82	94260004	Secondary malignant neoplasm of colon	120	162573006	Suspected lung cancer (situation)	1095	4	8	0	4	8	1083	0.00000	-0.00519	0.00000	0.00000	0.00000	1.0000000000	1.0000000000	0.02922	-0.04156	2	0	0	2	8	0	0.00000	0.00000
78	239872002	Osteoarthritis of hip	120	162573006	Suspected lung cancer (situation)	1095	21	8	1	20	7	1067	6.51786	0.06619	7.62143	64.87359	0.89537	0.1439420804	0.7404942507	0.15342	0.79408	13	0	0	8	8	1	-2.19722	-2.19722
76	127013003	Diabetic renal disease (disorder)	120	162573006	Suspected lung cancer (situation)	1095	28	8	1	27	7	1060	4.88839	0.05404	5.60847	47.18618	0.66661	0.1877127711	0.8181443419	0.20457	0.73149	10	0	0	18	8	1	-2.19722	-2.94444
75	431855005	Chronic kidney disease stage 1 (disorder)	120	162573006	Suspected lung cancer (situation)	1095	28	8	1	27	7	1060	4.88839	0.05404	5.60847	47.18618	0.66661	0.1877127711	0.8181443419	0.20457	0.73149	10	0	0	18	8	1	-2.19722	-2.94444
72	35999006	Blighted ovum	120	162573006	Suspected lung cancer (situation)	1095	53	8	0	53	8	1034	0.00000	-0.01935	0.00000	0.00000	0.00000	1.0000000000	1.0000000000	0.38721	-0.47219	53	0	0	0	8	0	0.00000	0.00000
71	201834006	Localized  primary osteoarthritis of the hand	120	162573006	Suspected lung cancer (situation)	1095	28	8	0	28	8	1059	0.00000	-0.01390	0.00000	0.00000	0.00000	1.0000000000	1.0000000000	0.20457	-0.26851	19	0	0	9	8	0	0.00000	0.00000
70	87433001	Pulmonary emphysema (disorder)	120	162573006	Suspected lung cancer (situation)	1095	17	8	0	17	8	1070	0.00000	-0.01077	0.00000	0.00000	0.00000	1.0000000000	1.0000000000	0.12420	-0.16890	9	0	0	8	8	0	0.00000	0.00000
69	233604007	Pneumonia	120	162573006	Suspected lung cancer (situation)	1095	7	8	0	7	8	1080	0.00000	-0.00688	0.00000	0.00000	0.00000	1.0000000000	1.0000000000	0.05114	-0.07196	3	0	0	4	8	0	0.00000	0.00000
68	26929004	Alzheimer's disease (disorder)	120	162573006	Suspected lung cancer (situation)	1095	23	8	0	23	8	1064	0.00000	-0.01257	0.00000	0.00000	0.00000	1.0000000000	1.0000000000	0.16804	-0.22409	15	0	0	8	8	0	0.00000	0.00000
67	403191005	Second degree burn	120	162573006	Suspected lung cancer (situation)	1095	49	8	0	49	8	1038	0.00000	-0.01857	0.00000	0.00000	0.00000	1.0000000000	1.0000000000	0.35799	-0.44147	23	0	0	26	8	0	0.00000	0.00000
65	239873007	Osteoarthritis of knee	120	162573006	Suspected lung cancer (situation)	1095	57	8	0	57	8	1030	0.00000	-0.02010	0.00000	0.00000	0.00000	1.0000000000	1.0000000000	0.41644	-0.50227	30	0	0	27	8	0	0.00000	0.00000
64	444448004	Injury of medial collateral ligament of knee	120	162573006	Suspected lung cancer (situation)	1095	32	8	0	32	8	1055	0.00000	-0.01488	0.00000	0.00000	0.00000	1.0000000000	1.0000000000	0.23379	-0.30310	17	0	0	15	8	0	0.00000	0.00000
63	68496003	Polyp of colon	120	162573006	Suspected lung cancer (situation)	1095	91	8	0	91	8	996	0.00000	-0.02583	0.00000	0.00000	0.00000	1.0000000000	1.0000000000	0.66484	-0.73538	43	0	0	48	8	0	0.00000	0.00000
59	262574004	Bullet wound	120	162573006	Suspected lung cancer (situation)	1095	20	8	0	20	8	1067	0.00000	-0.01170	0.00000	0.00000	0.00000	1.0000000000	1.0000000000	0.14612	-0.19676	9	0	0	11	8	0	0.00000	0.00000
58	239720000	Tear of meniscus of knee	120	162573006	Suspected lung cancer (situation)	1095	20	8	0	20	8	1067	0.00000	-0.01170	0.00000	0.00000	0.00000	1.0000000000	1.0000000000	0.14612	-0.19676	10	0	0	10	8	0	0.00000	0.00000
57	192127007	Child attention deficit disorder	120	162573006	Suspected lung cancer (situation)	1095	76	8	0	76	8	1011	0.00000	-0.02343	0.00000	0.00000	0.00000	1.0000000000	1.0000000000	0.55525	-0.63715	24	0	0	52	8	0	0.00000	0.00000
56	92691004	Carcinoma in situ of prostate (disorder)	120	162573006	Suspected lung cancer (situation)	1095	23	8	1	22	7	1065	5.95109	0.06222	6.91558	58.62581	0.81577	0.1566536716	0.7747075658	0.16804	0.77591	0	0	0	23	8	1	-2.19722	-3.17805
54	5602001	Opioid abuse (disorder)	120	162573006	Suspected lung cancer (situation)	1095	7	8	1	6	7	1081	19.55357	0.12767	25.73810	242.65496	2.73001	0.0501687997	0.4320205543	0.05114	0.92804	0	0	0	7	8	1	-2.19722	-2.07944
52	124171000119105	Chronic intractable migraine without aura	120	162573006	Suspected lung cancer (situation)	1095	51	8	0	51	8	1036	0.00000	-0.01896	0.00000	0.00000	0.00000	1.0000000000	1.0000000000	0.37260	-0.45691	21	0	0	30	8	0	0.00000	0.00000
50	446096008	Perennial allergic rhinitis	120	162573006	Suspected lung cancer (situation)	1095	26	8	0	26	8	1061	0.00000	-0.01338	0.00000	0.00000	0.00000	1.0000000000	1.0000000000	0.18995	-0.25091	14	0	0	12	8	0	0.00000	0.00000
49	88805009	Chronic congestive heart failure (disorder)	120	162573006	Suspected lung cancer (situation)	1095	10	8	0	10	8	1077	0.00000	-0.00824	0.00000	0.00000	0.00000	1.0000000000	1.0000000000	0.07306	-0.10173	5	0	0	5	8	0	0.00000	0.00000
47	359817006	Closed fracture of hip	120	162573006	Suspected lung cancer (situation)	1095	29	8	0	29	8	1058	0.00000	-0.01415	0.00000	0.00000	0.00000	1.0000000000	1.0000000000	0.21187	-0.27724	11	0	0	18	8	0	0.00000	0.00000
45	263102004	Fracture subluxation of wrist	120	162573006	Suspected lung cancer (situation)	1095	109	8	1	108	7	979	1.25573	0.00729	1.29497	10.62474	0.15784	0.5690084463	1.0000000000	0.79635	0.15493	51	0	0	58	8	1	-2.19722	-4.07754
44	58150001	Fracture of clavicle	120	162573006	Suspected lung cancer (situation)	1095	112	8	4	108	4	979	4.88839	0.11260	9.06481	36.76262	2.23517	0.0052541750	0.0931740363	0.81826	1.45937	55	0	0	57	8	4	-1.09861	-2.72458
43	307731004	Injury of tendon of the rotator cuff of shoulder	120	162573006	Suspected lung cancer (situation)	1095	51	8	0	51	8	1036	0.00000	-0.01896	0.00000	0.00000	0.00000	1.0000000000	1.0000000000	0.37260	-0.45691	26	0	0	25	8	0	0.00000	0.00000
42	16114001	Fracture of ankle	120	162573006	Suspected lung cancer (situation)	1095	108	8	0	108	8	979	0.00000	-0.02838	0.00000	0.00000	0.00000	1.0000000000	1.0000000000	0.78904	-0.83919	48	0	0	60	8	0	0.00000	0.00000
41	283385000	Laceration of thigh	120	162573006	Suspected lung cancer (situation)	1095	105	8	1	104	7	983	1.30357	0.00848	1.35027	11.08203	0.16452	0.5547693232	1.0000000000	0.76712	0.17860	50	0	0	55	8	1	-2.19722	-4.02535
39	74400008	Appendicitis	120	162573006	Suspected lung cancer (situation)	1095	51	8	1	50	7	1037	2.68382	0.03193	2.96286	24.54668	0.35763	0.3180602796	1.0000000000	0.37260	0.54309	27	0	0	24	8	1	-2.19722	-3.21888
38	398254007	Preeclampsia	120	162573006	Suspected lung cancer (situation)	1095	101	8	0	101	8	986	0.00000	-0.02735	0.00000	0.00000	0.00000	1.0000000000	1.0000000000	0.73790	-0.79734	101	0	0	0	8	0	0.00000	0.00000
35	19169002	Miscarriage in first trimester	120	162573006	Suspected lung cancer (situation)	1095	174	8	0	174	8	913	0.00000	-0.03729	0.00000	0.00000	0.00000	0.3691677987	1.0000000000	1.27123	-1.18348	174	0	0	0	8	0	0.00000	0.00000
33	429007001	History of cardiac arrest (situation)	120	162573006	Suspected lung cancer (situation)	1095	42	8	1	41	7	1046	3.25893	0.03870	3.64460	30.31510	0.43817	0.2694179494	0.9388450812	0.30685	0.61391	24	0	0	18	8	1	-2.19722	-2.94444
32	410429000	Cardiac Arrest	120	162573006	Suspected lung cancer (situation)	1095	42	8	1	41	7	1046	3.25893	0.03870	3.64460	30.31510	0.43817	0.2694179494	0.9388450812	0.30685	0.61391	24	0	0	18	8	1	-2.19722	-2.94444
30	399211009	History of myocardial infarction (situation)	120	162573006	Suspected lung cancer (situation)	1095	31	8	0	31	8	1056	0.00000	-0.01464	0.00000	0.00000	0.00000	1.0000000000	1.0000000000	0.22648	-0.29453	2	0	0	29	8	0	0.00000	0.00000
29	22298006	Myocardial Infarction	120	162573006	Suspected lung cancer (situation)	1095	31	8	0	31	8	1056	0.00000	-0.01464	0.00000	0.00000	0.00000	1.0000000000	1.0000000000	0.22648	-0.29453	2	0	0	29	8	0	0.00000	0.00000
27	408512008	Body mass index 40+ - severely obese (finding)	120	162573006	Suspected lung cancer (situation)	1095	97	8	0	97	8	990	0.00000	-0.02675	0.00000	0.00000	0.00000	1.0000000000	1.0000000000	0.70868	-0.77288	67	0	0	30	8	0	0.00000	0.00000
24	162864005	Body mass index 30+ - obesity (finding)	120	162573006	Suspected lung cancer (situation)	1095	439	8	4	435	4	652	1.24715	0.01735	1.49885	6.02493	0.37288	0.7205465380	1.0000000000	3.20731	0.24903	226	0	0	213	8	4	-1.09861	-3.99360
23	36971009	Sinusitis (disorder)	120	162573006	Suspected lung cancer (situation)	1095	190	8	3	187	5	900	2.16118	0.04564	2.88770	12.18808	0.68418	0.1472481858	0.7510427515	1.38813	0.74412	84	0	0	106	8	3	-1.29928	-3.59274
21	15777000	Prediabetes	120	162573006	Suspected lung cancer (situation)	1095	333	8	6	327	2	760	2.46622	0.08315	6.97248	34.72700	1.39993	0.0118613104	0.1721476562	2.43288	1.02794	159	0	0	174	8	6	-0.84730	-3.40120
20	80394007	Hyperglycemia (disorder)	120	162573006	Suspected lung cancer (situation)	1095	55	8	1	54	7	1033	2.48864	0.02937	2.73280	22.61036	0.33030	0.3387530268	1.0000000000	0.40183	0.51269	23	0	0	32	8	1	-2.19722	-3.49651
19	237602007	Metabolic syndrome X (disorder)	120	162573006	Suspected lung cancer (situation)	1095	64	8	2	62	6	1025	4.27734	0.07005	5.51075	27.86598	1.08980	0.0749717423	0.5403135912	0.46758	1.03152	28	0	0	36	8	2	-1.60944	-2.94444
18	302870006	Hypertriglyceridemia (disorder)	120	162573006	Suspected lung cancer (situation)	1095	64	8	2	62	6	1025	4.27734	0.07005	5.51075	27.86598	1.08980	0.0749717423	0.5403135912	0.46758	1.03152	28	0	0	36	8	2	-1.60944	-2.94444
17	368581000119106	Neuropathy due to type 2 diabetes mellitus (disorder)	120	162573006	Suspected lung cancer (situation)	1095	28	8	1	27	7	1060	4.88839	0.05404	5.60847	47.18618	0.66661	0.1877127711	0.8181443419	0.20457	0.73149	7	0	0	21	8	1	-2.19722	-3.09104
15	40055000	Chronic sinusitis (disorder)	120	162573006	Suspected lung cancer (situation)	1095	216	8	2	214	6	873	1.26736	0.01137	1.35981	6.78437	0.27255	0.6604667638	1.0000000000	1.57808	0.21866	104	0	0	112	8	2	-1.60944	-4.04305
14	10509002	Acute bronchitis (disorder)	120	162573006	Suspected lung cancer (situation)	1095	863	8	7	856	1	231	1.11023	0.01824	1.88902	15.43107	0.23125	1.0000000000	1.0000000000	6.30502	0.13111	418	0	0	445	8	7	-0.76214	-4.16777
13	370247008	Facial laceration	120	162573006	Suspected lung cancer (situation)	1095	109	8	0	109	8	978	0.00000	-0.02852	0.00000	0.00000	0.00000	1.0000000000	1.0000000000	0.79635	-0.84507	55	0	0	54	8	0	0.00000	0.00000
10	62106007	Concussion with no loss of consciousness	120	162573006	Suspected lung cancer (situation)	1095	206	8	1	205	7	882	0.66444	-0.01386	0.61463	5.02320	0.07521	1.0000000000	1.0000000000	1.50502	-0.32482	96	0	0	110	8	1	-2.19722	-4.70953
8	233678006	Childhood asthma	120	162573006	Suspected lung cancer (situation)	1095	45	8	0	45	8	1042	0.00000	-0.01776	0.00000	0.00000	0.00000	1.0000000000	1.0000000000	0.32877	-0.41009	25	0	0	20	8	0	0.00000	0.00000
7	75498004	Acute bacterial sinusitis (disorder)	120	162573006	Suspected lung cancer (situation)	1095	187	8	0	187	8	900	0.00000	-0.03893	0.00000	0.00000	0.00000	0.3643078077	1.0000000000	1.36621	-1.24258	89	0	0	98	8	0	0.00000	0.00000
6	39848009	Whiplash injury to neck	120	162573006	Suspected lung cancer (situation)	1095	182	8	1	181	7	906	0.75206	-0.00950	0.71507	5.84737	0.08745	1.0000000000	1.0000000000	1.32968	-0.22013	92	0	0	90	8	1	-2.19722	-4.51086
5	284549007	Laceration of hand	120	162573006	Suspected lung cancer (situation)	1095	104	8	2	102	6	985	2.63221	0.04536	3.21895	16.15607	0.64135	0.1716269478	0.7972585288	0.75982	0.76954	54	0	0	50	8	2	-1.60944	-3.25810
1	444814009	Viral sinusitis (disorder)	120	162573006	Suspected lung cancer (situation)	1095	993	8	8	985	0	102	1.10272	0.02750	0.00000	0.00000	0.00000	1.0000000000	1.0000000000	7.25479	0.12469	478	0	0	515	8	8	-0.69315	-4.18014
75	431855005	Chronic kidney disease stage 1 (disorder)	94	703151001	History of single seizure (situation)	1095	28	39	2	26	37	1030	2.00549	0.03130	2.14137	9.36132	0.48983	0.2629676428	0.9285317652	0.99726	0.58694	10	14	0	18	25	2	-2.60269	-2.30259
44	58150001	Fracture of clavicle	94	703151001	History of single seizure (situation)	1095	112	39	3	109	36	947	0.75206	-0.01608	0.72401	2.39027	0.21930	0.7900489739	1.0000000000	3.98904	-0.31876	55	14	1	57	25	2	0.10536	0.64096
42	16114001	Fracture of ankle	94	703151001	History of single seizure (situation)	1095	108	39	6	102	33	954	1.55983	0.03559	1.70053	4.15554	0.69589	0.2663999274	0.9357378021	3.84658	0.53039	48	14	2	60	25	4	0.09844	0.44629
130	314994000	Metastasis from malignant tumor of prostate (disorder)	68	26929004	Alzheimer's disease (disorder)	1095	1	23	0	1	23	1071	0.00000	-0.00443	0.00000	0.00000	0.00000	1.0000000000	1.0000000000	0.02100	-0.02999	0	15	0	1	8	0	0.00000	0.00000
129	47505003	Posttraumatic stress disorder	68	26929004	Alzheimer's disease (disorder)	1095	4	23	0	4	23	1068	0.00000	-0.00887	0.00000	0.00000	0.00000	1.0000000000	1.0000000000	0.08402	-0.11639	1	15	0	3	8	0	0.00000	0.00000
15	40055000	Chronic sinusitis (disorder)	94	703151001	History of single seizure (situation)	1095	216	39	6	210	33	846	0.77991	-0.02097	0.73247	1.77101	0.30294	0.6813597339	1.0000000000	7.69315	-0.31252	104	14	3	112	25	3	-0.49899	-0.07210
125	1734006	Fracture of the vertebral column with spinal cord injury	68	26929004	Alzheimer's disease (disorder)	1095	5	23	0	5	23	1067	0.00000	-0.00992	0.00000	0.00000	0.00000	1.0000000000	1.0000000000	0.10502	-0.14408	3	15	0	2	8	0	0.00000	0.00000
124	1501000119109	Proliferative diabetic retinopathy due to type II diabetes mellitus (disorder)	68	26929004	Alzheimer's disease (disorder)	1095	1	23	0	1	23	1071	0.00000	-0.00443	0.00000	0.00000	0.00000	1.0000000000	1.0000000000	0.02100	-0.02999	1	15	0	0	8	0	0.00000	0.00000
118	48333001	Burn injury(morphologic abnormality)	68	26929004	Alzheimer's disease (disorder)	1095	1	23	0	1	23	1071	0.00000	-0.00443	0.00000	0.00000	0.00000	1.0000000000	1.0000000000	0.02100	-0.02999	0	15	0	1	8	0	0.00000	0.00000
117	230265002	Familial Alzheimer's disease of early onset (disorder)	68	26929004	Alzheimer's disease (disorder)	1095	6	23	0	6	23	1066	0.00000	-0.01087	0.00000	0.00000	0.00000	1.0000000000	1.0000000000	0.12603	-0.17124	2	15	0	4	8	0	0.00000	0.00000
115	36923009	Major depression  single episode	68	26929004	Alzheimer's disease (disorder)	1095	6	23	0	6	23	1066	0.00000	-0.01087	0.00000	0.00000	0.00000	1.0000000000	1.0000000000	0.12603	-0.17124	3	15	0	3	8	0	0.00000	0.00000
114	449868002	Smokes tobacco daily	68	26929004	Alzheimer's disease (disorder)	1095	9	23	1	8	22	1064	5.28986	0.05720	6.04545	50.43056	0.72471	0.1744981661	0.8000743861	0.18904	0.75020	2	15	1	7	8	0	2.77259	1.09861
111	235919008	Cholelithiasis	68	26929004	Alzheimer's disease (disorder)	1095	9	23	0	9	23	1063	0.00000	-0.01333	0.00000	0.00000	0.00000	1.0000000000	1.0000000000	0.18904	-0.24980	7	15	0	2	8	0	0.00000	0.00000
109	90560007	Gout	68	26929004	Alzheimer's disease (disorder)	1095	4	23	0	4	23	1068	0.00000	-0.00887	0.00000	0.00000	0.00000	1.0000000000	1.0000000000	0.08402	-0.11639	0	15	0	4	8	0	0.00000	0.00000
108	40930008	Hypothyroidism (disorder)	68	26929004	Alzheimer's disease (disorder)	1095	13	23	1	12	22	1060	3.66221	0.04274	4.01515	32.24297	0.50000	0.2423305602	0.9106068739	0.27306	0.65170	11	15	1	2	8	0	2.77259	2.48491
107	40275004	Contact dermatitis	68	26929004	Alzheimer's disease (disorder)	1095	18	23	0	18	23	1054	0.00000	-0.01894	0.00000	0.00000	0.00000	1.0000000000	1.0000000000	0.37808	-0.46266	9	15	0	9	8	0	0.00000	0.00000
106	24079001	Atopic dermatitis	68	26929004	Alzheimer's disease (disorder)	1095	20	23	0	20	23	1052	0.00000	-0.01998	0.00000	0.00000	0.00000	1.0000000000	1.0000000000	0.42009	-0.50598	13	15	0	7	8	0	0.00000	0.00000
102	90781000119102	Microalbuminuria due to type 2 diabetes mellitus (disorder)	68	26929004	Alzheimer's disease (disorder)	1095	6	23	0	6	23	1066	0.00000	-0.01087	0.00000	0.00000	0.00000	1.0000000000	1.0000000000	0.12603	-0.17124	3	15	0	3	8	0	0.00000	0.00000
101	433144002	Chronic kidney disease stage 3 (disorder)	68	26929004	Alzheimer's disease (disorder)	1095	3	23	0	3	23	1069	0.00000	-0.00768	0.00000	0.00000	0.00000	1.0000000000	1.0000000000	0.06301	-0.08816	1	15	0	2	8	0	0.00000	0.00000
100	161622006	History of lower limb amputation (situation)	68	26929004	Alzheimer's disease (disorder)	1095	1	23	0	1	23	1071	0.00000	-0.00443	0.00000	0.00000	0.00000	1.0000000000	1.0000000000	0.02100	-0.02999	0	15	0	1	8	0	0.00000	0.00000
98	1551000119108	Nonproliferative diabetic retinopathy due to type 2 diabetes mellitus (disorder)	68	26929004	Alzheimer's disease (disorder)	1095	12	23	0	12	23	1060	0.00000	-0.01542	0.00000	0.00000	0.00000	1.0000000000	1.0000000000	0.25205	-0.32430	7	15	0	5	8	0	0.00000	0.00000
97	403192003	Third degree burn	68	26929004	Alzheimer's disease (disorder)	1095	8	23	0	8	23	1064	0.00000	-0.01257	0.00000	0.00000	0.00000	1.0000000000	1.0000000000	0.16804	-0.22409	3	15	0	5	8	0	0.00000	0.00000
96	283371005	Laceration of forearm	68	26929004	Alzheimer's disease (disorder)	1095	75	23	3	72	20	1000	1.90435	0.03592	2.08333	7.17644	0.60480	0.2048261543	0.8533859271	1.57534	0.63524	39	15	3	36	8	0	1.79176	2.63906
94	703151001	History of single seizure (situation)	68	26929004	Alzheimer's disease (disorder)	1095	39	23	2	37	21	1035	2.44147	0.04058	2.66409	11.78553	0.60221	0.1960135967	0.8340316782	0.81918	0.72168	14	15	1	25	8	1	0.57536	-0.55005
93	128613002	Seizure disorder	68	26929004	Alzheimer's disease (disorder)	1095	39	23	2	37	21	1035	2.44147	0.04058	2.66409	11.78553	0.60221	0.1960135967	0.8340316782	0.81918	0.72168	14	15	1	25	8	1	0.57536	-0.55005
89	47693006	Rupture of appendix	68	26929004	Alzheimer's disease (disorder)	1095	20	23	0	20	23	1052	0.00000	-0.01998	0.00000	0.00000	0.00000	1.0000000000	1.0000000000	0.42009	-0.50598	10	15	0	10	8	0	0.00000	0.00000
86	713197008	Recurrent rectal polyp	68	26929004	Alzheimer's disease (disorder)	1095	22	23	4	18	19	1054	8.65613	0.16058	12.32749	39.90090	3.80861	0.0008443346	0.0216712543	0.46210	1.77389	12	15	4	10	8	0	1.55814	1.38629
82	94260004	Secondary malignant neoplasm of colon	68	26929004	Alzheimer's disease (disorder)	1095	4	23	0	4	23	1068	0.00000	-0.00887	0.00000	0.00000	0.00000	1.0000000000	1.0000000000	0.08402	-0.11639	2	15	0	2	8	0	0.00000	0.00000
78	239872002	Osteoarthritis of hip	68	26929004	Alzheimer's disease (disorder)	1095	21	23	0	21	23	1051	0.00000	-0.02048	0.00000	0.00000	0.00000	1.0000000000	1.0000000000	0.44110	-0.52717	13	15	0	8	8	0	0.00000	0.00000
76	127013003	Diabetic renal disease (disorder)	68	26929004	Alzheimer's disease (disorder)	1095	28	23	0	28	23	1044	0.00000	-0.02373	0.00000	0.00000	0.00000	1.0000000000	1.0000000000	0.58813	-0.66733	10	15	0	18	8	0	0.00000	0.00000
75	431855005	Chronic kidney disease stage 1 (disorder)	68	26929004	Alzheimer's disease (disorder)	1095	28	23	0	28	23	1044	0.00000	-0.02373	0.00000	0.00000	0.00000	1.0000000000	1.0000000000	0.58813	-0.66733	10	15	0	18	8	0	0.00000	0.00000
72	35999006	Blighted ovum	68	26929004	Alzheimer's disease (disorder)	1095	53	23	2	51	21	1021	1.79655	0.02631	1.90663	8.35407	0.43515	0.3070370590	0.9977249576	1.11324	0.50550	53	15	2	0	8	0	2.14007	3.31419
71	201834006	Localized  primary osteoarthritis of the hand	68	26929004	Alzheimer's disease (disorder)	1095	28	23	2	26	21	1046	3.40062	0.05696	3.83150	17.20070	0.85348	0.1146806889	0.6697718480	0.58813	0.91764	19	15	2	9	8	0	2.14007	2.35138
70	87433001	Pulmonary emphysema (disorder)	68	26929004	Alzheimer's disease (disorder)	1095	17	23	1	16	22	1056	2.80051	0.03312	3.00000	23.63061	0.38086	0.3048121888	0.9953175875	0.35708	0.55950	9	15	0	8	8	1	-2.19722	-2.19722
69	233604007	Pneumonia	68	26929004	Alzheimer's disease (disorder)	1095	7	23	5	2	18	1070	34.00621	0.38779	148.61111	817.32915	27.02126	0.0000000529	0.0000032231	0.14703	2.38706	3	15	3	4	8	2	0.18232	-0.40547
67	403191005	Second degree burn	68	26929004	Alzheimer's disease (disorder)	1095	49	23	3	46	20	1026	2.91482	0.06071	3.34565	11.66494	0.95958	0.0794562744	0.5584007465	1.02922	0.97907	23	15	2	26	8	1	-0.05716	-0.77011
65	239873007	Osteoarthritis of knee	68	26929004	Alzheimer's disease (disorder)	1095	57	23	5	52	18	1020	4.17620	0.10902	5.44872	15.25073	1.94670	0.0052378725	0.0931740363	1.19726	1.44926	30	15	4	27	8	1	-0.63908	-1.19214
64	444448004	Injury of medial collateral ligament of knee	68	26929004	Alzheimer's disease (disorder)	1095	32	23	0	32	23	1040	0.00000	-0.02541	0.00000	0.00000	0.00000	1.0000000000	1.0000000000	0.67215	-0.74170	17	15	0	15	8	0	0.00000	0.00000
63	68496003	Polyp of colon	68	26929004	Alzheimer's disease (disorder)	1095	91	23	11	80	12	992	5.75490	0.20968	11.36667	26.57423	4.86189	0.0000004264	0.0000233957	1.91142	2.04324	43	15	9	48	8	2	-0.62861	-1.46486
59	262574004	Bullet wound	68	26929004	Alzheimer's disease (disorder)	1095	20	23	0	20	23	1052	0.00000	-0.01998	0.00000	0.00000	0.00000	1.0000000000	1.0000000000	0.42009	-0.50598	9	15	0	11	8	0	0.00000	0.00000
58	239720000	Tear of meniscus of knee	68	26929004	Alzheimer's disease (disorder)	1095	20	23	0	20	23	1052	0.00000	-0.01998	0.00000	0.00000	0.00000	1.0000000000	1.0000000000	0.42009	-0.50598	10	15	0	10	8	0	0.00000	0.00000
57	192127007	Child attention deficit disorder	68	26929004	Alzheimer's disease (disorder)	1095	76	23	0	76	23	996	0.00000	-0.04000	0.00000	0.00000	0.00000	0.3982835573	1.0000000000	1.59635	-1.37648	24	15	0	52	8	0	0.00000	0.00000
56	92691004	Carcinoma in situ of prostate (disorder)	68	26929004	Alzheimer's disease (disorder)	1095	23	23	3	20	20	1052	6.20983	0.11178	7.89000	28.70922	2.16837	0.0109059326	0.1633656590	0.48311	1.43138	0	15	0	23	8	3	-1.29928	-2.15948
54	5602001	Opioid abuse (disorder)	68	26929004	Alzheimer's disease (disorder)	1095	7	23	0	7	23	1065	0.00000	-0.01175	0.00000	0.00000	0.00000	1.0000000000	1.0000000000	0.14703	-0.19791	0	15	0	7	8	0	0.00000	0.00000
52	124171000119105	Chronic intractable migraine without aura	68	26929004	Alzheimer's disease (disorder)	1095	51	23	0	51	23	1021	0.00000	-0.03237	0.00000	0.00000	0.00000	0.6211545311	1.0000000000	1.07123	-1.05049	21	15	0	30	8	0	0.00000	0.00000
50	446096008	Perennial allergic rhinitis	68	26929004	Alzheimer's disease (disorder)	1095	26	23	0	26	23	1046	0.00000	-0.02284	0.00000	0.00000	0.00000	1.0000000000	1.0000000000	0.54612	-0.62865	14	15	0	12	8	0	0.00000	0.00000
49	88805009	Chronic congestive heart failure (disorder)	68	26929004	Alzheimer's disease (disorder)	1095	10	23	1	9	22	1063	4.76087	0.05289	5.36869	44.22373	0.65175	0.1919811700	0.8268943621	0.21005	0.72494	5	15	1	5	8	0	2.77259	1.79176
47	359817006	Closed fracture of hip	68	26929004	Alzheimer's disease (disorder)	1095	29	23	2	27	21	1045	3.28336	0.05516	3.68607	16.51768	0.82258	0.1216407719	0.6889733259	0.60913	0.89868	11	15	2	18	8	0	2.14007	1.87180
45	263102004	Fracture subluxation of wrist	68	26929004	Alzheimer's disease (disorder)	1095	109	23	8	101	15	971	3.49422	0.12147	5.12739	12.38882	2.12209	0.0010269760	0.0254655244	2.28950	1.45206	51	15	4	58	8	4	0.45953	-0.11980
44	58150001	Fracture of clavicle	68	26929004	Alzheimer's disease (disorder)	1095	112	23	3	109	20	963	1.27523	0.01361	1.32523	4.53188	0.38753	0.7230712273	1.0000000000	2.35251	0.25476	55	15	2	57	8	1	-0.05716	-0.71054
43	307731004	Injury of tendon of the rotator cuff of shoulder	68	26929004	Alzheimer's disease (disorder)	1095	51	23	3	48	20	1024	2.80051	0.05829	3.20000	11.14160	0.91908	0.0873973862	0.5838464658	1.07123	0.94951	26	15	2	25	8	1	-0.05716	-0.61904
42	16114001	Fracture of ankle	68	26929004	Alzheimer's disease (disorder)	1095	108	23	3	105	20	967	1.32246	0.01562	1.38143	4.72661	0.40375	0.4891446374	1.0000000000	2.26849	0.29137	48	15	2	60	8	1	-0.05716	-0.89200
41	283385000	Laceration of thigh	68	26929004	Alzheimer's disease (disorder)	1095	105	23	2	103	21	969	0.90683	-0.00444	0.89598	3.87566	0.20713	1.0000000000	1.0000000000	2.20548	-0.09558	50	15	2	55	8	0	2.14007	3.25810
39	74400008	Appendicitis	68	26929004	Alzheimer's disease (disorder)	1095	51	23	1	50	22	1022	0.93350	-0.00215	0.92909	7.03202	0.12275	1.0000000000	1.0000000000	1.07123	-0.05049	27	15	1	24	8	0	2.77259	3.33220
38	398254007	Preeclampsia	68	26929004	Alzheimer's disease (disorder)	1095	101	23	3	98	20	974	1.41412	0.01934	1.49082	5.10624	0.43526	0.4631086357	1.0000000000	2.12146	0.35778	101	15	3	0	8	0	1.79176	3.54578
35	19169002	Miscarriage in first trimester	68	26929004	Alzheimer's disease (disorder)	1095	174	23	7	167	16	905	1.91529	0.05827	2.37088	5.85126	0.96066	0.0763498998	0.5462097970	3.65479	0.78128	174	15	7	0	8	0	1.14513	3.25259
33	429007001	History of cardiac arrest (situation)	68	26929004	Alzheimer's disease (disorder)	1095	42	23	2	40	21	1032	2.26708	0.03707	2.45714	10.84161	0.55689	0.2194727604	0.8768098041	0.88219	0.67255	24	15	1	18	8	1	0.57536	0.27444
32	410429000	Cardiac Arrest	68	26929004	Alzheimer's disease (disorder)	1095	42	23	2	40	21	1032	2.26708	0.03707	2.45714	10.84161	0.55689	0.2194727604	0.8768098041	0.88219	0.67255	24	15	1	18	8	1	0.57536	0.27444
30	399211009	History of myocardial infarction (situation)	68	26929004	Alzheimer's disease (disorder)	1095	31	23	0	31	23	1041	0.00000	-0.02500	0.00000	0.00000	0.00000	1.0000000000	1.0000000000	0.65114	-0.72346	2	15	0	29	8	0	0.00000	0.00000
29	22298006	Myocardial Infarction	68	26929004	Alzheimer's disease (disorder)	1095	31	23	0	31	23	1041	0.00000	-0.02500	0.00000	0.00000	0.00000	1.0000000000	1.0000000000	0.65114	-0.72346	2	15	0	29	8	0	0.00000	0.00000
27	408512008	Body mass index 40+ - severely obese (finding)	68	26929004	Alzheimer's disease (disorder)	1095	97	23	4	93	19	979	1.96325	0.04399	2.21619	6.65107	0.73845	0.1391001987	0.7320273048	2.03744	0.71907	67	15	4	30	8	0	1.55814	2.87639
24	162864005	Body mass index 30+ - obesity (finding)	68	26929004	Alzheimer's disease (disorder)	1095	439	23	14	425	9	647	1.51827	0.06210	2.36810	5.51998	1.01593	0.0517750619	0.4398325680	9.22100	0.55343	226	15	11	213	8	3	-0.43908	-1.20650
23	36971009	Sinusitis (disorder)	68	26929004	Alzheimer's disease (disorder)	1095	190	23	4	186	19	886	1.00229	0.00015	1.00283	2.98192	0.33725	1.0000000000	1.0000000000	3.99087	0.00264	84	15	1	106	8	3	1.47331	0.84992
21	15777000	Prediabetes	68	26929004	Alzheimer's disease (disorder)	1095	333	23	16	317	7	755	2.28750	0.12467	5.44389	13.36065	2.21815	0.0001058702	0.0036160633	6.99452	1.08845	159	15	10	174	8	6	0.06899	-0.57388
20	80394007	Hyperglycemia (disorder)	68	26929004	Alzheimer's disease (disorder)	1095	55	23	0	55	23	1017	0.00000	-0.03368	0.00000	0.00000	0.00000	0.6248522476	1.0000000000	1.15525	-1.10786	23	15	0	32	8	0	0.00000	0.00000
19	237602007	Metabolic syndrome X (disorder)	68	26929004	Alzheimer's disease (disorder)	1095	64	23	0	64	23	1008	0.00000	-0.03649	0.00000	0.00000	0.00000	0.3932410777	1.0000000000	1.34429	-1.22915	28	15	0	36	8	0	0.00000	0.00000
18	302870006	Hypertriglyceridemia (disorder)	68	26929004	Alzheimer's disease (disorder)	1095	64	23	0	64	23	1008	0.00000	-0.03649	0.00000	0.00000	0.00000	0.3932410777	1.0000000000	1.34429	-1.22915	28	15	0	36	8	0	0.00000	0.00000
17	368581000119106	Neuropathy due to type 2 diabetes mellitus (disorder)	68	26929004	Alzheimer's disease (disorder)	1095	28	23	0	28	23	1044	0.00000	-0.02373	0.00000	0.00000	0.00000	1.0000000000	1.0000000000	0.58813	-0.66733	7	15	0	21	8	0	0.00000	0.00000
15	40055000	Chronic sinusitis (disorder)	68	26929004	Alzheimer's disease (disorder)	1095	216	23	5	211	18	861	1.10205	0.00741	1.13349	3.08789	0.41608	0.7919872525	1.0000000000	4.53699	0.11586	104	15	2	112	8	3	0.84078	0.32397
14	10509002	Acute bronchitis (disorder)	68	26929004	Alzheimer's disease (disorder)	1095	863	23	23	840	0	232	1.26883	0.07595	0.00000	0.00000	0.00000	0.0075883293	0.1256799135	18.12694	0.32743	418	15	15	445	8	8	0.00000	-0.67376
13	370247008	Facial laceration	68	26929004	Alzheimer's disease (disorder)	1095	109	23	3	106	20	966	1.31033	0.01511	1.36698	4.67653	0.39958	0.4930296836	1.0000000000	2.28950	0.28213	55	15	1	54	8	2	1.16315	0.69315
10	62106007	Concussion with no loss of consciousness	68	26929004	Alzheimer's disease (disorder)	1095	206	23	2	204	21	868	0.46222	-0.03792	0.40523	1.74210	0.09426	0.2851312483	0.9659403678	4.32694	-0.82834	96	15	1	110	8	1	0.57536	-0.13482
8	233678006	Childhood asthma	68	26929004	Alzheimer's disease (disorder)	1095	45	23	0	45	23	1027	0.00000	-0.03032	0.00000	0.00000	0.00000	0.6203225651	1.0000000000	0.94521	-0.95992	25	15	0	20	8	0	0.00000	0.00000
7	75498004	Acute bacterial sinusitis (disorder)	68	26929004	Alzheimer's disease (disorder)	1095	187	23	2	185	21	887	0.50918	-0.03263	0.45663	1.96431	0.10615	0.4039413151	1.0000000000	3.92785	-0.71600	89	15	1	98	8	1	0.57536	-0.09531
6	39848009	Whiplash injury to neck	68	26929004	Alzheimer's disease (disorder)	1095	182	23	1	181	22	891	0.26159	-0.04829	0.22376	1.67060	0.02997	0.1550048044	0.7747075658	3.82283	-1.26988	92	15	0	90	8	1	-2.19722	-4.51086
5	284549007	Laceration of hand	68	26929004	Alzheimer's disease (disorder)	1095	104	23	3	101	20	971	1.37333	0.01771	1.44208	4.93700	0.42123	0.4739955907	1.0000000000	2.18447	0.32894	54	15	1	50	8	2	1.16315	0.74924
118	48333001	Burn injury(morphologic abnormality)	84	232353008	Perennial allergic rhinitis with seasonal variation	1095	1	29	0	1	29	1065	0.00000	-0.00499	0.00000	0.00000	0.00000	1.0000000000	1.0000000000	0.02648	-0.03771	0	14	0	1	15	0	0.00000	0.00000
119	275272006	Brain damage - traumatic	84	232353008	Perennial allergic rhinitis with seasonal variation	1095	4	29	0	4	29	1062	0.00000	-0.00999	0.00000	0.00000	0.00000	1.0000000000	1.0000000000	0.10594	-0.14527	0	14	0	4	15	0	0.00000	0.00000
1	444814009	Viral sinusitis (disorder)	68	26929004	Alzheimer's disease (disorder)	1095	993	23	23	970	0	102	1.10272	0.04695	0.00000	0.00000	0.00000	0.1580460463	0.7763448205	20.85753	0.13490	478	15	15	515	8	8	0.00000	-0.68768
121	254637007	Non-small cell lung cancer (disorder)	84	232353008	Perennial allergic rhinitis with seasonal variation	1095	8	29	0	8	29	1058	0.00000	-0.01415	0.00000	0.00000	0.00000	1.0000000000	1.0000000000	0.21187	-0.27724	0	14	0	8	15	0	0.00000	0.00000
123	195967001	Asthma	84	232353008	Perennial allergic rhinitis with seasonal variation	1095	2	29	1	1	28	1065	18.87931	0.12615	38.03571	623.66928	2.31968	0.0522902006	0.4421997889	0.05297	0.92554	1	14	0	1	15	1	-2.77259	-0.69315
126	698754002	Chronic paralysis due to lesion of spinal cord	84	232353008	Perennial allergic rhinitis with seasonal variation	1095	2	29	0	2	29	1064	0.00000	-0.00706	0.00000	0.00000	0.00000	1.0000000000	1.0000000000	0.05297	-0.07446	2	14	0	0	15	0	0.00000	0.00000
127	431856006	Chronic kidney disease stage 2 (disorder)	84	232353008	Perennial allergic rhinitis with seasonal variation	1095	5	29	0	5	29	1061	0.00000	-0.01117	0.00000	0.00000	0.00000	1.0000000000	1.0000000000	0.13242	-0.17941	3	14	0	2	15	0	0.00000	0.00000
128	86849004	Suicidal deliberate poisoning	84	232353008	Perennial allergic rhinitis with seasonal variation	1095	1	29	0	1	29	1065	0.00000	-0.00499	0.00000	0.00000	0.00000	1.0000000000	1.0000000000	0.02648	-0.03771	0	14	0	1	15	0	0.00000	0.00000
130	314994000	Metastasis from malignant tumor of prostate (disorder)	84	232353008	Perennial allergic rhinitis with seasonal variation	1095	1	29	0	1	29	1065	0.00000	-0.00499	0.00000	0.00000	0.00000	1.0000000000	1.0000000000	0.02648	-0.03771	0	14	0	1	15	0	0.00000	0.00000
131	93761005	Primary malignant neoplasm of colon	84	232353008	Perennial allergic rhinitis with seasonal variation	1095	5	29	0	5	29	1061	0.00000	-0.01117	0.00000	0.00000	0.00000	1.0000000000	1.0000000000	0.13242	-0.17941	3	14	0	2	15	0	0.00000	0.00000
132	69896004	Rheumatoid arthritis	84	232353008	Perennial allergic rhinitis with seasonal variation	1095	3	29	0	3	29	1063	0.00000	-0.00865	0.00000	0.00000	0.00000	1.0000000000	1.0000000000	0.07945	-0.11030	2	14	0	1	15	0	0.00000	0.00000
75	431855005	Chronic kidney disease stage 1 (disorder)	42	16114001	Fracture of ankle	1095	28	108	3	25	105	962	1.08631	0.00462	1.09943	3.70311	0.32641	0.7511776610	1.0000000000	2.76164	0.08864	10	48	1	18	60	2	0.45783	0.09531
132	69896004	Rheumatoid arthritis	16	44054006	Diabetes	1095	3	68	0	3	68	1024	0.00000	-0.01349	0.00000	0.00000	0.00000	1.0000000000	1.0000000000	0.18630	-0.24647	2	29	0	1	39	0	0.00000	0.00000
131	93761005	Primary malignant neoplasm of colon	16	44054006	Diabetes	1095	5	68	0	5	68	1022	0.00000	-0.01743	0.00000	0.00000	0.00000	1.0000000000	1.0000000000	0.31050	-0.39012	3	29	0	2	39	0	0.00000	0.00000
130	314994000	Metastasis from malignant tumor of prostate (disorder)	16	44054006	Diabetes	1095	1	68	1	0	67	1027	16.10294	0.11750	0.00000	0.00000	0.00000	0.0621004566	0.4836892708	0.06210	0.91308	0	29	0	1	39	1	-3.68888	-0.69315
129	47505003	Posttraumatic stress disorder	16	44054006	Diabetes	1095	4	68	2	2	66	1025	8.05147	0.10987	15.53030	112.00019	2.15348	0.0210231326	0.2591403333	0.24840	1.26488	1	29	0	3	39	2	-3.02042	-0.91629
15	40055000	Chronic sinusitis (disorder)	42	16114001	Fracture of ankle	1095	216	108	24	192	84	795	1.12654	0.02075	1.18304	1.91234	0.73187	0.5240418157	1.0000000000	21.30411	0.16462	104	48	10	112	60	14	0.09285	0.23639
127	431856006	Chronic kidney disease stage 2 (disorder)	16	44054006	Diabetes	1095	5	68	5	0	63	1027	16.10294	0.26321	0.00000	0.00000	0.00000	0.0000008019	0.0000409250	0.31050	2.19484	3	29	3	2	39	2	-0.65330	0.00000
126	698754002	Chronic paralysis due to lesion of spinal cord	16	44054006	Diabetes	1095	2	68	0	2	68	1025	0.00000	-0.01101	0.00000	0.00000	0.00000	1.0000000000	1.0000000000	0.12420	-0.16890	2	29	0	0	39	0	0.00000	0.00000
125	1734006	Fracture of the vertebral column with spinal cord injury	16	44054006	Diabetes	1095	5	68	0	5	68	1022	0.00000	-0.01743	0.00000	0.00000	0.00000	1.0000000000	1.0000000000	0.31050	-0.39012	3	29	0	2	39	0	0.00000	0.00000
124	1501000119109	Proliferative diabetic retinopathy due to type II diabetes mellitus (disorder)	16	44054006	Diabetes	1095	1	68	1	0	67	1027	16.10294	0.11750	0.00000	0.00000	0.00000	0.0621004566	0.4836892708	0.06210	0.91308	1	29	1	0	39	0	3.40120	0.69315
117	230265002	Familial Alzheimer's disease of early onset (disorder)	29	22298006	Myocardial Infarction	1095	6	31	0	6	31	1058	0.00000	-0.01267	0.00000	0.00000	0.00000	1.0000000000	1.0000000000	0.16986	-0.22634	2	2	0	4	29	0	0.00000	0.00000
118	48333001	Burn injury(morphologic abnormality)	29	22298006	Myocardial Infarction	1095	1	31	0	1	31	1063	0.00000	-0.00516	0.00000	0.00000	0.00000	1.0000000000	1.0000000000	0.02831	-0.04028	0	2	0	1	29	0	0.00000	0.00000
121	254637007	Non-small cell lung cancer (disorder)	16	44054006	Diabetes	1095	8	68	2	6	66	1021	4.02574	0.06679	5.15657	26.04489	1.02094	0.0834664194	0.5700988979	0.49680	1.00308	0	29	0	8	39	2	-3.02042	-1.60944
120	162573006	Suspected lung cancer (situation)	16	44054006	Diabetes	1095	8	68	2	6	66	1021	4.02574	0.06679	5.15657	26.04489	1.02094	0.0834664194	0.5700988979	0.49680	1.00308	0	29	0	8	39	2	-3.02042	-1.60944
119	275272006	Brain damage - traumatic	16	44054006	Diabetes	1095	4	68	0	4	68	1023	0.00000	-0.01558	0.00000	0.00000	0.00000	1.0000000000	1.0000000000	0.24840	-0.32008	0	29	0	4	39	0	0.00000	0.00000
118	48333001	Burn injury(morphologic abnormality)	16	44054006	Diabetes	1095	1	68	0	1	68	1026	0.00000	-0.00778	0.00000	0.00000	0.00000	1.0000000000	1.0000000000	0.06210	-0.08692	0	29	0	1	39	0	0.00000	0.00000
117	230265002	Familial Alzheimer's disease of early onset (disorder)	16	44054006	Diabetes	1095	6	68	2	4	66	1023	5.36765	0.08342	7.75000	43.08728	1.39397	0.0484583391	0.4232510452	0.37260	1.12805	2	29	2	4	39	0	2.74084	0.69315
116	370143000	Major depression disorder	16	44054006	Diabetes	1095	8	68	2	6	66	1021	4.02574	0.06679	5.15657	26.04489	1.02094	0.0834664194	0.5700988979	0.49680	1.00308	3	29	0	5	39	2	-3.02042	-1.25276
115	36923009	Major depression  single episode	16	44054006	Diabetes	1095	6	68	1	5	67	1022	2.68382	0.03216	3.05075	26.48564	0.35140	0.3199471486	1.0000000000	0.37260	0.54309	3	29	0	3	39	1	-3.68888	-1.38629
114	449868002	Smokes tobacco daily	16	44054006	Diabetes	1095	9	68	3	6	65	1021	5.36765	0.10231	7.85385	32.11764	1.92053	0.0146924904	0.2040675334	0.55890	1.35947	2	29	1	7	39	2	0.38077	-0.40547
113	443165006	Pathological fracture due to osteoporosis (disorder)	16	44054006	Diabetes	1095	10	68	2	8	66	1019	3.22059	0.05486	3.85985	18.54107	0.80354	0.1238785663	0.6913144812	0.62100	0.88807	7	29	2	3	39	0	2.74084	1.50408
112	49436004	Atrial Fibrillation	16	44054006	Diabetes	1095	35	68	5	30	63	997	2.30042	0.06080	2.63757	7.03044	0.98952	0.0603399126	0.4789003189	2.17352	0.91888	9	29	0	26	39	5	-2.17475	-1.82455
111	235919008	Cholelithiasis	16	44054006	Diabetes	1095	9	68	0	9	68	1018	0.00000	-0.02342	0.00000	0.00000	0.00000	1.0000000000	1.0000000000	0.55890	-0.64053	7	29	0	2	39	0	0.00000	0.00000
110	65275009	Acute Cholecystitis	16	44054006	Diabetes	1095	9	68	0	9	68	1018	0.00000	-0.02342	0.00000	0.00000	0.00000	1.0000000000	1.0000000000	0.55890	-0.64053	7	29	0	2	39	0	0.00000	0.00000
109	90560007	Gout	16	44054006	Diabetes	1095	4	68	0	4	68	1023	0.00000	-0.01558	0.00000	0.00000	0.00000	1.0000000000	1.0000000000	0.24840	-0.32008	0	29	0	4	39	0	0.00000	0.00000
108	40930008	Hypothyroidism (disorder)	16	44054006	Diabetes	1095	13	68	0	13	68	1014	0.00000	-0.02821	0.00000	0.00000	0.00000	1.0000000000	1.0000000000	0.80731	-0.85384	11	29	0	2	39	0	0.00000	0.00000
107	40275004	Contact dermatitis	16	44054006	Diabetes	1095	18	68	2	16	66	1011	1.78922	0.02625	1.91477	8.50381	0.43114	0.3089444728	1.0000000000	1.11781	0.50239	9	29	0	9	39	2	-3.02042	-1.70475
106	24079001	Atopic dermatitis	16	44054006	Diabetes	1095	20	68	0	20	68	1007	0.00000	-0.03510	0.00000	0.00000	0.00000	0.6300412956	1.0000000000	1.24201	-1.16479	13	29	0	7	39	0	0.00000	0.00000
105	363406005	Malignant tumor of colon	16	44054006	Diabetes	1095	6	68	1	5	67	1022	2.68382	0.03216	3.05075	26.48564	0.35140	0.3199471486	1.0000000000	0.37260	0.54309	4	29	1	2	39	0	3.40120	1.60944
104	367498001	Seasonal allergic rhinitis	16	44054006	Diabetes	1095	20	68	0	20	68	1007	0.00000	-0.03510	0.00000	0.00000	0.00000	0.6300412956	1.0000000000	1.24201	-1.16479	9	29	0	11	39	0	0.00000	0.00000
103	157141000119108	Proteinuria due to type 2 diabetes mellitus (disorder)	16	44054006	Diabetes	1095	3	68	3	0	65	1027	16.10294	0.20369	0.00000	0.00000	0.00000	0.0002296551	0.0071740650	0.18630	1.75353	1	29	1	2	39	2	0.38077	0.00000
102	90781000119102	Microalbuminuria due to type 2 diabetes mellitus (disorder)	16	44054006	Diabetes	1095	6	68	6	0	62	1027	16.10294	0.28846	0.00000	0.00000	0.00000	0.0000000463	0.0000028451	0.37260	2.35044	3	29	3	3	39	3	-0.27193	0.00000
101	433144002	Chronic kidney disease stage 3 (disorder)	16	44054006	Diabetes	1095	3	68	3	0	65	1027	16.10294	0.20369	0.00000	0.00000	0.00000	0.0002296551	0.0071740650	0.18630	1.75353	1	29	1	2	39	2	0.38077	0.00000
100	161622006	History of lower limb amputation (situation)	16	44054006	Diabetes	1095	1	68	1	0	67	1027	16.10294	0.11750	0.00000	0.00000	0.00000	0.0621004566	0.4836892708	0.06210	0.91308	0	29	0	1	39	1	-3.68888	-0.69315
99	30832001	Rupture of patellar tendon	16	44054006	Diabetes	1095	23	68	5	18	63	1009	3.50064	0.09425	4.44885	12.37438	1.59946	0.0111636794	0.1657421438	1.42831	1.30501	14	29	3	9	39	2	-0.65330	0.02985
98	1551000119108	Nonproliferative diabetic retinopathy due to type 2 diabetes mellitus (disorder)	16	44054006	Diabetes	1095	12	68	12	0	56	1027	16.10294	0.40908	0.00000	0.00000	0.00000	0.0000000000	0.0000000000	0.74521	2.89704	7	29	7	5	39	5	-0.53714	0.00000
97	403192003	Third degree burn	16	44054006	Diabetes	1095	8	68	1	7	67	1020	2.01287	0.02236	2.17484	17.93542	0.26372	0.4022607083	1.0000000000	0.49680	0.41812	3	29	0	5	39	1	-3.68888	-1.79176
96	283371005	Laceration of forearm	16	44054006	Diabetes	1095	75	68	5	70	63	957	1.07353	0.00513	1.08503	2.78441	0.42282	0.8041514295	1.0000000000	4.65753	0.08479	39	29	4	36	39	1	-1.57867	-1.23601
95	84757009	Epilepsy	16	44054006	Diabetes	1095	30	68	1	29	67	998	0.53676	-0.02001	0.51364	3.82870	0.06891	1.0000000000	1.0000000000	1.86301	-0.51753	13	29	0	17	39	1	-3.68888	-2.89037
94	703151001	History of single seizure (situation)	16	44054006	Diabetes	1095	39	68	2	37	66	990	0.82579	-0.00861	0.81081	3.43769	0.19124	1.0000000000	1.0000000000	2.42192	-0.18984	14	29	0	25	39	2	-3.02042	-2.60269
93	128613002	Seizure disorder	16	44054006	Diabetes	1095	39	68	2	37	66	990	0.82579	-0.00861	0.81081	3.43769	0.19124	1.0000000000	1.0000000000	2.42192	-0.18984	14	29	0	25	39	2	-3.02042	-2.60269
92	82423001	Chronic pain	16	44054006	Diabetes	1095	52	68	3	49	65	978	0.92902	-0.00408	0.92119	3.03544	0.27956	1.0000000000	1.0000000000	3.22922	-0.08039	24	29	2	28	39	1	-0.94804	-0.80235
91	64859006	Osteoporosis (disorder)	16	44054006	Diabetes	1095	37	68	3	34	65	993	1.30564	0.01471	1.34796	4.50607	0.40323	0.4964587120	1.0000000000	2.29772	0.27853	24	29	3	13	39	0	2.36712	2.19722
89	47693006	Rupture of appendix	16	44054006	Diabetes	1095	20	68	0	20	68	1007	0.00000	-0.03510	0.00000	0.00000	0.00000	0.6300412956	1.0000000000	1.24201	-1.16479	10	29	0	10	39	0	0.00000	0.00000
88	197927001	Recurrent urinary tract infection	16	44054006	Diabetes	1095	8	68	2	6	66	1021	4.02574	0.06679	5.15657	26.04489	1.02094	0.0834664194	0.5700988979	0.49680	1.00308	8	29	2	0	39	0	2.74084	1.60944
86	713197008	Recurrent rectal polyp	16	44054006	Diabetes	1095	22	68	2	20	66	1007	1.46390	0.01709	1.52576	6.66734	0.34916	0.6422141242	1.0000000000	1.36621	0.34238	12	29	1	10	39	1	-0.28768	0.16705
85	241929008	Acute allergic reaction	16	44054006	Diabetes	1095	47	68	2	45	66	982	0.68523	-0.01715	0.66128	2.78584	0.15697	0.7635108276	1.0000000000	2.91872	-0.38542	25	29	2	22	39	0	2.74084	2.60269
84	232353008	Perennial allergic rhinitis with seasonal variation	16	44054006	Diabetes	1095	29	68	2	27	66	1000	1.11055	0.00469	1.12233	4.82190	0.26123	0.7000714118	1.0000000000	1.80091	0.09907	14	29	2	15	39	0	2.74084	2.07944
83	110030002	Concussion injury of brain	16	44054006	Diabetes	1095	7	68	0	7	68	1020	0.00000	-0.02064	0.00000	0.00000	0.00000	1.0000000000	1.0000000000	0.43470	-0.52075	1	29	0	6	39	0	0.00000	0.00000
82	94260004	Secondary malignant neoplasm of colon	16	44054006	Diabetes	1095	4	68	1	3	67	1024	4.02574	0.04714	5.09453	49.64000	0.52285	0.2264874134	0.8836028956	0.24840	0.67992	2	29	0	2	39	1	-3.68888	-1.09861
81	236077008	Protracted diarrhea	16	44054006	Diabetes	1095	4	68	1	3	67	1024	4.02574	0.04714	5.09453	49.64000	0.52285	0.2264874134	0.8836028956	0.24840	0.67992	2	29	0	2	39	1	-3.68888	-1.09861
80	6072007	Bleeding from anus	16	44054006	Diabetes	1095	4	68	1	3	67	1024	4.02574	0.04714	5.09453	49.64000	0.52285	0.2264874134	0.8836028956	0.24840	0.67992	2	29	0	2	39	1	-3.68888	-1.09861
79	45816000	Pyelonephritis	16	44054006	Diabetes	1095	1	68	0	1	68	1026	0.00000	-0.00778	0.00000	0.00000	0.00000	1.0000000000	1.0000000000	0.06210	-0.08692	1	29	0	0	39	0	0.00000	0.00000
78	239872002	Osteoarthritis of hip	16	44054006	Diabetes	1095	21	68	4	17	64	1010	3.06723	0.07438	3.71324	11.35900	1.21385	0.0364882415	0.3590974313	1.30411	1.11772	13	29	1	8	39	3	0.76214	1.33977
77	422034002	Diabetic retinopathy associated with type II diabetes mellitus (disorder)	16	44054006	Diabetes	1095	20	68	20	0	48	1027	16.10294	0.53008	0.00000	0.00000	0.00000	0.0000000000	0.0000000000	1.24201	3.22753	8	29	8	12	39	12	0.08456	0.00000
76	127013003	Diabetic renal disease (disorder)	16	44054006	Diabetes	1095	28	68	28	0	40	1027	16.10294	0.62955	0.00000	0.00000	0.00000	0.0000000000	0.0000000000	1.73881	3.40443	10	29	10	18	39	18	0.20830	0.00000
75	431855005	Chronic kidney disease stage 1 (disorder)	16	44054006	Diabetes	1095	28	68	28	0	40	1027	16.10294	0.62955	0.00000	0.00000	0.00000	0.0000000000	0.0000000000	1.73881	3.40443	10	29	10	18	39	18	0.20830	0.00000
73	196416002	Impacted molars	16	44054006	Diabetes	1095	49	68	4	45	64	982	1.31453	0.01752	1.36389	3.91082	0.47565	0.5393301531	1.0000000000	3.04292	0.30653	25	29	2	24	39	2	-0.27958	0.03774
72	35999006	Blighted ovum	16	44054006	Diabetes	1095	53	68	4	49	64	978	1.21532	0.01250	1.24745	3.56514	0.43648	0.5651365390	1.0000000000	3.29132	0.22051	53	29	4	0	39	0	2.11021	2.65676
71	201834006	Localized  primary osteoarthritis of the hand	16	44054006	Diabetes	1095	28	68	7	21	61	1006	4.02574	0.12612	5.49727	13.43469	2.24940	0.0010872761	0.0267325863	1.73881	1.54645	19	29	4	9	39	3	-0.52884	0.36291
70	87433001	Pulmonary emphysema (disorder)	16	44054006	Diabetes	1095	17	68	0	17	68	1010	0.00000	-0.03231	0.00000	0.00000	0.00000	0.6187101754	1.0000000000	1.05571	-1.03964	9	29	0	8	39	0	0.00000	0.00000
69	233604007	Pneumonia	16	44054006	Diabetes	1095	7	68	0	7	68	1020	0.00000	-0.02064	0.00000	0.00000	0.00000	1.0000000000	1.0000000000	0.43470	-0.52075	3	29	0	4	39	0	0.00000	0.00000
68	26929004	Alzheimer's disease (disorder)	16	44054006	Diabetes	1095	23	68	0	23	68	1004	0.00000	-0.03769	0.00000	0.00000	0.00000	0.3923884616	1.0000000000	1.42831	-1.27995	15	29	0	8	39	0	0.00000	0.00000
67	403191005	Second degree burn	16	44054006	Diabetes	1095	49	68	5	44	63	983	1.64316	0.03582	1.77309	4.62807	0.67930	0.2227012236	0.8794911525	3.04292	0.56956	23	29	2	26	39	3	0.10178	0.25705
65	239873007	Osteoarthritis of knee	16	44054006	Diabetes	1095	57	68	6	51	62	976	1.69505	0.04191	1.85199	4.48288	0.76511	0.1591588283	0.7778932040	3.53973	0.62475	30	29	1	27	39	5	1.22645	1.57769
64	444448004	Injury of medial collateral ligament of knee	16	44054006	Diabetes	1095	32	68	3	29	65	998	1.50965	0.02275	1.58833	5.35242	0.47134	0.4439823991	1.0000000000	1.98721	0.42120	17	29	2	15	39	1	-0.94804	-0.52130
63	68496003	Polyp of colon	16	44054006	Diabetes	1095	91	68	6	85	62	942	1.06173	0.00478	1.07249	2.55195	0.45073	0.8207186756	1.0000000000	5.65114	0.07375	43	29	1	48	39	5	1.22645	1.42334
62	185086009	Chronic obstructive bronchitis (disorder)	16	44054006	Diabetes	1095	6	68	0	6	68	1021	0.00000	-0.01910	0.00000	0.00000	0.00000	1.0000000000	1.0000000000	0.37260	-0.45691	4	29	0	2	39	0	0.00000	0.00000
61	198992004	Antepartum eclampsia	16	44054006	Diabetes	1095	96	68	7	89	61	938	1.17417	0.01389	1.20943	2.72358	0.53706	0.6560161622	1.0000000000	5.96164	0.20057	96	29	7	0	39	0	1.63761	2.68882
60	301011002	Escherichia coli urinary tract infection	16	44054006	Diabetes	1095	92	68	9	83	59	944	1.57529	0.04483	1.73494	3.62327	0.83075	0.1699067637	0.7972493423	5.71324	0.57492	85	29	8	7	39	1	-2.15740	0.37372
59	262574004	Bullet wound	16	44054006	Diabetes	1095	20	68	1	19	67	1008	0.80515	-0.00684	0.79183	6.00518	0.10441	1.0000000000	1.0000000000	1.24201	-0.16479	9	29	0	11	39	1	-3.68888	-2.48491
58	239720000	Tear of meniscus of knee	16	44054006	Diabetes	1095	20	68	2	18	66	1009	1.61029	0.02142	1.69865	7.47662	0.38593	0.3558366088	1.0000000000	1.24201	0.42017	10	29	0	10	39	2	-3.02042	-1.79176
57	192127007	Child attention deficit disorder	16	44054006	Diabetes	1095	76	68	7	69	61	958	1.48317	0.03395	1.59325	3.61536	0.70213	0.3179646132	1.0000000000	4.71963	0.48408	24	29	1	52	39	6	1.38629	0.95019
56	92691004	Carcinoma in situ of prostate (disorder)	16	44054006	Diabetes	1095	23	68	4	19	64	1008	2.80051	0.06786	3.31579	10.03539	1.09557	0.0491678665	0.4273223087	1.42831	1.04198	0	29	0	23	39	4	-2.37491	-1.90954
55	126906006	Neoplasm of prostate	16	44054006	Diabetes	1095	24	68	5	19	63	1008	3.35478	0.09070	4.21053	11.64721	1.52213	0.0134325861	0.1883566145	1.49041	1.26858	0	29	0	24	39	5	-2.17475	-1.75786
54	5602001	Opioid abuse (disorder)	16	44054006	Diabetes	1095	7	68	1	6	67	1021	2.30042	0.02684	2.53980	21.40175	0.30140	0.3624114222	1.0000000000	0.43470	0.47925	0	29	0	7	39	1	-3.68888	-2.07944
53	7200002	Alcoholism	16	44054006	Diabetes	1095	5	68	2	3	66	1024	6.44118	0.09483	10.34343	62.97760	1.69880	0.0336410124	0.3402083027	0.31050	1.19484	0	29	0	5	39	2	-3.02042	-1.25276
52	124171000119105	Chronic intractable migraine without aura	16	44054006	Diabetes	1095	51	68	5	46	63	981	1.57872	0.03291	1.69255	4.40913	0.64972	0.2399026601	0.9095097439	3.16712	0.52591	21	29	1	30	39	4	1.02629	0.95098
50	446096008	Perennial allergic rhinitis	16	44054006	Diabetes	1095	26	68	1	25	67	1002	0.61934	-0.01528	0.59821	4.48263	0.07983	1.0000000000	1.0000000000	1.61461	-0.38660	14	29	1	12	39	0	3.40120	2.70805
49	88805009	Chronic congestive heart failure (disorder)	16	44054006	Diabetes	1095	10	68	0	10	68	1017	0.00000	-0.02470	0.00000	0.00000	0.00000	1.0000000000	1.0000000000	0.62100	-0.69689	5	29	0	5	39	0	0.00000	0.00000
47	359817006	Closed fracture of hip	16	44054006	Diabetes	1095	29	68	0	29	68	998	0.00000	-0.04244	0.00000	0.00000	0.00000	0.2517935295	0.9133257124	1.80091	-1.48590	11	29	0	18	39	0	0.00000	0.00000
46	62564004	Concussion with loss of consciousness	16	44054006	Diabetes	1095	67	68	1	66	67	961	0.24034	-0.04990	0.21732	1.59019	0.02970	0.1175725347	0.6798759613	4.16073	-1.36758	36	29	1	31	39	0	3.40120	3.61092
45	263102004	Fracture subluxation of wrist	16	44054006	Diabetes	1095	109	68	6	103	62	924	0.88640	-0.00972	0.86815	2.05641	0.36650	1.0000000000	1.0000000000	6.76895	-0.15036	51	29	3	58	39	3	-0.27193	-0.12189
44	58150001	Fracture of clavicle	16	44054006	Diabetes	1095	112	68	9	103	59	924	1.29399	0.02553	1.36844	2.84058	0.65924	0.4064477554	1.0000000000	6.95525	0.33002	55	29	4	57	39	5	-0.06454	0.17355
43	307731004	Injury of tendon of the rotator cuff of shoulder	16	44054006	Diabetes	1095	51	68	8	43	60	984	2.52595	0.08679	3.05116	6.77966	1.37317	0.0107938863	0.1622409825	3.16712	1.11087	26	29	3	25	39	5	0.19237	0.47692
42	16114001	Fracture of ankle	16	44054006	Diabetes	1095	108	68	4	104	64	923	0.59641	-0.03435	0.55469	1.55416	0.19797	0.3975515877	1.0000000000	6.70685	-0.62421	48	29	1	60	39	3	0.76214	0.84730
41	283385000	Laceration of thigh	16	44054006	Diabetes	1095	105	68	9	96	59	931	1.38025	0.03187	1.47934	3.07644	0.71136	0.2869865360	0.9695093904	6.52055	0.41109	50	29	5	55	39	4	-0.45798	-0.29335
40	428251008	History of appendectomy	16	44054006	Diabetes	1095	51	68	2	49	66	978	0.63149	-0.02096	0.60482	2.54185	0.14392	0.7649915555	1.0000000000	3.16712	-0.47409	27	29	0	24	39	2	-3.02042	-2.56495
39	74400008	Appendicitis	16	44054006	Diabetes	1095	51	68	2	49	66	978	0.63149	-0.02096	0.60482	2.54185	0.14392	0.7649915555	1.0000000000	3.16712	-0.47409	27	29	0	24	39	2	-3.02042	-2.56495
38	398254007	Preeclampsia	16	44054006	Diabetes	1095	101	68	11	90	57	937	1.75379	0.06183	2.00916	3.96876	1.01713	0.0502498275	0.4320205543	6.27215	0.72258	101	29	11	0	39	0	1.29098	2.32060
37	38822007	Cystitis	16	44054006	Diabetes	1095	71	68	7	64	61	963	1.58761	0.03981	1.72669	3.92850	0.75893	0.1985302097	0.8410705506	4.40913	0.56460	68	29	7	3	39	0	1.63761	2.37158
35	19169002	Miscarriage in first trimester	16	44054006	Diabetes	1095	174	68	15	159	53	868	1.38818	0.04342	1.54503	2.80858	0.84994	0.1690812766	0.7953887708	10.80548	0.43862	174	29	15	0	39	0	1.07614	2.53370
33	429007001	History of cardiac arrest (situation)	16	44054006	Diabetes	1095	42	68	3	39	65	988	1.15021	0.00772	1.16923	3.88518	0.35188	0.7413337648	1.0000000000	2.60822	0.14871	24	29	2	18	39	1	-0.94804	-0.37949
32	410429000	Cardiac Arrest	16	44054006	Diabetes	1095	42	68	3	39	65	988	1.15021	0.00772	1.16923	3.88518	0.35188	0.7413337648	1.0000000000	2.60822	0.14871	24	29	2	18	39	1	-0.94804	-0.37949
31	230690007	Stroke	16	44054006	Diabetes	1095	62	68	10	52	58	975	2.59725	0.10069	3.23276	6.68660	1.56294	0.0034949607	0.0683268708	3.85023	1.18138	32	29	4	30	39	6	0.09531	0.40547
30	399211009	History of myocardial infarction (situation)	16	44054006	Diabetes	1095	31	68	1	30	67	997	0.51945	-0.02111	0.49602	3.69331	0.06662	0.7164652479	1.0000000000	1.92511	-0.54849	2	29	0	29	39	1	-3.68888	-3.40120
29	22298006	Myocardial Infarction	16	44054006	Diabetes	1095	31	68	1	30	67	997	0.51945	-0.02111	0.49602	3.69331	0.06662	0.7164652479	1.0000000000	1.92511	-0.54849	2	29	0	29	39	1	-3.68888	-3.40120
28	53741008	Coronary Heart Disease	16	44054006	Diabetes	1095	80	68	13	67	55	960	2.61673	0.11679	3.38670	6.50821	1.76235	0.0007481483	0.0195453746	4.96804	1.23010	24	29	4	56	39	9	0.43624	-0.03125
27	408512008	Body mass index 40+ - severely obese (finding)	16	44054006	Diabetes	1095	97	68	5	92	63	935	0.83005	-0.01363	0.80659	2.05556	0.31650	0.8263649944	1.0000000000	6.02374	-0.22728	67	29	4	30	39	1	-1.57867	-0.55760
26	33737001	Fracture of rib	16	44054006	Diabetes	1095	54	68	1	53	67	974	0.29820	-0.04113	0.27429	2.01420	0.03735	0.2484886123	0.9133257124	3.35342	-1.12215	32	29	1	22	39	0	3.40120	3.49651
25	284551006	Laceration of foot	16	44054006	Diabetes	1095	118	68	7	111	61	916	0.95526	-0.00400	0.94698	2.12144	0.42272	1.0000000000	1.0000000000	7.32785	-0.05794	53	29	3	65	39	4	-0.00778	0.07893
24	162864005	Body mass index 30+ - obesity (finding)	16	44054006	Diabetes	1095	439	68	26	413	42	614	0.95370	-0.00975	0.92033	1.52458	0.55556	0.7991743728	1.0000000000	27.26210	-0.06591	226	29	11	213	39	15	0.01005	0.34887
23	36971009	Sinusitis (disorder)	16	44054006	Diabetes	1095	190	68	16	174	52	853	1.35604	0.04198	1.50840	2.70368	0.84155	0.1845600663	0.8181443419	11.79909	0.40949	84	29	5	106	39	11	0.40279	0.51492
22	70704007	Sprain of wrist	16	44054006	Diabetes	1095	195	68	18	177	50	850	1.48643	0.05826	1.72881	3.03433	0.98500	0.0699802742	0.5205820740	12.10959	0.53538	90	29	6	105	39	12	0.31667	0.49532
21	15777000	Prediabetes	16	44054006	Diabetes	1095	333	68	39	294	29	733	1.88593	0.15070	3.35292	5.52400	2.03513	0.0000020872	0.0001014992	20.67945	0.88367	159	29	14	174	39	25	0.18214	0.43981
20	80394007	Hyperglycemia (disorder)	16	44054006	Diabetes	1095	55	68	55	0	13	1027	16.10294	0.89371	0.00000	0.00000	0.00000	0.0000000000	0.0000000000	3.41553	3.66477	23	29	23	32	39	32	0.01881	0.00000
19	237602007	Metabolic syndrome X (disorder)	16	44054006	Diabetes	1095	64	68	64	0	4	1027	16.10294	0.96826	0.00000	0.00000	0.00000	0.0000000000	0.0000000000	3.97443	3.70784	28	29	28	36	39	36	-0.02312	0.00000
18	302870006	Hypertriglyceridemia (disorder)	16	44054006	Diabetes	1095	64	68	64	0	4	1027	16.10294	0.96826	0.00000	0.00000	0.00000	0.0000000000	0.0000000000	3.97443	3.70784	28	29	28	36	39	36	-0.02312	0.00000
17	368581000119106	Neuropathy due to type 2 diabetes mellitus (disorder)	16	44054006	Diabetes	1095	28	68	28	0	40	1027	16.10294	0.62955	0.00000	0.00000	0.00000	0.0000000000	0.0000000000	1.73881	3.40443	7	29	7	21	39	21	0.58779	0.00000
15	40055000	Chronic sinusitis (disorder)	16	44054006	Diabetes	1095	216	68	14	202	54	825	1.04371	0.00558	1.05886	1.94412	0.57670	0.8749822097	1.0000000000	13.41370	0.05752	104	29	6	112	39	8	-0.00712	0.20067
14	10509002	Acute bronchitis (disorder)	16	44054006	Diabetes	1095	863	68	62	801	6	226	1.15687	0.07785	2.91552	6.82730	1.24504	0.0085967128	0.1379560235	53.59269	0.20664	418	29	24	445	39	38	0.08602	0.37083
13	370247008	Facial laceration	16	44054006	Diabetes	1095	109	68	9	100	59	927	1.32960	0.02820	1.41407	2.93752	0.68071	0.3993344923	1.0000000000	6.76895	0.36421	55	29	4	54	39	5	-0.06454	0.22314
12	65966004	Fracture of forearm	16	44054006	Diabetes	1095	123	68	13	110	55	917	1.70194	0.06425	1.97041	3.72181	1.04318	0.0451179329	0.4084765375	7.63836	0.69660	55	29	4	68	39	9	0.43624	0.54466
11	38341003	Hypertension	16	44054006	Diabetes	1095	278	68	34	244	34	783	1.96942	0.14551	3.20902	5.27285	1.95298	0.0000086033	0.0003720177	17.26393	0.93836	131	29	13	147	39	21	0.12290	0.32542
10	62106007	Concussion with no loss of consciousness	16	44054006	Diabetes	1095	206	68	20	186	48	841	1.56339	0.06979	1.88396	3.24999	1.09210	0.0251974103	0.2905941929	12.79269	0.60649	96	29	8	110	39	12	0.08456	0.24583
9	44465007	Sprain of ankle	16	44054006	Diabetes	1095	362	68	29	333	39	694	1.29001	0.05244	1.54970	2.55000	0.94180	0.0851944705	0.5765898706	22.48037	0.35351	185	29	14	177	39	15	-0.15879	0.10480
8	233678006	Childhood asthma	16	44054006	Diabetes	1095	45	68	1	44	67	983	0.35784	-0.03421	0.33345	2.45771	0.04524	0.5199336121	1.0000000000	2.79452	-0.92392	25	29	0	20	39	1	-3.68888	-3.04452
7	75498004	Acute bacterial sinusitis (disorder)	16	44054006	Diabetes	1095	187	68	15	172	53	855	1.29168	0.03406	1.40687	2.55365	0.77508	0.2475152516	0.9133257124	11.61279	0.34318	89	29	6	98	39	9	0.08961	0.28651
6	39848009	Whiplash injury to neck	16	44054006	Diabetes	1095	182	68	13	169	55	858	1.15021	0.01726	1.20000	2.24535	0.64133	0.6130763669	1.0000000000	11.30228	0.18650	92	29	6	90	39	7	-0.11914	0.16441
5	284549007	Laceration of hand	16	44054006	Diabetes	1095	104	68	8	96	60	931	1.23869	0.01990	1.29306	2.78444	0.60048	0.5195599048	1.0000000000	6.45845	0.27105	54	29	3	50	39	5	0.19237	0.54654
4	195662009	Acute viral pharyngitis (disorder)	16	44054006	Diabetes	1095	890	68	65	825	3	202	1.17606	0.09439	5.30505	17.05166	1.65049	0.0006455785	0.0174903943	55.26941	0.23012	430	29	27	460	39	38	0.02330	0.25583
3	65363002	Otitis media	16	44054006	Diabetes	1095	580	68	31	549	37	478	0.86067	-0.03805	0.72948	1.19399	0.44569	0.2125714733	0.8671354646	36.01826	-0.21017	277	29	13	303	39	18	0.02004	0.22386
1	444814009	Viral sinusitis (disorder)	16	44054006	Diabetes	1095	993	68	67	926	1	101	1.08650	0.06945	7.30778	53.20384	1.00375	0.0161281445	0.2164722508	61.66575	0.11786	478	29	29	515	39	38	-0.01307	0.18344
118	48333001	Burn injury(morphologic abnormality)	73	196416002	Impacted molars	1095	1	49	0	1	49	1045	0.00000	-0.00654	0.00000	0.00000	0.00000	1.0000000000	1.0000000000	0.04475	-0.06316	0	25	0	1	24	0	0.00000	0.00000
120	162573006	Suspected lung cancer (situation)	73	196416002	Impacted molars	1095	8	49	0	8	49	1038	0.00000	-0.01857	0.00000	0.00000	0.00000	1.0000000000	1.0000000000	0.35799	-0.44147	0	25	0	8	24	0	0.00000	0.00000
130	314994000	Metastasis from malignant tumor of prostate (disorder)	73	196416002	Impacted molars	1095	1	49	1	0	48	1046	22.34694	0.13969	0.00000	0.00000	0.00000	0.0447488584	0.4078976941	0.04475	0.93684	0	25	0	1	24	1	-3.21888	-0.69315
118	48333001	Burn injury(morphologic abnormality)	82	94260004	Secondary malignant neoplasm of colon	1095	1	4	0	1	4	1090	0.00000	-0.00183	0.00000	0.00000	0.00000	1.0000000000	1.0000000000	0.00365	-0.00526	0	2	0	1	2	0	0.00000	0.00000
130	314994000	Metastasis from malignant tumor of prostate (disorder)	129	47505003	Posttraumatic stress disorder	1095	1	4	1	0	3	1091	273.75000	0.49931	0.00000	0.00000	0.00000	0.0036529680	0.0707538718	0.00365	0.99474	0	1	0	1	3	1	-1.38629	-0.69315
125	1734006	Fracture of the vertebral column with spinal cord injury	129	47505003	Posttraumatic stress disorder	1095	5	4	0	5	4	1086	0.00000	-0.00410	0.00000	0.00000	0.00000	1.0000000000	1.0000000000	0.01826	-0.02611	3	1	0	2	3	0	0.00000	0.00000
118	48333001	Burn injury(morphologic abnormality)	129	47505003	Posttraumatic stress disorder	1095	1	4	0	1	4	1090	0.00000	-0.00183	0.00000	0.00000	0.00000	1.0000000000	1.0000000000	0.00365	-0.00526	0	1	0	1	3	0	0.00000	0.00000
117	230265002	Familial Alzheimer's disease of early onset (disorder)	129	47505003	Posttraumatic stress disorder	1095	6	4	0	6	4	1085	0.00000	-0.00449	0.00000	0.00000	0.00000	1.0000000000	1.0000000000	0.02192	-0.03128	2	1	0	4	3	0	0.00000	0.00000
109	90560007	Gout	129	47505003	Posttraumatic stress disorder	1095	4	4	0	4	4	1087	0.00000	-0.00367	0.00000	0.00000	0.00000	1.0000000000	1.0000000000	0.01461	-0.02093	0	1	0	4	3	0	0.00000	0.00000
130	314994000	Metastasis from malignant tumor of prostate (disorder)	82	94260004	Secondary malignant neoplasm of colon	1095	1	4	0	1	4	1090	0.00000	-0.00183	0.00000	0.00000	0.00000	1.0000000000	1.0000000000	0.00365	-0.00526	0	2	0	1	2	0	0.00000	0.00000
102	90781000119102	Microalbuminuria due to type 2 diabetes mellitus (disorder)	129	47505003	Posttraumatic stress disorder	1095	6	4	0	6	4	1085	0.00000	-0.00449	0.00000	0.00000	0.00000	1.0000000000	1.0000000000	0.02192	-0.03128	3	1	0	3	3	0	0.00000	0.00000
98	1551000119108	Nonproliferative diabetic retinopathy due to type 2 diabetes mellitus (disorder)	129	47505003	Posttraumatic stress disorder	1095	12	4	0	12	4	1079	0.00000	-0.00637	0.00000	0.00000	0.00000	1.0000000000	1.0000000000	0.04384	-0.06189	7	1	0	5	3	0	0.00000	0.00000
97	403192003	Third degree burn	129	47505003	Posttraumatic stress disorder	1095	8	4	0	8	4	1083	0.00000	-0.00519	0.00000	0.00000	0.00000	1.0000000000	1.0000000000	0.02922	-0.04156	3	1	0	5	3	0	0.00000	0.00000
96	283371005	Laceration of forearm	129	47505003	Posttraumatic stress disorder	1095	75	4	1	74	3	1017	3.65000	0.04351	4.58108	44.58419	0.47071	0.2473919744	0.9133257124	0.27397	0.65067	39	1	0	36	3	1	-1.38629	-3.61092
94	703151001	History of single seizure (situation)	129	47505003	Posttraumatic stress disorder	1095	39	4	0	39	4	1052	0.00000	-0.01164	0.00000	0.00000	0.00000	1.0000000000	1.0000000000	0.14247	-0.19215	14	1	0	25	3	0	0.00000	0.00000
93	128613002	Seizure disorder	129	47505003	Posttraumatic stress disorder	1095	39	4	0	39	4	1052	0.00000	-0.01164	0.00000	0.00000	0.00000	1.0000000000	1.0000000000	0.14247	-0.19215	14	1	0	25	3	0	0.00000	0.00000
89	47693006	Rupture of appendix	129	47505003	Posttraumatic stress disorder	1095	20	4	0	20	4	1071	0.00000	-0.00826	0.00000	0.00000	0.00000	1.0000000000	1.0000000000	0.07306	-0.10173	10	1	0	10	3	0	0.00000	0.00000
86	713197008	Recurrent rectal polyp	129	47505003	Posttraumatic stress disorder	1095	22	4	0	22	4	1069	0.00000	-0.00867	0.00000	0.00000	0.00000	1.0000000000	1.0000000000	0.08037	-0.11152	12	1	0	10	3	0	0.00000	0.00000
75	431855005	Chronic kidney disease stage 1 (disorder)	129	47505003	Posttraumatic stress disorder	1095	28	4	2	26	2	1065	19.55357	0.18199	40.96154	302.12436	5.55350	0.0036674654	0.0707538718	0.10228	1.44447	10	1	0	18	3	2	-0.91629	-2.30259
72	35999006	Blighted ovum	129	47505003	Posttraumatic stress disorder	1095	53	4	0	53	4	1038	0.00000	-0.01366	0.00000	0.00000	0.00000	1.0000000000	1.0000000000	0.19361	-0.25533	53	1	0	0	3	0	0.00000	0.00000
69	233604007	Pneumonia	129	47505003	Posttraumatic stress disorder	1095	7	4	0	7	4	1084	0.00000	-0.00486	0.00000	0.00000	0.00000	1.0000000000	1.0000000000	0.02557	-0.03643	3	1	0	4	3	0	0.00000	0.00000
67	403191005	Second degree burn	129	47505003	Posttraumatic stress disorder	1095	49	4	0	49	4	1042	0.00000	-0.01311	0.00000	0.00000	0.00000	1.0000000000	1.0000000000	0.17900	-0.23756	23	1	0	26	3	0	0.00000	0.00000
64	444448004	Injury of medial collateral ligament of knee	129	47505003	Posttraumatic stress disorder	1095	32	4	0	32	4	1059	0.00000	-0.01051	0.00000	0.00000	0.00000	1.0000000000	1.0000000000	0.11689	-0.15949	17	1	0	15	3	0	0.00000	0.00000
63	68496003	Polyp of colon	129	47505003	Posttraumatic stress disorder	1095	91	4	1	90	3	1001	3.00824	0.03661	3.70741	36.00873	0.38171	0.2935812737	0.9796285312	0.33242	0.58595	43	1	0	48	3	1	-1.38629	-3.89182
58	239720000	Tear of meniscus of knee	129	47505003	Posttraumatic stress disorder	1095	20	4	0	20	4	1071	0.00000	-0.00826	0.00000	0.00000	0.00000	1.0000000000	1.0000000000	0.07306	-0.10173	10	1	0	10	3	0	0.00000	0.00000
50	446096008	Perennial allergic rhinitis	129	47505003	Posttraumatic stress disorder	1095	26	4	0	26	4	1065	0.00000	-0.00944	0.00000	0.00000	0.00000	1.0000000000	1.0000000000	0.09498	-0.13090	14	1	0	12	3	0	0.00000	0.00000
49	88805009	Chronic congestive heart failure (disorder)	129	47505003	Posttraumatic stress disorder	1095	10	4	0	10	4	1081	0.00000	-0.00581	0.00000	0.00000	0.00000	1.0000000000	1.0000000000	0.03653	-0.05176	5	1	0	5	3	0	0.00000	0.00000
47	359817006	Closed fracture of hip	129	47505003	Posttraumatic stress disorder	1095	29	4	1	28	3	1063	9.43966	0.08429	12.65476	125.47489	1.27630	0.1019356362	0.6291042150	0.10594	0.85473	11	1	0	18	3	1	-1.38629	-2.94444
44	58150001	Fracture of clavicle	129	47505003	Posttraumatic stress disorder	1095	112	4	0	112	4	979	0.00000	-0.02044	0.00000	0.00000	0.00000	1.0000000000	1.0000000000	0.40913	-0.49481	55	1	0	57	3	0	0.00000	0.00000
43	307731004	Injury of tendon of the rotator cuff of shoulder	129	47505003	Posttraumatic stress disorder	1095	51	4	0	51	4	1040	0.00000	-0.01338	0.00000	0.00000	0.00000	1.0000000000	1.0000000000	0.18630	-0.24647	26	1	0	25	3	0	0.00000	0.00000
42	16114001	Fracture of ankle	129	47505003	Posttraumatic stress disorder	1095	108	4	1	107	3	984	2.53472	0.03074	3.06542	29.72939	0.31608	0.3402929047	1.0000000000	0.39452	0.52023	48	1	1	60	3	0	0.69315	3.89182
41	283385000	Laceration of thigh	129	47505003	Posttraumatic stress disorder	1095	105	4	2	103	2	988	5.21429	0.08310	9.59223	68.81339	1.33711	0.0480628260	0.4214740129	0.38356	1.11658	50	1	1	55	3	1	-0.69315	-0.09353
39	74400008	Appendicitis	129	47505003	Posttraumatic stress disorder	1095	51	4	0	51	4	1040	0.00000	-0.01338	0.00000	0.00000	0.00000	1.0000000000	1.0000000000	0.18630	-0.24647	27	1	0	24	3	0	0.00000	0.00000
38	398254007	Preeclampsia	129	47505003	Posttraumatic stress disorder	1095	101	4	1	100	3	991	2.71040	0.03301	3.30333	32.05427	0.34042	0.3213486489	1.0000000000	0.36895	0.54693	101	1	1	0	3	0	0.69315	4.62497
35	19169002	Miscarriage in first trimester	129	47505003	Posttraumatic stress disorder	1095	174	4	1	173	3	918	1.57328	0.01509	1.76879	17.10363	0.18292	0.5000444330	1.0000000000	0.63562	0.29017	174	1	1	0	3	0	0.69315	5.16479
33	429007001	History of cardiac arrest (situation)	129	47505003	Posttraumatic stress disorder	1095	42	4	0	42	4	1049	0.00000	-0.01209	0.00000	0.00000	0.00000	1.0000000000	1.0000000000	0.15342	-0.20592	24	1	0	18	3	0	0.00000	0.00000
32	410429000	Cardiac Arrest	129	47505003	Posttraumatic stress disorder	1095	42	4	0	42	4	1049	0.00000	-0.01209	0.00000	0.00000	0.00000	1.0000000000	1.0000000000	0.15342	-0.20592	24	1	0	18	3	0	0.00000	0.00000
27	408512008	Body mass index 40+ - severely obese (finding)	129	47505003	Posttraumatic stress disorder	1095	97	4	0	97	4	994	0.00000	-0.01888	0.00000	0.00000	0.00000	1.0000000000	1.0000000000	0.35434	-0.43759	67	1	0	30	3	0	0.00000	0.00000
24	162864005	Body mass index 30+ - obesity (finding)	129	47505003	Posttraumatic stress disorder	1095	439	4	1	438	3	653	0.62358	-0.01865	0.49696	4.79299	0.05153	0.6532944618	1.0000000000	1.60365	-0.38054	226	1	1	213	3	0	0.69315	5.42495
21	15777000	Prediabetes	129	47505003	Posttraumatic stress disorder	1095	333	4	3	330	1	761	2.46622	0.05869	6.91818	66.75380	0.71698	0.0864561147	0.5823623432	1.21644	0.85176	159	1	1	174	3	2	-0.22314	0.59784
20	80394007	Hyperglycemia (disorder)	129	47505003	Posttraumatic stress disorder	1095	55	4	2	53	2	1038	9.95455	0.12469	19.58491	141.74993	2.70595	0.0139310661	0.1938682647	0.20091	1.32083	23	1	0	32	3	2	-0.91629	-2.83321
132	69896004	Rheumatoid arthritis	103	157141000119108	Proteinuria due to type 2 diabetes mellitus (disorder)	1095	3	3	0	3	3	1089	0.00000	-0.00275	0.00000	0.00000	0.00000	1.0000000000	1.0000000000	0.00822	-0.01181	2	1	0	1	2	0	0.00000	0.00000
18	302870006	Hypertriglyceridemia (disorder)	129	47505003	Posttraumatic stress disorder	1095	64	4	2	62	2	1029	8.55469	0.11397	16.59677	119.80462	2.29918	0.0186994393	0.2375451204	0.23379	1.28187	28	1	0	36	3	2	-0.91629	-2.94444
17	368581000119106	Neuropathy due to type 2 diabetes mellitus (disorder)	129	47505003	Posttraumatic stress disorder	1095	28	4	1	27	3	1064	9.77679	0.08609	13.13580	130.38871	1.32335	0.0985562783	0.6237397336	0.10228	0.85951	7	1	0	21	3	1	-1.38629	-3.09104
129	47505003	Posttraumatic stress disorder	103	157141000119108	Proteinuria due to type 2 diabetes mellitus (disorder)	1095	4	3	0	4	3	1088	0.00000	-0.00317	0.00000	0.00000	0.00000	1.0000000000	1.0000000000	0.01096	-0.01572	1	1	0	3	2	0	0.00000	0.00000
15	40055000	Chronic sinusitis (disorder)	129	47505003	Posttraumatic stress disorder	1095	216	4	1	215	3	876	1.26736	0.00803	1.35814	13.12083	0.14058	0.5853202300	1.0000000000	0.78904	0.16081	104	1	1	112	3	0	0.69315	4.65396
14	10509002	Acute bronchitis (disorder)	129	47505003	Posttraumatic stress disorder	1095	863	4	4	859	0	232	1.26883	0.03139	0.00000	0.00000	0.00000	0.5842857155	1.0000000000	3.15251	0.26794	418	1	1	445	3	3	0.00000	1.03169
13	370247008	Facial laceration	129	47505003	Posttraumatic stress disorder	1095	109	4	0	109	4	982	0.00000	-0.02013	0.00000	0.00000	0.00000	1.0000000000	1.0000000000	0.39817	-0.48354	55	1	0	54	3	0	0.00000	0.00000
125	1734006	Fracture of the vertebral column with spinal cord injury	103	157141000119108	Proteinuria due to type 2 diabetes mellitus (disorder)	1095	5	3	0	5	3	1087	0.00000	-0.00355	0.00000	0.00000	0.00000	1.0000000000	1.0000000000	0.01370	-0.01963	3	1	0	2	2	0	0.00000	0.00000
124	1501000119109	Proliferative diabetic retinopathy due to type II diabetes mellitus (disorder)	103	157141000119108	Proteinuria due to type 2 diabetes mellitus (disorder)	1095	1	3	0	1	3	1091	0.00000	-0.00158	0.00000	0.00000	0.00000	1.0000000000	1.0000000000	0.00274	-0.00395	1	1	0	0	2	0	0.00000	0.00000
10	62106007	Concussion with no loss of consciousness	129	47505003	Posttraumatic stress disorder	1095	206	4	0	206	4	885	0.00000	-0.02915	0.00000	0.00000	0.00000	1.0000000000	1.0000000000	0.75251	-0.80942	96	1	0	110	3	0	0.00000	0.00000
121	254637007	Non-small cell lung cancer (disorder)	103	157141000119108	Proteinuria due to type 2 diabetes mellitus (disorder)	1095	8	3	0	8	3	1084	0.00000	-0.00450	0.00000	0.00000	0.00000	1.0000000000	1.0000000000	0.02192	-0.03128	0	1	0	8	2	0	0.00000	0.00000
7	75498004	Acute bacterial sinusitis (disorder)	129	47505003	Posttraumatic stress disorder	1095	187	4	0	187	4	904	0.00000	-0.02748	0.00000	0.00000	0.00000	1.0000000000	1.0000000000	0.68311	-0.75113	89	1	0	98	3	0	0.00000	0.00000
6	39848009	Whiplash injury to neck	129	47505003	Posttraumatic stress disorder	1095	182	4	1	181	3	910	1.50412	0.01363	1.67587	16.20183	0.17335	0.5172179176	1.0000000000	0.66484	0.26462	92	1	1	90	3	0	0.69315	4.53260
118	48333001	Burn injury(morphologic abnormality)	103	157141000119108	Proteinuria due to type 2 diabetes mellitus (disorder)	1095	1	3	0	1	3	1091	0.00000	-0.00158	0.00000	0.00000	0.00000	1.0000000000	1.0000000000	0.00274	-0.00395	0	1	0	1	2	0	0.00000	0.00000
117	230265002	Familial Alzheimer's disease of early onset (disorder)	103	157141000119108	Proteinuria due to type 2 diabetes mellitus (disorder)	1095	6	3	0	6	3	1086	0.00000	-0.00389	0.00000	0.00000	0.00000	1.0000000000	1.0000000000	0.01644	-0.02352	2	1	0	4	2	0	0.00000	0.00000
116	370143000	Major depression disorder	103	157141000119108	Proteinuria due to type 2 diabetes mellitus (disorder)	1095	8	3	0	8	3	1084	0.00000	-0.00450	0.00000	0.00000	0.00000	1.0000000000	1.0000000000	0.02192	-0.03128	3	1	0	5	2	0	0.00000	0.00000
115	36923009	Major depression  single episode	103	157141000119108	Proteinuria due to type 2 diabetes mellitus (disorder)	1095	6	3	0	6	3	1086	0.00000	-0.00389	0.00000	0.00000	0.00000	1.0000000000	1.0000000000	0.01644	-0.02352	3	1	0	3	2	0	0.00000	0.00000
114	449868002	Smokes tobacco daily	103	157141000119108	Proteinuria due to type 2 diabetes mellitus (disorder)	1095	9	3	1	8	2	1084	40.55556	0.18874	67.75000	824.69220	5.56579	0.0244776081	0.2884086500	0.02466	0.96486	2	1	0	7	2	1	-1.09861	-2.07944
113	443165006	Pathological fracture due to osteoporosis (disorder)	103	157141000119108	Proteinuria due to type 2 diabetes mellitus (disorder)	1095	10	3	0	10	3	1082	0.00000	-0.00503	0.00000	0.00000	0.00000	1.0000000000	1.0000000000	0.02740	-0.03899	7	1	0	3	2	0	0.00000	0.00000
112	49436004	Atrial Fibrillation	103	157141000119108	Proteinuria due to type 2 diabetes mellitus (disorder)	1095	35	3	0	35	3	1057	0.00000	-0.00952	0.00000	0.00000	0.00000	1.0000000000	1.0000000000	0.09589	-0.13210	9	1	0	26	2	0	0.00000	0.00000
111	235919008	Cholelithiasis	103	157141000119108	Proteinuria due to type 2 diabetes mellitus (disorder)	1095	9	3	0	9	3	1083	0.00000	-0.00477	0.00000	0.00000	0.00000	1.0000000000	1.0000000000	0.02466	-0.03514	7	1	0	2	2	0	0.00000	0.00000
110	65275009	Acute Cholecystitis	103	157141000119108	Proteinuria due to type 2 diabetes mellitus (disorder)	1095	9	3	0	9	3	1083	0.00000	-0.00477	0.00000	0.00000	0.00000	1.0000000000	1.0000000000	0.02466	-0.03514	7	1	0	2	2	0	0.00000	0.00000
109	90560007	Gout	103	157141000119108	Proteinuria due to type 2 diabetes mellitus (disorder)	1095	4	3	0	4	3	1088	0.00000	-0.00317	0.00000	0.00000	0.00000	1.0000000000	1.0000000000	0.01096	-0.01572	0	1	0	4	2	0	0.00000	0.00000
108	40930008	Hypothyroidism (disorder)	103	157141000119108	Proteinuria due to type 2 diabetes mellitus (disorder)	1095	13	3	0	13	3	1079	0.00000	-0.00575	0.00000	0.00000	0.00000	1.0000000000	1.0000000000	0.03562	-0.05049	11	1	0	2	2	0	0.00000	0.00000
107	40275004	Contact dermatitis	103	157141000119108	Proteinuria due to type 2 diabetes mellitus (disorder)	1095	18	3	0	18	3	1074	0.00000	-0.00678	0.00000	0.00000	0.00000	1.0000000000	1.0000000000	0.04932	-0.06945	9	1	0	9	2	0	0.00000	0.00000
106	24079001	Atopic dermatitis	103	157141000119108	Proteinuria due to type 2 diabetes mellitus (disorder)	1095	20	3	0	20	3	1072	0.00000	-0.00715	0.00000	0.00000	0.00000	1.0000000000	1.0000000000	0.05479	-0.07696	13	1	0	7	2	0	0.00000	0.00000
105	363406005	Malignant tumor of colon	103	157141000119108	Proteinuria due to type 2 diabetes mellitus (disorder)	1095	6	3	0	6	3	1086	0.00000	-0.00389	0.00000	0.00000	0.00000	1.0000000000	1.0000000000	0.01644	-0.02352	4	1	0	2	2	0	0.00000	0.00000
104	367498001	Seasonal allergic rhinitis	103	157141000119108	Proteinuria due to type 2 diabetes mellitus (disorder)	1095	20	3	0	20	3	1072	0.00000	-0.00715	0.00000	0.00000	0.00000	1.0000000000	1.0000000000	0.05479	-0.07696	9	1	0	11	2	0	0.00000	0.00000
102	90781000119102	Microalbuminuria due to type 2 diabetes mellitus (disorder)	103	157141000119108	Proteinuria due to type 2 diabetes mellitus (disorder)	1095	6	3	3	3	0	1089	182.50000	0.70613	0.00000	0.00000	0.00000	0.0000000916	0.0000053993	0.01644	1.97648	3	1	1	3	2	2	0.00000	0.47000
101	433144002	Chronic kidney disease stage 3 (disorder)	103	157141000119108	Proteinuria due to type 2 diabetes mellitus (disorder)	1095	3	3	3	0	0	1092	365.00000	1.00000	0.00000	0.00000	0.00000	0.0000000046	0.0000003248	0.00822	1.98819	1	1	1	2	2	2	0.00000	0.00000
100	161622006	History of lower limb amputation (situation)	103	157141000119108	Proteinuria due to type 2 diabetes mellitus (disorder)	1095	1	3	0	1	3	1091	0.00000	-0.00158	0.00000	0.00000	0.00000	1.0000000000	1.0000000000	0.00274	-0.00395	0	1	0	1	2	0	0.00000	0.00000
99	30832001	Rupture of patellar tendon	103	157141000119108	Proteinuria due to type 2 diabetes mellitus (disorder)	1095	23	3	0	23	3	1069	0.00000	-0.00768	0.00000	0.00000	0.00000	1.0000000000	1.0000000000	0.06301	-0.08816	14	1	0	9	2	0	0.00000	0.00000
98	1551000119108	Nonproliferative diabetic retinopathy due to type 2 diabetes mellitus (disorder)	103	157141000119108	Proteinuria due to type 2 diabetes mellitus (disorder)	1095	12	3	1	11	2	1081	30.41667	0.16230	49.13636	582.56919	4.14437	0.0325471502	0.3325947436	0.03288	0.95333	7	1	0	5	2	1	-1.09861	-1.79176
97	403192003	Third degree burn	103	157141000119108	Proteinuria due to type 2 diabetes mellitus (disorder)	1095	8	3	0	8	3	1084	0.00000	-0.00450	0.00000	0.00000	0.00000	1.0000000000	1.0000000000	0.02192	-0.03128	3	1	0	5	2	0	0.00000	0.00000
96	283371005	Laceration of forearm	103	157141000119108	Proteinuria due to type 2 diabetes mellitus (disorder)	1095	75	3	1	74	2	1018	4.86667	0.05496	6.87838	76.73920	0.61653	0.1918899076	0.8268943621	0.20548	0.73039	39	1	1	36	2	0	0.69315	3.68888
95	84757009	Epilepsy	103	157141000119108	Proteinuria due to type 2 diabetes mellitus (disorder)	1095	30	3	0	30	3	1062	0.00000	-0.00880	0.00000	0.00000	0.00000	1.0000000000	1.0000000000	0.08219	-0.11396	13	1	0	17	2	0	0.00000	0.00000
94	703151001	History of single seizure (situation)	103	157141000119108	Proteinuria due to type 2 diabetes mellitus (disorder)	1095	39	3	1	38	2	1054	9.35897	0.08420	13.86842	156.30210	1.23052	0.1031797921	0.6315984763	0.10685	0.85354	14	1	0	25	2	1	-1.09861	-3.25810
93	128613002	Seizure disorder	103	157141000119108	Proteinuria due to type 2 diabetes mellitus (disorder)	1095	39	3	1	38	2	1054	9.35897	0.08420	13.86842	156.30210	1.23052	0.1031797921	0.6315984763	0.10685	0.85354	14	1	0	25	2	1	-1.09861	-3.25810
92	82423001	Chronic pain	103	157141000119108	Proteinuria due to type 2 diabetes mellitus (disorder)	1095	52	3	0	52	3	1040	0.00000	-0.01170	0.00000	0.00000	0.00000	1.0000000000	1.0000000000	0.14247	-0.19215	24	1	0	28	2	0	0.00000	0.00000
91	64859006	Osteoporosis (disorder)	103	157141000119108	Proteinuria due to type 2 diabetes mellitus (disorder)	1095	37	3	0	37	3	1055	0.00000	-0.00980	0.00000	0.00000	0.00000	1.0000000000	1.0000000000	0.10137	-0.13930	24	1	0	13	2	0	0.00000	0.00000
89	47693006	Rupture of appendix	103	157141000119108	Proteinuria due to type 2 diabetes mellitus (disorder)	1095	20	3	0	20	3	1072	0.00000	-0.00715	0.00000	0.00000	0.00000	1.0000000000	1.0000000000	0.05479	-0.07696	10	1	0	10	2	0	0.00000	0.00000
88	197927001	Recurrent urinary tract infection	103	157141000119108	Proteinuria due to type 2 diabetes mellitus (disorder)	1095	8	3	0	8	3	1084	0.00000	-0.00450	0.00000	0.00000	0.00000	1.0000000000	1.0000000000	0.02192	-0.03128	8	1	0	0	2	0	0.00000	0.00000
86	713197008	Recurrent rectal polyp	103	157141000119108	Proteinuria due to type 2 diabetes mellitus (disorder)	1095	22	3	0	22	3	1070	0.00000	-0.00751	0.00000	0.00000	0.00000	1.0000000000	1.0000000000	0.06027	-0.08444	12	1	0	10	2	0	0.00000	0.00000
85	241929008	Acute allergic reaction	103	157141000119108	Proteinuria due to type 2 diabetes mellitus (disorder)	1095	47	3	1	46	2	1046	7.76596	0.07510	11.36957	127.67529	1.01247	0.1234270883	0.6913144812	0.12877	0.82525	25	1	1	22	2	0	0.69315	3.25810
83	110030002	Concussion injury of brain	103	157141000119108	Proteinuria due to type 2 diabetes mellitus (disorder)	1095	7	3	0	7	3	1085	0.00000	-0.00420	0.00000	0.00000	0.00000	1.0000000000	1.0000000000	0.01918	-0.02741	1	1	0	6	2	0	0.00000	0.00000
82	94260004	Secondary malignant neoplasm of colon	103	157141000119108	Proteinuria due to type 2 diabetes mellitus (disorder)	1095	4	3	0	4	3	1088	0.00000	-0.00317	0.00000	0.00000	0.00000	1.0000000000	1.0000000000	0.01096	-0.01572	2	1	0	2	2	0	0.00000	0.00000
81	236077008	Protracted diarrhea	103	157141000119108	Proteinuria due to type 2 diabetes mellitus (disorder)	1095	4	3	0	4	3	1088	0.00000	-0.00317	0.00000	0.00000	0.00000	1.0000000000	1.0000000000	0.01096	-0.01572	2	1	0	2	2	0	0.00000	0.00000
80	6072007	Bleeding from anus	103	157141000119108	Proteinuria due to type 2 diabetes mellitus (disorder)	1095	4	3	0	4	3	1088	0.00000	-0.00317	0.00000	0.00000	0.00000	1.0000000000	1.0000000000	0.01096	-0.01572	2	1	0	2	2	0	0.00000	0.00000
79	45816000	Pyelonephritis	103	157141000119108	Proteinuria due to type 2 diabetes mellitus (disorder)	1095	1	3	0	1	3	1091	0.00000	-0.00158	0.00000	0.00000	0.00000	1.0000000000	1.0000000000	0.00274	-0.00395	1	1	0	0	2	0	0.00000	0.00000
78	239872002	Osteoarthritis of hip	103	157141000119108	Proteinuria due to type 2 diabetes mellitus (disorder)	1095	21	3	0	21	3	1071	0.00000	-0.00733	0.00000	0.00000	0.00000	1.0000000000	1.0000000000	0.05753	-0.08070	13	1	0	8	2	0	0.00000	0.00000
77	422034002	Diabetic retinopathy associated with type II diabetes mellitus (disorder)	103	157141000119108	Proteinuria due to type 2 diabetes mellitus (disorder)	1095	20	3	1	19	2	1073	18.25000	0.12332	28.23684	324.91689	2.45392	0.0538481030	0.4488876049	0.05479	0.92304	8	1	0	12	2	1	-1.09861	-2.56495
76	127013003	Diabetic renal disease (disorder)	103	157141000119108	Proteinuria due to type 2 diabetes mellitus (disorder)	1095	28	3	3	25	0	1067	39.10714	0.32356	0.00000	0.00000	0.00000	0.0000150122	0.0006072666	0.07671	1.89337	10	1	1	18	2	2	0.00000	0.09531
75	431855005	Chronic kidney disease stage 1 (disorder)	103	157141000119108	Proteinuria due to type 2 diabetes mellitus (disorder)	1095	28	3	3	25	0	1067	39.10714	0.32356	0.00000	0.00000	0.00000	0.0000150122	0.0006072666	0.07671	1.89337	10	1	1	18	2	2	0.00000	0.09531
73	196416002	Impacted molars	103	157141000119108	Proteinuria due to type 2 diabetes mellitus (disorder)	1095	49	3	0	49	3	1043	0.00000	-0.01134	0.00000	0.00000	0.00000	1.0000000000	1.0000000000	0.13425	-0.18173	25	1	0	24	2	0	0.00000	0.00000
72	35999006	Blighted ovum	103	157141000119108	Proteinuria due to type 2 diabetes mellitus (disorder)	1095	53	3	0	53	3	1039	0.00000	-0.01182	0.00000	0.00000	0.00000	1.0000000000	1.0000000000	0.14521	-0.19561	53	1	0	0	2	0	0.00000	0.00000
71	201834006	Localized  primary osteoarthritis of the hand	103	157141000119108	Proteinuria due to type 2 diabetes mellitus (disorder)	1095	28	3	0	28	3	1064	0.00000	-0.00849	0.00000	0.00000	0.00000	1.0000000000	1.0000000000	0.07671	-0.10663	19	1	0	9	2	0	0.00000	0.00000
70	87433001	Pulmonary emphysema (disorder)	103	157141000119108	Proteinuria due to type 2 diabetes mellitus (disorder)	1095	17	3	0	17	3	1075	0.00000	-0.00658	0.00000	0.00000	0.00000	1.0000000000	1.0000000000	0.04658	-0.06568	9	1	0	8	2	0	0.00000	0.00000
69	233604007	Pneumonia	103	157141000119108	Proteinuria due to type 2 diabetes mellitus (disorder)	1095	7	3	0	7	3	1085	0.00000	-0.00420	0.00000	0.00000	0.00000	1.0000000000	1.0000000000	0.01918	-0.02741	3	1	0	4	2	0	0.00000	0.00000
68	26929004	Alzheimer's disease (disorder)	103	157141000119108	Proteinuria due to type 2 diabetes mellitus (disorder)	1095	23	3	0	23	3	1069	0.00000	-0.00768	0.00000	0.00000	0.00000	1.0000000000	1.0000000000	0.06301	-0.08816	15	1	0	8	2	0	0.00000	0.00000
67	403191005	Second degree burn	103	157141000119108	Proteinuria due to type 2 diabetes mellitus (disorder)	1095	49	3	1	48	2	1044	7.44898	0.07316	10.87500	122.03388	0.96912	0.1284408422	0.7042184342	0.13425	0.81827	23	1	1	26	2	0	0.69315	3.17805
65	239873007	Osteoarthritis of knee	103	157141000119108	Proteinuria due to type 2 diabetes mellitus (disorder)	1095	57	3	0	57	3	1035	0.00000	-0.01228	0.00000	0.00000	0.00000	1.0000000000	1.0000000000	0.15616	-0.20935	30	1	0	27	2	0	0.00000	0.00000
64	444448004	Injury of medial collateral ligament of knee	103	157141000119108	Proteinuria due to type 2 diabetes mellitus (disorder)	1095	32	3	0	32	3	1060	0.00000	-0.00909	0.00000	0.00000	0.00000	1.0000000000	1.0000000000	0.08767	-0.12124	17	1	0	15	2	0	0.00000	0.00000
63	68496003	Polyp of colon	103	157141000119108	Proteinuria due to type 2 diabetes mellitus (disorder)	1095	91	3	1	90	2	1002	4.01099	0.04751	5.56667	61.98701	0.49991	0.2293613895	0.8880487574	0.24932	0.67886	43	1	0	48	2	1	-1.09861	-3.89182
62	185086009	Chronic obstructive bronchitis (disorder)	103	157141000119108	Proteinuria due to type 2 diabetes mellitus (disorder)	1095	6	3	0	6	3	1086	0.00000	-0.00389	0.00000	0.00000	0.00000	1.0000000000	1.0000000000	0.01644	-0.02352	4	1	0	2	2	0	0.00000	0.00000
60	301011002	Escherichia coli urinary tract infection	103	157141000119108	Proteinuria due to type 2 diabetes mellitus (disorder)	1095	92	3	0	92	3	1000	0.00000	-0.01587	0.00000	0.00000	0.00000	1.0000000000	1.0000000000	0.25205	-0.32430	85	1	0	7	2	0	0.00000	0.00000
59	262574004	Bullet wound	103	157141000119108	Proteinuria due to type 2 diabetes mellitus (disorder)	1095	20	3	0	20	3	1072	0.00000	-0.00715	0.00000	0.00000	0.00000	1.0000000000	1.0000000000	0.05479	-0.07696	9	1	0	11	2	0	0.00000	0.00000
58	239720000	Tear of meniscus of knee	103	157141000119108	Proteinuria due to type 2 diabetes mellitus (disorder)	1095	20	3	0	20	3	1072	0.00000	-0.00715	0.00000	0.00000	0.00000	1.0000000000	1.0000000000	0.05479	-0.07696	10	1	0	10	2	0	0.00000	0.00000
57	192127007	Child attention deficit disorder	103	157141000119108	Proteinuria due to type 2 diabetes mellitus (disorder)	1095	76	3	0	76	3	1016	0.00000	-0.01431	0.00000	0.00000	0.00000	1.0000000000	1.0000000000	0.20822	-0.27288	24	1	0	52	2	0	0.00000	0.00000
56	92691004	Carcinoma in situ of prostate (disorder)	103	157141000119108	Proteinuria due to type 2 diabetes mellitus (disorder)	1095	23	3	1	22	2	1070	15.86957	0.11416	24.31818	278.24967	2.12534	0.0617546283	0.4836892708	0.06301	0.91184	0	1	0	23	2	1	-1.09861	-3.17805
54	5602001	Opioid abuse (disorder)	103	157141000119108	Proteinuria due to type 2 diabetes mellitus (disorder)	1095	7	3	0	7	3	1085	0.00000	-0.00420	0.00000	0.00000	0.00000	1.0000000000	1.0000000000	0.01918	-0.02741	0	1	0	7	2	0	0.00000	0.00000
53	7200002	Alcoholism	103	157141000119108	Proteinuria due to type 2 diabetes mellitus (disorder)	1095	5	3	0	5	3	1087	0.00000	-0.00355	0.00000	0.00000	0.00000	1.0000000000	1.0000000000	0.01370	-0.01963	0	1	0	5	2	0	0.00000	0.00000
52	124171000119105	Chronic intractable migraine without aura	103	157141000119108	Proteinuria due to type 2 diabetes mellitus (disorder)	1095	51	3	0	51	3	1041	0.00000	-0.01158	0.00000	0.00000	0.00000	1.0000000000	1.0000000000	0.13973	-0.18869	21	1	0	30	2	0	0.00000	0.00000
50	446096008	Perennial allergic rhinitis	103	157141000119108	Proteinuria due to type 2 diabetes mellitus (disorder)	1095	26	3	1	25	2	1067	14.03846	0.10658	21.34000	243.12544	1.87309	0.0696169832	0.5191995567	0.07123	0.90073	14	1	1	12	2	0	0.69315	2.70805
49	88805009	Chronic congestive heart failure (disorder)	103	157141000119108	Proteinuria due to type 2 diabetes mellitus (disorder)	1095	10	3	0	10	3	1082	0.00000	-0.00503	0.00000	0.00000	0.00000	1.0000000000	1.0000000000	0.02740	-0.03899	5	1	0	5	2	0	0.00000	0.00000
47	359817006	Closed fracture of hip	103	157141000119108	Proteinuria due to type 2 diabetes mellitus (disorder)	1095	29	3	0	29	3	1063	0.00000	-0.00865	0.00000	0.00000	0.00000	1.0000000000	1.0000000000	0.07945	-0.11030	11	1	0	18	2	0	0.00000	0.00000
46	62564004	Concussion with loss of consciousness	103	157141000119108	Proteinuria due to type 2 diabetes mellitus (disorder)	1095	67	3	0	67	3	1025	0.00000	-0.01338	0.00000	0.00000	0.00000	1.0000000000	1.0000000000	0.18356	-0.24313	36	1	0	31	2	0	0.00000	0.00000
45	263102004	Fracture subluxation of wrist	103	157141000119108	Proteinuria due to type 2 diabetes mellitus (disorder)	1095	109	3	0	109	3	983	0.00000	-0.01743	0.00000	0.00000	0.00000	1.0000000000	1.0000000000	0.29863	-0.37699	51	1	0	58	2	0	0.00000	0.00000
44	58150001	Fracture of clavicle	103	157141000119108	Proteinuria due to type 2 diabetes mellitus (disorder)	1095	112	3	0	112	3	980	0.00000	-0.01769	0.00000	0.00000	0.00000	1.0000000000	1.0000000000	0.30685	-0.38609	55	1	0	57	2	0	0.00000	0.00000
43	307731004	Injury of tendon of the rotator cuff of shoulder	103	157141000119108	Proteinuria due to type 2 diabetes mellitus (disorder)	1095	51	3	0	51	3	1041	0.00000	-0.01158	0.00000	0.00000	0.00000	1.0000000000	1.0000000000	0.13973	-0.18869	26	1	0	25	2	0	0.00000	0.00000
42	16114001	Fracture of ankle	103	157141000119108	Proteinuria due to type 2 diabetes mellitus (disorder)	1095	108	3	1	107	2	985	3.37963	0.04126	4.60280	51.18264	0.41393	0.2678860284	0.9388450812	0.29589	0.62606	48	1	0	60	2	1	-1.09861	-4.11087
41	283385000	Laceration of thigh	103	157141000119108	Proteinuria due to type 2 diabetes mellitus (disorder)	1095	105	3	0	105	3	987	0.00000	-0.01707	0.00000	0.00000	0.00000	1.0000000000	1.0000000000	0.28767	-0.36476	50	1	0	55	2	0	0.00000	0.00000
40	428251008	History of appendectomy	103	157141000119108	Proteinuria due to type 2 diabetes mellitus (disorder)	1095	51	3	0	51	3	1041	0.00000	-0.01158	0.00000	0.00000	0.00000	1.0000000000	1.0000000000	0.13973	-0.18869	27	1	0	24	2	0	0.00000	0.00000
39	74400008	Appendicitis	103	157141000119108	Proteinuria due to type 2 diabetes mellitus (disorder)	1095	51	3	0	51	3	1041	0.00000	-0.01158	0.00000	0.00000	0.00000	1.0000000000	1.0000000000	0.13973	-0.18869	27	1	0	24	2	0	0.00000	0.00000
38	398254007	Preeclampsia	103	157141000119108	Proteinuria due to type 2 diabetes mellitus (disorder)	1095	101	3	1	100	2	992	3.61386	0.04367	4.96000	55.18309	0.44582	0.2521823659	0.9133257124	0.27671	0.64757	101	1	1	0	2	0	0.69315	4.62497
37	38822007	Cystitis	103	157141000119108	Proteinuria due to type 2 diabetes mellitus (disorder)	1095	71	3	1	70	2	1022	5.14085	0.05715	7.30000	81.49290	0.65392	0.1823359889	0.8153567551	0.19452	0.74357	68	1	1	3	2	0	0.69315	4.23411
35	19169002	Miscarriage in first trimester	103	157141000119108	Proteinuria due to type 2 diabetes mellitus (disorder)	1095	174	3	1	173	2	919	2.09770	0.02501	2.65607	29.45300	0.23952	0.4052816131	1.0000000000	0.47671	0.43761	174	1	1	0	2	0	0.69315	5.16479
33	429007001	History of cardiac arrest (situation)	103	157141000119108	Proteinuria due to type 2 diabetes mellitus (disorder)	1095	42	3	0	42	3	1050	0.00000	-0.01047	0.00000	0.00000	0.00000	1.0000000000	1.0000000000	0.11507	-0.15713	24	1	0	18	2	0	0.00000	0.00000
32	410429000	Cardiac Arrest	103	157141000119108	Proteinuria due to type 2 diabetes mellitus (disorder)	1095	42	3	0	42	3	1050	0.00000	-0.01047	0.00000	0.00000	0.00000	1.0000000000	1.0000000000	0.11507	-0.15713	24	1	0	18	2	0	0.00000	0.00000
31	230690007	Stroke	103	157141000119108	Proteinuria due to type 2 diabetes mellitus (disorder)	1095	62	3	0	62	3	1030	0.00000	-0.01284	0.00000	0.00000	0.00000	1.0000000000	1.0000000000	0.16986	-0.22634	32	1	0	30	2	0	0.00000	0.00000
30	399211009	History of myocardial infarction (situation)	103	157141000119108	Proteinuria due to type 2 diabetes mellitus (disorder)	1095	31	3	0	31	3	1061	0.00000	-0.00895	0.00000	0.00000	0.00000	1.0000000000	1.0000000000	0.08493	-0.11760	2	1	0	29	2	0	0.00000	0.00000
29	22298006	Myocardial Infarction	103	157141000119108	Proteinuria due to type 2 diabetes mellitus (disorder)	1095	31	3	0	31	3	1061	0.00000	-0.00895	0.00000	0.00000	0.00000	1.0000000000	1.0000000000	0.08493	-0.11760	2	1	0	29	2	0	0.00000	0.00000
28	53741008	Coronary Heart Disease	103	157141000119108	Proteinuria due to type 2 diabetes mellitus (disorder)	1095	80	3	0	80	3	1012	0.00000	-0.01472	0.00000	0.00000	0.00000	1.0000000000	1.0000000000	0.21918	-0.28591	24	1	0	56	2	0	0.00000	0.00000
27	408512008	Body mass index 40+ - severely obese (finding)	103	157141000119108	Proteinuria due to type 2 diabetes mellitus (disorder)	1095	97	3	0	97	3	995	0.00000	-0.01634	0.00000	0.00000	0.00000	1.0000000000	1.0000000000	0.26575	-0.34000	67	1	0	30	2	0	0.00000	0.00000
26	33737001	Fracture of rib	103	157141000119108	Proteinuria due to type 2 diabetes mellitus (disorder)	1095	54	3	0	54	3	1038	0.00000	-0.01194	0.00000	0.00000	0.00000	1.0000000000	1.0000000000	0.14795	-0.19905	32	1	0	22	2	0	0.00000	0.00000
24	162864005	Body mass index 30+ - obesity (finding)	103	157141000119108	Proteinuria due to type 2 diabetes mellitus (disorder)	1095	439	3	1	438	2	654	0.83144	-0.00723	0.74658	8.25854	0.06749	1.0000000000	1.0000000000	1.20274	-0.13930	226	1	0	213	2	1	-1.09861	-5.36598
23	36971009	Sinusitis (disorder)	103	157141000119108	Proteinuria due to type 2 diabetes mellitus (disorder)	1095	190	3	1	189	2	903	1.92105	0.02212	2.38889	26.48031	0.21551	0.4357739195	1.0000000000	0.52055	0.39541	84	1	0	106	2	1	-1.09861	-4.67283
22	70704007	Sprain of wrist	103	157141000119108	Proteinuria due to type 2 diabetes mellitus (disorder)	1095	195	3	2	193	1	899	3.74359	0.06694	9.31606	103.25787	0.84051	0.0835859286	0.5700988979	0.53425	0.96743	90	1	1	105	2	1	-0.40547	-0.15258
21	15777000	Prediabetes	103	157141000119108	Proteinuria due to type 2 diabetes mellitus (disorder)	1095	333	3	3	330	0	762	3.28829	0.07929	0.00000	0.00000	0.00000	0.0279485131	0.3078193827	0.91233	1.06467	159	1	1	174	2	2	0.00000	0.59784
20	80394007	Hyperglycemia (disorder)	103	157141000119108	Proteinuria due to type 2 diabetes mellitus (disorder)	1095	55	3	2	53	1	1039	13.27273	0.14793	39.20755	439.28273	3.49941	0.0071973880	0.1207683861	0.15068	1.38247	23	1	1	32	2	1	-0.40547	-0.31845
19	237602007	Metabolic syndrome X (disorder)	103	157141000119108	Proteinuria due to type 2 diabetes mellitus (disorder)	1095	64	3	3	61	0	1031	17.10937	0.21037	0.00000	0.00000	0.00000	0.0001909240	0.0061165372	0.17534	1.76692	28	1	1	36	2	2	0.00000	0.42286
18	302870006	Hypertriglyceridemia (disorder)	103	157141000119108	Proteinuria due to type 2 diabetes mellitus (disorder)	1095	64	3	3	61	0	1031	17.10937	0.21037	0.00000	0.00000	0.00000	0.0001909240	0.0061165372	0.17534	1.76692	28	1	1	36	2	2	0.00000	0.42286
17	368581000119106	Neuropathy due to type 2 diabetes mellitus (disorder)	103	157141000119108	Proteinuria due to type 2 diabetes mellitus (disorder)	1095	28	3	1	27	2	1065	13.03571	0.10219	19.72222	224.16927	1.73514	0.0748340751	0.5403135912	0.07671	0.89337	7	1	0	21	2	1	-1.09861	-3.09104
129	47505003	Posttraumatic stress disorder	77	422034002	Diabetic retinopathy associated with type II diabetes mellitus (disorder)	1095	4	20	0	4	20	1071	0.00000	-0.00826	0.00000	0.00000	0.00000	1.0000000000	1.0000000000	0.07306	-0.10173	1	8	0	3	12	0	0.00000	0.00000
15	40055000	Chronic sinusitis (disorder)	103	157141000119108	Proteinuria due to type 2 diabetes mellitus (disorder)	1095	216	3	1	215	2	877	1.68981	0.01792	2.03953	22.59684	0.18408	0.4830704237	1.0000000000	0.59178	0.32936	104	1	0	112	2	1	-1.09861	-4.72739
14	10509002	Acute bronchitis (disorder)	103	157141000119108	Proteinuria due to type 2 diabetes mellitus (disorder)	1095	863	3	2	861	1	231	0.84589	-0.01558	0.53659	5.94362	0.04844	0.5108189669	1.0000000000	2.36438	-0.16538	418	1	1	445	2	1	-0.40547	-0.06245
13	370247008	Facial laceration	103	157141000119108	Proteinuria due to type 2 diabetes mellitus (disorder)	1095	109	3	1	108	2	984	3.34862	0.04093	4.55556	50.65380	0.40970	0.2701112988	0.9405144708	0.29863	0.62301	55	1	0	54	2	1	-1.09861	-4.00733
12	65966004	Fracture of forearm	103	157141000119108	Proteinuria due to type 2 diabetes mellitus (disorder)	1095	123	3	1	122	2	970	2.96748	0.03668	3.97541	44.16616	0.35783	0.3007932279	0.9911272351	0.33699	0.58102	55	1	0	68	2	1	-1.09861	-4.23411
11	38341003	Hypertension	103	157141000119108	Proteinuria due to type 2 diabetes mellitus (disorder)	1095	278	3	0	278	3	814	0.00000	-0.03057	0.00000	0.00000	0.00000	0.5753543664	1.0000000000	0.76164	-0.81692	131	1	0	147	2	0	0.00000	0.00000
10	62106007	Concussion with no loss of consciousness	103	157141000119108	Proteinuria due to type 2 diabetes mellitus (disorder)	1095	206	3	1	205	2	887	1.77184	0.01947	2.16341	23.97345	0.19523	0.4652057324	1.0000000000	0.56438	0.35441	96	1	0	110	2	1	-1.09861	-4.70953
9	44465007	Sprain of ankle	103	157141000119108	Proteinuria due to type 2 diabetes mellitus (disorder)	1095	362	3	3	359	0	733	3.02486	0.07458	0.00000	0.00000	0.00000	0.0359307821	0.3569070239	0.99178	1.00594	185	1	1	177	2	2	0.00000	0.73151
8	233678006	Childhood asthma	103	157141000119108	Proteinuria due to type 2 diabetes mellitus (disorder)	1095	45	3	0	45	3	1047	0.00000	-0.01085	0.00000	0.00000	0.00000	1.0000000000	1.0000000000	0.12329	-0.16773	25	1	0	20	2	0	0.00000	0.00000
7	75498004	Acute bacterial sinusitis (disorder)	103	157141000119108	Proteinuria due to type 2 diabetes mellitus (disorder)	1095	187	3	2	185	1	907	3.90374	0.06907	9.80541	108.70027	0.88451	0.0772763621	0.5501475317	0.51233	0.98819	89	1	0	98	2	2	-0.69315	-3.91202
6	39848009	Whiplash injury to neck	103	157141000119108	Proteinuria due to type 2 diabetes mellitus (disorder)	1095	182	3	1	181	2	911	2.00549	0.02353	2.51657	27.90067	0.22699	0.4206615011	1.0000000000	0.49863	0.41636	92	1	1	90	2	0	0.69315	4.53260
5	284549007	Laceration of hand	103	157141000119108	Proteinuria due to type 2 diabetes mellitus (disorder)	1095	104	3	0	104	3	988	0.00000	-0.01698	0.00000	0.00000	0.00000	1.0000000000	1.0000000000	0.28493	-0.36169	54	1	0	50	2	0	0.00000	0.00000
4	195662009	Acute viral pharyngitis (disorder)	103	157141000119108	Proteinuria due to type 2 diabetes mellitus (disorder)	1095	890	3	3	887	0	205	1.23034	0.02516	0.00000	0.00000	0.00000	1.0000000000	1.0000000000	2.43836	0.21828	430	1	1	460	2	2	0.00000	0.62369
3	65363002	Otitis media	103	157141000119108	Proteinuria due to type 2 diabetes mellitus (disorder)	1095	580	3	2	578	1	514	1.25862	0.01439	1.77855	19.67197	0.16080	1.0000000000	1.0000000000	1.58904	0.21254	277	1	0	303	2	2	-0.69315	-5.02716
115	36923009	Major depression  single episode	77	422034002	Diabetic retinopathy associated with type II diabetes mellitus (disorder)	1095	6	20	0	6	20	1069	0.00000	-0.01012	0.00000	0.00000	0.00000	1.0000000000	1.0000000000	0.10959	-0.15003	3	8	0	3	12	0	0.00000	0.00000
1	444814009	Viral sinusitis (disorder)	103	157141000119108	Proteinuria due to type 2 diabetes mellitus (disorder)	1095	993	3	3	990	0	102	1.10272	0.01680	0.00000	0.00000	0.00000	1.0000000000	1.0000000000	2.72055	0.10448	478	1	1	515	2	2	0.00000	0.61680
113	443165006	Pathological fracture due to osteoporosis (disorder)	77	422034002	Diabetic retinopathy associated with type II diabetes mellitus (disorder)	1095	10	20	1	9	19	1066	5.47500	0.05860	6.23392	51.68709	0.75187	0.1689838786	0.7953568293	0.18265	0.75798	7	8	1	3	12	0	2.19722	2.07944
112	49436004	Atrial Fibrillation	77	422034002	Diabetic retinopathy associated with type II diabetes mellitus (disorder)	1095	35	20	2	33	18	1042	3.12857	0.05276	3.50842	15.74588	0.78173	0.1317109623	0.7138846116	0.63927	0.87191	9	8	0	26	12	2	-1.94591	-2.63906
111	235919008	Cholelithiasis	77	422034002	Diabetic retinopathy associated with type II diabetes mellitus (disorder)	1095	9	20	0	9	20	1066	0.00000	-0.01242	0.00000	0.00000	0.00000	1.0000000000	1.0000000000	0.16438	-0.21957	7	8	0	2	12	0	0.00000	0.00000
110	65275009	Acute Cholecystitis	77	422034002	Diabetic retinopathy associated with type II diabetes mellitus (disorder)	1095	9	20	0	9	20	1066	0.00000	-0.01242	0.00000	0.00000	0.00000	1.0000000000	1.0000000000	0.16438	-0.21957	7	8	0	2	12	0	0.00000	0.00000
109	90560007	Gout	77	422034002	Diabetic retinopathy associated with type II diabetes mellitus (disorder)	1095	4	20	0	4	20	1071	0.00000	-0.00826	0.00000	0.00000	0.00000	1.0000000000	1.0000000000	0.07306	-0.10173	0	8	0	4	12	0	0.00000	0.00000
108	40930008	Hypothyroidism (disorder)	77	422034002	Diabetic retinopathy associated with type II diabetes mellitus (disorder)	1095	13	20	0	13	20	1062	0.00000	-0.01495	0.00000	0.00000	0.00000	1.0000000000	1.0000000000	0.23744	-0.30736	11	8	0	2	12	0	0.00000	0.00000
107	40275004	Contact dermatitis	77	422034002	Diabetic retinopathy associated with type II diabetes mellitus (disorder)	1095	18	20	1	17	19	1058	3.04167	0.03600	3.27554	25.88510	0.41449	0.2842572622	0.9659403678	0.32877	0.58991	9	8	0	9	12	1	-2.56495	-2.30259
106	24079001	Atopic dermatitis	77	422034002	Diabetic retinopathy associated with type II diabetes mellitus (disorder)	1095	20	20	0	20	20	1055	0.00000	-0.01860	0.00000	0.00000	0.00000	1.0000000000	1.0000000000	0.36530	-0.44921	13	8	0	7	12	0	0.00000	0.00000
105	363406005	Malignant tumor of colon	77	422034002	Diabetic retinopathy associated with type II diabetes mellitus (disorder)	1095	6	20	0	6	20	1069	0.00000	-0.01012	0.00000	0.00000	0.00000	1.0000000000	1.0000000000	0.10959	-0.15003	4	8	0	2	12	0	0.00000	0.00000
104	367498001	Seasonal allergic rhinitis	77	422034002	Diabetic retinopathy associated with type II diabetes mellitus (disorder)	1095	20	20	0	20	20	1055	0.00000	-0.01860	0.00000	0.00000	0.00000	1.0000000000	1.0000000000	0.36530	-0.44921	9	8	0	11	12	0	0.00000	0.00000
102	90781000119102	Microalbuminuria due to type 2 diabetes mellitus (disorder)	77	422034002	Diabetic retinopathy associated with type II diabetes mellitus (disorder)	1095	6	20	1	5	19	1070	9.12500	0.08226	11.26316	101.08580	1.25496	0.1049341008	0.6373840157	0.10959	0.84997	3	8	0	3	12	1	-2.56495	-1.38629
101	433144002	Chronic kidney disease stage 3 (disorder)	77	422034002	Diabetic retinopathy associated with type II diabetes mellitus (disorder)	1095	3	20	1	2	19	1073	18.25000	0.12332	28.23684	324.91689	2.45392	0.0538481030	0.4488876049	0.05479	0.92304	1	8	0	2	12	1	-2.56495	-1.09861
100	161622006	History of lower limb amputation (situation)	77	422034002	Diabetic retinopathy associated with type II diabetes mellitus (disorder)	1095	1	20	0	1	20	1074	0.00000	-0.00412	0.00000	0.00000	0.00000	1.0000000000	1.0000000000	0.01826	-0.02611	0	8	0	1	12	0	0.00000	0.00000
99	30832001	Rupture of patellar tendon	77	422034002	Diabetic retinopathy associated with type II diabetes mellitus (disorder)	1095	23	20	1	22	19	1053	2.38043	0.02758	2.51914	19.66118	0.32277	0.3484063322	1.0000000000	0.42009	0.49402	14	8	1	9	12	0	2.19722	2.70805
98	1551000119108	Nonproliferative diabetic retinopathy due to type 2 diabetes mellitus (disorder)	77	422034002	Diabetic retinopathy associated with type II diabetes mellitus (disorder)	1095	12	20	12	0	8	1075	54.75000	0.77173	0.00000	0.00000	0.00000	0.0000000000	0.0000000000	0.21918	3.41453	7	8	7	5	12	5	-0.46164	0.00000
97	403192003	Third degree burn	77	422034002	Diabetic retinopathy associated with type II diabetes mellitus (disorder)	1095	8	20	0	8	20	1067	0.00000	-0.01170	0.00000	0.00000	0.00000	1.0000000000	1.0000000000	0.14612	-0.19676	3	8	0	5	12	0	0.00000	0.00000
96	283371005	Laceration of forearm	77	422034002	Diabetic retinopathy associated with type II diabetes mellitus (disorder)	1095	75	20	1	74	19	1001	0.73000	-0.00999	0.71195	5.39217	0.09400	1.0000000000	1.0000000000	1.36986	-0.24480	39	8	1	36	12	0	2.19722	3.68888
95	84757009	Epilepsy	77	422034002	Diabetic retinopathy associated with type II diabetes mellitus (disorder)	1095	30	20	0	30	20	1045	0.00000	-0.02289	0.00000	0.00000	0.00000	1.0000000000	1.0000000000	0.54795	-0.63035	13	8	0	17	12	0	0.00000	0.00000
94	703151001	History of single seizure (situation)	77	422034002	Diabetic retinopathy associated with type II diabetes mellitus (disorder)	1095	39	20	0	39	20	1036	0.00000	-0.02621	0.00000	0.00000	0.00000	1.0000000000	1.0000000000	0.71233	-0.77596	14	8	0	25	12	0	0.00000	0.00000
93	128613002	Seizure disorder	77	422034002	Diabetic retinopathy associated with type II diabetes mellitus (disorder)	1095	39	20	0	39	20	1036	0.00000	-0.02621	0.00000	0.00000	0.00000	1.0000000000	1.0000000000	0.71233	-0.77596	14	8	0	25	12	0	0.00000	0.00000
92	82423001	Chronic pain	77	422034002	Diabetic retinopathy associated with type II diabetes mellitus (disorder)	1095	52	20	0	52	20	1023	0.00000	-0.03046	0.00000	0.00000	0.00000	0.6195182740	1.0000000000	0.94977	-0.96331	24	8	0	28	12	0	0.00000	0.00000
91	64859006	Osteoporosis (disorder)	77	422034002	Diabetic retinopathy associated with type II diabetes mellitus (disorder)	1095	37	20	1	36	19	1039	1.47973	0.01224	1.51901	11.66049	0.19788	0.5002378770	1.0000000000	0.67580	0.25515	24	8	1	13	12	0	2.19722	3.21888
89	47693006	Rupture of appendix	77	422034002	Diabetic retinopathy associated with type II diabetes mellitus (disorder)	1095	20	20	0	20	20	1055	0.00000	-0.01860	0.00000	0.00000	0.00000	1.0000000000	1.0000000000	0.36530	-0.44921	10	8	0	10	12	0	0.00000	0.00000
88	197927001	Recurrent urinary tract infection	77	422034002	Diabetic retinopathy associated with type II diabetes mellitus (disorder)	1095	8	20	0	8	20	1067	0.00000	-0.01170	0.00000	0.00000	0.00000	1.0000000000	1.0000000000	0.14612	-0.19676	8	8	0	0	12	0	0.00000	0.00000
86	713197008	Recurrent rectal polyp	77	422034002	Diabetic retinopathy associated with type II diabetes mellitus (disorder)	1095	22	20	0	22	20	1053	0.00000	-0.01953	0.00000	0.00000	0.00000	1.0000000000	1.0000000000	0.40183	-0.48731	12	8	0	10	12	0	0.00000	0.00000
85	241929008	Acute allergic reaction	77	422034002	Diabetic retinopathy associated with type II diabetes mellitus (disorder)	1095	47	20	0	47	20	1028	0.00000	-0.02889	0.00000	0.00000	0.00000	1.0000000000	1.0000000000	0.85845	-0.89410	25	8	0	22	12	0	0.00000	0.00000
83	110030002	Concussion injury of brain	77	422034002	Diabetic retinopathy associated with type II diabetes mellitus (disorder)	1095	7	20	0	7	20	1068	0.00000	-0.01094	0.00000	0.00000	0.00000	1.0000000000	1.0000000000	0.12785	-0.17358	1	8	0	6	12	0	0.00000	0.00000
82	94260004	Secondary malignant neoplasm of colon	77	422034002	Diabetic retinopathy associated with type II diabetes mellitus (disorder)	1095	4	20	1	3	19	1072	13.68750	0.10479	18.80702	189.12653	1.87020	0.0711768923	0.5245934178	0.07306	0.89827	2	8	0	2	12	1	-2.56495	-1.09861
81	236077008	Protracted diarrhea	77	422034002	Diabetic retinopathy associated with type II diabetes mellitus (disorder)	1095	4	20	1	3	19	1072	13.68750	0.10479	18.80702	189.12653	1.87020	0.0711768923	0.5245934178	0.07306	0.89827	2	8	0	2	12	1	-2.56495	-1.09861
80	6072007	Bleeding from anus	77	422034002	Diabetic retinopathy associated with type II diabetes mellitus (disorder)	1095	4	20	1	3	19	1072	13.68750	0.10479	18.80702	189.12653	1.87020	0.0711768923	0.5245934178	0.07306	0.89827	2	8	0	2	12	1	-2.56495	-1.09861
79	45816000	Pyelonephritis	77	422034002	Diabetic retinopathy associated with type II diabetes mellitus (disorder)	1095	1	20	0	1	20	1074	0.00000	-0.00412	0.00000	0.00000	0.00000	1.0000000000	1.0000000000	0.01826	-0.02611	1	8	0	0	12	0	0.00000	0.00000
78	239872002	Osteoarthritis of hip	77	422034002	Diabetic retinopathy associated with type II diabetes mellitus (disorder)	1095	21	20	1	20	19	1055	2.60714	0.03065	2.77632	21.76051	0.35422	0.3234313401	1.0000000000	0.38356	0.53161	13	8	0	8	12	1	-2.56495	-2.19722
76	127013003	Diabetic renal disease (disorder)	77	422034002	Diabetic retinopathy associated with type II diabetes mellitus (disorder)	1095	28	20	8	20	12	1055	15.64286	0.32354	35.16667	95.40270	12.96289	0.0000000064	0.0000004441	0.51142	2.57402	10	8	3	18	12	5	0.07551	-0.05972
75	431855005	Chronic kidney disease stage 1 (disorder)	77	422034002	Diabetic retinopathy associated with type II diabetes mellitus (disorder)	1095	28	20	8	20	12	1055	15.64286	0.32354	35.16667	95.40270	12.96289	0.0000000064	0.0000004441	0.51142	2.57402	10	8	3	18	12	5	0.07551	-0.05972
73	196416002	Impacted molars	77	422034002	Diabetic retinopathy associated with type II diabetes mellitus (disorder)	1095	49	20	1	48	19	1027	1.11735	0.00346	1.12610	8.58797	0.14766	0.6030116966	1.0000000000	0.89498	0.07782	25	8	0	24	12	1	-2.56495	-3.21888
72	35999006	Blighted ovum	77	422034002	Diabetic retinopathy associated with type II diabetes mellitus (disorder)	1095	53	20	2	51	18	1024	2.06604	0.03279	2.23094	9.87605	0.50395	0.2518212279	0.9133257124	0.96804	0.60821	53	8	2	0	12	0	1.60944	3.31419
71	201834006	Localized  primary osteoarthritis of the hand	77	422034002	Diabetic retinopathy associated with type II diabetes mellitus (disorder)	1095	28	20	2	26	18	1049	3.91071	0.06431	4.48291	20.32961	0.98853	0.0902351548	0.5966770779	0.51142	0.98906	19	8	2	9	12	0	1.60944	2.35138
70	87433001	Pulmonary emphysema (disorder)	77	422034002	Diabetic retinopathy associated with type II diabetes mellitus (disorder)	1095	17	20	0	17	20	1058	0.00000	-0.01713	0.00000	0.00000	0.00000	1.0000000000	1.0000000000	0.31050	-0.39012	9	8	0	8	12	0	0.00000	0.00000
69	233604007	Pneumonia	77	422034002	Diabetic retinopathy associated with type II diabetes mellitus (disorder)	1095	7	20	0	7	20	1068	0.00000	-0.01094	0.00000	0.00000	0.00000	1.0000000000	1.0000000000	0.12785	-0.17358	3	8	0	4	12	0	0.00000	0.00000
68	26929004	Alzheimer's disease (disorder)	77	422034002	Diabetic retinopathy associated with type II diabetes mellitus (disorder)	1095	23	20	0	23	20	1052	0.00000	-0.01998	0.00000	0.00000	0.00000	1.0000000000	1.0000000000	0.42009	-0.50598	15	8	0	8	12	0	0.00000	0.00000
67	403191005	Second degree burn	77	422034002	Diabetic retinopathy associated with type II diabetes mellitus (disorder)	1095	49	20	2	47	18	1028	2.23469	0.03645	2.43026	10.78156	0.54780	0.2241913097	0.8794911525	0.89498	0.66278	23	8	0	26	12	2	-1.94591	-2.63906
65	239873007	Osteoarthritis of knee	77	422034002	Diabetic retinopathy associated with type II diabetes mellitus (disorder)	1095	57	20	4	53	16	1022	3.84211	0.09084	4.82075	14.92207	1.55740	0.0171221347	0.2232466162	1.04110	1.29258	30	8	0	27	12	4	-1.38629	-2.04769
64	444448004	Injury of medial collateral ligament of knee	77	422034002	Diabetic retinopathy associated with type II diabetes mellitus (disorder)	1095	32	20	1	31	19	1044	1.71094	0.01682	1.77250	13.66383	0.22993	0.4503494275	1.0000000000	0.58447	0.33600	17	8	1	15	12	0	2.19722	2.89037
63	68496003	Polyp of colon	77	422034002	Diabetic retinopathy associated with type II diabetes mellitus (disorder)	1095	91	20	1	90	19	985	0.60165	-0.01636	0.57602	4.35283	0.07623	1.0000000000	1.0000000000	1.66210	-0.41257	43	8	0	48	12	1	-2.56495	-3.89182
62	185086009	Chronic obstructive bronchitis (disorder)	77	422034002	Diabetic retinopathy associated with type II diabetes mellitus (disorder)	1095	6	20	0	6	20	1069	0.00000	-0.01012	0.00000	0.00000	0.00000	1.0000000000	1.0000000000	0.10959	-0.15003	4	8	0	2	12	0	0.00000	0.00000
60	301011002	Escherichia coli urinary tract infection	77	422034002	Diabetic retinopathy associated with type II diabetes mellitus (disorder)	1095	92	20	2	90	18	985	1.19022	0.00786	1.21605	5.32460	0.27773	0.6819027983	1.0000000000	1.68037	0.16253	85	8	1	7	12	1	-0.36772	2.37491
59	262574004	Bullet wound	77	422034002	Diabetic retinopathy associated with type II diabetes mellitus (disorder)	1095	20	20	1	19	19	1056	2.73750	0.03233	2.92521	22.98381	0.37230	0.3106053939	1.0000000000	0.36530	0.55079	9	8	0	11	12	1	-2.56495	-2.48491
58	239720000	Tear of meniscus of knee	77	422034002	Diabetic retinopathy associated with type II diabetes mellitus (disorder)	1095	20	20	1	19	19	1056	2.73750	0.03233	2.92521	22.98381	0.37230	0.3106053939	1.0000000000	0.36530	0.55079	10	8	0	10	12	1	-2.56495	-2.39790
57	192127007	Child attention deficit disorder	77	422034002	Diabetic retinopathy associated with type II diabetes mellitus (disorder)	1095	76	20	2	74	18	1001	1.44079	0.01642	1.50300	6.60149	0.34220	0.6440783962	1.0000000000	1.38813	0.32908	24	8	0	52	12	2	-1.94591	-3.29584
56	92691004	Carcinoma in situ of prostate (disorder)	77	422034002	Diabetic retinopathy associated with type II diabetes mellitus (disorder)	1095	23	20	1	22	19	1053	2.38043	0.02758	2.51914	19.66118	0.32277	0.3484063322	1.0000000000	0.42009	0.49402	0	8	0	23	12	1	-2.56495	-3.17805
54	5602001	Opioid abuse (disorder)	77	422034002	Diabetic retinopathy associated with type II diabetes mellitus (disorder)	1095	7	20	0	7	20	1068	0.00000	-0.01094	0.00000	0.00000	0.00000	1.0000000000	1.0000000000	0.12785	-0.17358	0	8	0	7	12	0	0.00000	0.00000
53	7200002	Alcoholism	77	422034002	Diabetic retinopathy associated with type II diabetes mellitus (disorder)	1095	5	20	0	5	20	1070	0.00000	-0.00924	0.00000	0.00000	0.00000	1.0000000000	1.0000000000	0.09132	-0.12608	0	8	0	5	12	0	0.00000	0.00000
52	124171000119105	Chronic intractable migraine without aura	77	422034002	Diabetic retinopathy associated with type II diabetes mellitus (disorder)	1095	51	20	3	48	17	1027	3.22059	0.06694	3.77574	13.32495	1.06989	0.0620090373	0.4836892708	0.93151	1.05027	21	8	0	30	12	3	-1.60944	-2.39790
50	446096008	Perennial allergic rhinitis	77	422034002	Diabetic retinopathy associated with type II diabetes mellitus (disorder)	1095	26	20	0	26	20	1049	0.00000	-0.02127	0.00000	0.00000	0.00000	1.0000000000	1.0000000000	0.47489	-0.56060	14	8	0	12	12	0	0.00000	0.00000
49	88805009	Chronic congestive heart failure (disorder)	77	422034002	Diabetic retinopathy associated with type II diabetes mellitus (disorder)	1095	10	20	0	10	20	1065	0.00000	-0.01309	0.00000	0.00000	0.00000	1.0000000000	1.0000000000	0.18265	-0.24202	5	8	0	5	12	0	0.00000	0.00000
47	359817006	Closed fracture of hip	77	422034002	Diabetic retinopathy associated with type II diabetes mellitus (disorder)	1095	29	20	0	29	20	1046	0.00000	-0.02250	0.00000	0.00000	0.00000	1.0000000000	1.0000000000	0.52968	-0.61323	11	8	0	18	12	0	0.00000	0.00000
46	62564004	Concussion with loss of consciousness	77	422034002	Diabetic retinopathy associated with type II diabetes mellitus (disorder)	1095	67	20	0	67	20	1008	0.00000	-0.03482	0.00000	0.00000	0.00000	0.6286177968	1.0000000000	1.22374	-1.15299	36	8	0	31	12	0	0.00000	0.00000
45	263102004	Fracture subluxation of wrist	77	422034002	Diabetic retinopathy associated with type II diabetes mellitus (disorder)	1095	109	20	1	108	19	967	0.50229	-0.02257	0.47125	3.55487	0.06247	0.7121796267	1.0000000000	1.99087	-0.58056	51	8	0	58	12	1	-2.56495	-4.07754
44	58150001	Fracture of clavicle	77	422034002	Diabetic retinopathy associated with type II diabetes mellitus (disorder)	1095	112	20	2	110	18	965	0.97768	-0.00103	0.97475	4.25694	0.22320	1.0000000000	1.0000000000	2.04566	-0.02179	55	8	1	57	12	1	-0.36772	-0.03509
43	307731004	Injury of tendon of the rotator cuff of shoulder	77	422034002	Diabetic retinopathy associated with type II diabetes mellitus (disorder)	1095	51	20	4	47	16	1028	4.29412	0.09931	5.46809	16.99496	1.75934	0.0116357371	0.1704250285	0.93151	1.37220	26	8	2	25	12	2	-0.33647	0.03637
42	16114001	Fracture of ankle	77	422034002	Diabetic retinopathy associated with type II diabetes mellitus (disorder)	1095	108	20	2	106	18	969	1.01389	0.00063	1.01572	4.43785	0.23248	1.0000000000	1.0000000000	1.97260	0.01324	48	8	1	60	12	1	-0.36772	-0.21905
41	283385000	Laceration of thigh	77	422034002	Diabetic retinopathy associated with type II diabetes mellitus (disorder)	1095	105	20	4	101	16	974	2.08571	0.04823	2.41089	7.34958	0.79085	0.1167150330	0.6772868389	1.91781	0.77704	50	8	2	55	12	2	-0.33647	-0.09181
40	428251008	History of appendectomy	77	422034002	Diabetic retinopathy associated with type II diabetes mellitus (disorder)	1095	51	20	0	51	20	1024	0.00000	-0.03015	0.00000	0.00000	0.00000	1.0000000000	1.0000000000	0.93151	-0.94973	27	8	0	24	12	0	0.00000	0.00000
39	74400008	Appendicitis	77	422034002	Diabetic retinopathy associated with type II diabetes mellitus (disorder)	1095	51	20	0	51	20	1024	0.00000	-0.03015	0.00000	0.00000	0.00000	1.0000000000	1.0000000000	0.93151	-0.94973	27	8	0	24	12	0	0.00000	0.00000
38	398254007	Preeclampsia	77	422034002	Diabetic retinopathy associated with type II diabetes mellitus (disorder)	1095	101	20	1	100	19	975	0.54208	-0.01991	0.51316	3.87372	0.06798	1.0000000000	1.0000000000	1.84475	-0.50830	101	8	1	0	12	0	2.19722	4.62497
37	38822007	Cystitis	77	422034002	Diabetic retinopathy associated with type II diabetes mellitus (disorder)	1095	71	20	3	68	17	1007	2.31338	0.04717	2.61332	9.13695	0.74745	0.1348851285	0.7224049163	1.29680	0.80037	68	8	3	3	12	0	1.29928	3.16407
35	19169002	Miscarriage in first trimester	77	422034002	Diabetic retinopathy associated with type II diabetes mellitus (disorder)	1095	174	20	5	169	15	906	1.57328	0.03399	1.78698	4.98228	0.64093	0.3477328087	1.0000000000	3.17808	0.52212	174	8	5	0	12	0	0.95551	3.57795
33	429007001	History of cardiac arrest (situation)	77	422034002	Diabetic retinopathy associated with type II diabetes mellitus (disorder)	1095	42	20	1	41	19	1034	1.30357	0.00827	1.32734	10.15675	0.17346	0.5458048964	1.0000000000	0.76712	0.17860	24	8	1	18	12	0	2.19722	3.21888
32	410429000	Cardiac Arrest	77	422034002	Diabetic retinopathy associated with type II diabetes mellitus (disorder)	1095	42	20	1	41	19	1034	1.30357	0.00827	1.32734	10.15675	0.17346	0.5458048964	1.0000000000	0.76712	0.17860	24	8	1	18	12	0	2.19722	3.21888
31	230690007	Stroke	77	422034002	Diabetic retinopathy associated with type II diabetes mellitus (disorder)	1095	62	20	2	60	18	1015	1.76613	0.02560	1.87963	8.28937	0.42621	0.3144154169	1.0000000000	1.13242	0.49247	32	8	1	30	12	1	-0.36772	0.06252
30	399211009	History of myocardial infarction (situation)	77	422034002	Diabetic retinopathy associated with type II diabetes mellitus (disorder)	1095	31	20	0	31	20	1044	0.00000	-0.02328	0.00000	0.00000	0.00000	1.0000000000	1.0000000000	0.56621	-0.64728	2	8	0	29	12	0	0.00000	0.00000
29	22298006	Myocardial Infarction	77	422034002	Diabetic retinopathy associated with type II diabetes mellitus (disorder)	1095	31	20	0	31	20	1044	0.00000	-0.02328	0.00000	0.00000	0.00000	1.0000000000	1.0000000000	0.56621	-0.64728	2	8	0	29	12	0	0.00000	0.00000
28	53741008	Coronary Heart Disease	77	422034002	Diabetic retinopathy associated with type II diabetes mellitus (disorder)	1095	80	20	6	74	14	1001	4.10625	0.11895	5.79730	15.52533	2.16476	0.0021358238	0.0458392689	1.46119	1.50800	24	8	3	56	12	3	-0.31015	-0.78170
27	408512008	Body mass index 40+ - severely obese (finding)	77	422034002	Diabetic retinopathy associated with type II diabetes mellitus (disorder)	1095	97	20	2	95	18	980	1.12887	0.00548	1.14620	5.01497	0.26197	0.6952591165	1.0000000000	1.77169	0.11420	67	8	2	30	12	0	1.60944	3.54096
26	33737001	Fracture of rib	77	422034002	Diabetic retinopathy associated with type II diabetes mellitus (disorder)	1095	54	20	0	54	20	1021	0.00000	-0.03107	0.00000	0.00000	0.00000	0.6191554175	1.0000000000	0.98630	-0.99008	32	8	0	22	12	0	0.00000	0.00000
24	162864005	Body mass index 30+ - obesity (finding)	77	422034002	Diabetic retinopathy associated with type II diabetes mellitus (disorder)	1095	439	20	8	431	12	644	0.99772	-0.00025	0.99613	2.45715	0.40383	1.0000000000	1.0000000000	8.01826	-0.00292	226	8	3	213	12	5	0.07551	0.56005
23	36971009	Sinusitis (disorder)	77	422034002	Diabetic retinopathy associated with type II diabetes mellitus (disorder)	1095	190	20	6	184	14	891	1.72895	0.04556	2.07531	5.47152	0.78715	0.1378301959	0.7297186125	3.47032	0.64698	84	8	2	106	12	4	0.22314	0.44701
22	70704007	Sprain of wrist	77	422034002	Diabetic retinopathy associated with type II diabetes mellitus (disorder)	1095	195	20	4	191	16	884	1.12308	0.00781	1.15707	3.49960	0.38256	0.7688384102	1.0000000000	3.56164	0.13237	90	8	1	105	12	3	0.58779	0.92734
21	15777000	Prediabetes	77	422034002	Diabetic retinopathy associated with type II diabetes mellitus (disorder)	1095	333	20	12	321	8	754	1.97297	0.08773	3.52336	8.70154	1.42665	0.0060614086	0.1051522618	6.08219	0.87624	159	8	4	174	12	8	0.18232	0.58289
20	80394007	Hyperglycemia (disorder)	77	422034002	Diabetic retinopathy associated with type II diabetes mellitus (disorder)	1095	55	20	18	37	2	1038	17.91818	0.53068	252.48649	1128.42662	56.49408	0.0000000000	0.0000000000	1.00457	3.24464	23	8	8	32	12	10	-0.09531	-0.08054
19	237602007	Metabolic syndrome X (disorder)	77	422034002	Diabetic retinopathy associated with type II diabetes mellitus (disorder)	1095	64	20	19	45	1	1030	16.25391	0.51839	434.88889	3320.95030	56.95007	0.0000000000	0.0000000000	1.16895	3.20493	28	8	8	36	12	11	-0.04445	0.05183
18	302870006	Hypertriglyceridemia (disorder)	77	422034002	Diabetic retinopathy associated with type II diabetes mellitus (disorder)	1095	64	20	19	45	1	1030	16.25391	0.51839	434.88889	3320.95030	56.95007	0.0000000000	0.0000000000	1.16895	3.20493	28	8	8	36	12	11	-0.04445	0.05183
17	368581000119106	Neuropathy due to type 2 diabetes mellitus (disorder)	77	422034002	Diabetic retinopathy associated with type II diabetes mellitus (disorder)	1095	28	20	10	18	10	1057	19.55357	0.40995	58.72222	158.45372	21.76219	0.0000000000	0.0000000003	0.51142	2.86353	7	8	3	21	12	7	0.30075	-0.18232
129	47505003	Posttraumatic stress disorder	51	403190006	First degree burn	1095	4	79	1	3	78	1013	3.46519	0.04162	4.32906	42.10695	0.44508	0.2591455240	0.9239558936	0.28858	0.63421	1	43	1	3	36	0	3.78419	0.69315
15	40055000	Chronic sinusitis (disorder)	77	422034002	Diabetic retinopathy associated with type II diabetes mellitus (disorder)	1095	216	20	4	212	16	863	1.01389	0.00094	1.01769	3.07542	0.33676	1.0000000000	1.0000000000	3.94521	0.01590	104	8	2	112	12	2	-0.33647	-0.07276
14	10509002	Acute bronchitis (disorder)	77	422034002	Diabetic retinopathy associated with type II diabetes mellitus (disorder)	1095	863	20	20	843	0	232	1.26883	0.07072	0.00000	0.00000	0.00000	0.0118844247	0.1721476562	15.76256	0.32515	418	8	8	445	12	12	0.00000	0.33522
13	370247008	Facial laceration	77	422034002	Diabetic retinopathy associated with type II diabetes mellitus (disorder)	1095	109	20	2	107	18	968	1.00459	0.00021	1.00519	4.39134	0.23009	1.0000000000	1.0000000000	1.99087	0.00440	55	8	2	54	12	0	1.60944	3.34990
12	65966004	Fracture of forearm	77	422034002	Diabetic retinopathy associated with type II diabetes mellitus (disorder)	1095	123	20	6	117	14	958	2.67073	0.08107	3.50916	9.30743	1.32305	0.0182901476	0.2349246247	2.24658	1.10844	55	8	1	68	12	5	0.97345	1.34433
11	38341003	Hypertension	77	422034002	Diabetic retinopathy associated with type II diabetes mellitus (disorder)	1095	278	20	11	267	9	808	2.16637	0.09280	3.69871	9.02250	1.51626	0.0068347692	0.1162705502	5.07763	0.98145	131	8	5	147	12	6	-0.14310	0.06454
10	62106007	Concussion with no loss of consciousness	77	422034002	Diabetic retinopathy associated with type II diabetes mellitus (disorder)	1095	206	20	8	198	12	877	2.12621	0.07395	2.95286	7.31969	1.19123	0.0366015035	0.3597849915	3.76256	0.91819	96	8	5	110	12	3	-0.65393	-0.62309
9	44465007	Sprain of ankle	77	422034002	Diabetic retinopathy associated with type II diabetes mellitus (disorder)	1095	362	20	7	355	13	720	1.05870	0.00563	1.09209	2.76127	0.43193	0.8149543877	1.0000000000	6.61187	0.07175	185	8	3	177	12	4	-0.08701	0.32563
8	233678006	Childhood asthma	77	422034002	Diabetic retinopathy associated with type II diabetes mellitus (disorder)	1095	45	20	0	45	20	1030	0.00000	-0.02824	0.00000	0.00000	0.00000	1.0000000000	1.0000000000	0.82192	-0.86546	25	8	0	20	12	0	0.00000	0.00000
7	75498004	Acute bacterial sinusitis (disorder)	77	422034002	Diabetic retinopathy associated with type II diabetes mellitus (disorder)	1095	187	20	5	182	15	893	1.46390	0.02872	1.63553	4.55655	0.58706	0.3646611401	1.0000000000	3.41553	0.44238	89	8	3	98	12	2	-0.64663	-0.48885
6	39848009	Whiplash injury to neck	77	422034002	Diabetic retinopathy associated with type II diabetes mellitus (disorder)	1095	182	20	6	176	14	899	1.80495	0.04902	2.18912	5.77429	0.82993	0.1242759457	0.6913144812	3.32420	0.69492	92	8	1	90	12	5	0.97345	1.58816
5	284549007	Laceration of hand	77	422034002	Diabetic retinopathy associated with type II diabetes mellitus (disorder)	1095	104	20	3	101	17	974	1.57933	0.02560	1.70181	5.90649	0.49033	0.4274216011	1.0000000000	1.89954	0.46417	54	8	1	50	12	2	0.25131	0.74924
4	195662009	Acute viral pharyngitis (disorder)	77	422034002	Diabetic retinopathy associated with type II diabetes mellitus (disorder)	1095	890	20	19	871	1	204	1.16882	0.04798	4.45006	33.43391	0.59230	0.1494035668	0.7580719708	16.25571	0.21293	430	8	7	460	12	12	0.06899	0.46195
3	65363002	Otitis media	77	422034002	Diabetic retinopathy associated with type II diabetes mellitus (disorder)	1095	580	20	9	571	11	504	0.84957	-0.02178	0.72218	1.75692	0.29685	0.5048725171	1.0000000000	10.59361	-0.21333	277	8	2	303	12	7	0.61091	1.14740
115	36923009	Major depression  single episode	51	403190006	First degree burn	1095	6	79	0	6	79	1010	0.00000	-0.02070	0.00000	0.00000	0.00000	1.0000000000	1.0000000000	0.43288	-0.51891	3	43	0	3	36	0	0.00000	0.00000
1	444814009	Viral sinusitis (disorder)	77	422034002	Diabetic retinopathy associated with type II diabetes mellitus (disorder)	1095	993	20	20	973	0	102	1.10272	0.04372	0.00000	0.00000	0.00000	0.2465034255	0.9133257124	18.13699	0.13403	478	8	8	515	12	12	0.00000	0.32447
113	443165006	Pathological fracture due to osteoporosis (disorder)	51	403190006	First degree burn	1095	10	79	3	7	76	1009	4.15823	0.08455	5.68985	22.44652	1.44229	0.0299843941	0.3180139089	0.72146	1.21637	7	43	1	3	36	2	0.83975	1.16315
112	49436004	Atrial Fibrillation	51	403190006	First degree burn	1095	35	79	7	28	72	988	2.77215	0.08979	3.43056	8.12401	1.44863	0.0100544613	0.1555459839	2.52511	1.18233	9	43	2	26	36	5	1.00938	-0.11980
111	235919008	Cholelithiasis	51	403190006	First degree burn	1095	9	79	0	9	79	1007	0.00000	-0.02538	0.00000	0.00000	0.00000	1.0000000000	1.0000000000	0.64932	-0.72187	7	43	0	2	36	0	0.00000	0.00000
110	65275009	Acute Cholecystitis	51	403190006	First degree burn	1095	9	79	0	9	79	1007	0.00000	-0.02538	0.00000	0.00000	0.00000	1.0000000000	1.0000000000	0.64932	-0.72187	7	43	0	2	36	0	0.00000	0.00000
109	90560007	Gout	51	403190006	First degree burn	1095	4	79	0	4	79	1012	0.00000	-0.01688	0.00000	0.00000	0.00000	1.0000000000	1.0000000000	0.28858	-0.36579	0	43	0	4	36	0	0.00000	0.00000
108	40930008	Hypothyroidism (disorder)	51	403190006	First degree burn	1095	13	79	2	11	77	1005	2.13242	0.03461	2.37308	10.89766	0.51676	0.2400479065	0.9095097439	0.93790	0.63047	11	43	2	2	36	0	3.11352	1.87180
107	40275004	Contact dermatitis	51	403190006	First degree burn	1095	18	79	2	16	77	1000	1.54008	0.01947	1.62338	7.18968	0.36655	0.3772831594	1.0000000000	1.29863	0.38419	9	43	1	9	36	1	0.17327	0.00000
106	24079001	Atopic dermatitis	51	403190006	First degree burn	1095	20	79	1	19	78	997	0.69304	-0.01168	0.67274	5.09188	0.08888	1.0000000000	1.0000000000	1.44292	-0.28861	13	43	1	7	36	0	3.78419	2.63906
105	363406005	Malignant tumor of colon	51	403190006	First degree burn	1095	6	79	1	5	78	1011	2.31013	0.02712	2.59231	22.46375	0.29915	0.3625981368	1.0000000000	0.43288	0.48109	4	43	1	2	36	0	3.78419	1.60944
104	367498001	Seasonal allergic rhinitis	51	403190006	First degree burn	1095	20	79	1	19	78	997	0.69304	-0.01168	0.67274	5.09188	0.08888	1.0000000000	1.0000000000	1.44292	-0.28861	9	43	1	11	36	0	3.78419	2.30259
103	157141000119108	Proteinuria due to type 2 diabetes mellitus (disorder)	51	403190006	First degree burn	1095	3	79	0	3	79	1013	0.00000	-0.01462	0.00000	0.00000	0.00000	1.0000000000	1.0000000000	0.21644	-0.28266	1	43	0	2	36	0	0.00000	0.00000
102	90781000119102	Microalbuminuria due to type 2 diabetes mellitus (disorder)	51	403190006	First degree burn	1095	6	79	0	6	79	1010	0.00000	-0.02070	0.00000	0.00000	0.00000	1.0000000000	1.0000000000	0.43288	-0.51891	3	43	0	3	36	0	0.00000	0.00000
101	433144002	Chronic kidney disease stage 3 (disorder)	51	403190006	First degree burn	1095	3	79	0	3	79	1013	0.00000	-0.01462	0.00000	0.00000	0.00000	1.0000000000	1.0000000000	0.21644	-0.28266	1	43	0	2	36	0	0.00000	0.00000
100	161622006	History of lower limb amputation (situation)	51	403190006	First degree burn	1095	1	79	1	0	78	1016	13.86076	0.10842	0.00000	0.00000	0.00000	0.0721461187	0.5300715848	0.07215	0.89950	0	43	0	1	36	1	-3.61092	-0.69315
99	30832001	Rupture of patellar tendon	51	403190006	First degree burn	1095	23	79	2	21	77	995	1.20528	0.00838	1.23067	5.34614	0.28330	0.6793111107	1.0000000000	1.65936	0.17388	14	43	1	9	36	1	0.17327	0.40547
98	1551000119108	Nonproliferative diabetic retinopathy due to type 2 diabetes mellitus (disorder)	51	403190006	First degree burn	1095	12	79	0	12	79	1004	0.00000	-0.02935	0.00000	0.00000	0.00000	1.0000000000	1.0000000000	0.86575	-0.89976	7	43	0	5	36	0	0.00000	0.00000
97	403192003	Third degree burn	51	403190006	First degree burn	1095	8	79	1	7	78	1009	1.73259	0.01753	1.84799	15.21088	0.22451	0.4517620517	1.0000000000	0.57717	0.34266	3	43	0	5	36	1	-3.61092	-1.79176
96	283371005	Laceration of forearm	51	403190006	First degree burn	1095	75	79	7	68	72	948	1.29367	0.02221	1.35539	3.05916	0.60052	0.4841412245	1.0000000000	5.41096	0.31946	39	43	3	36	36	4	0.42744	0.33647
95	84757009	Epilepsy	51	403190006	First degree burn	1095	30	79	2	28	77	988	0.92405	-0.00355	0.91651	3.91961	0.21431	1.0000000000	1.0000000000	2.16438	-0.07696	13	43	2	17	36	0	3.11352	2.01490
94	703151001	History of single seizure (situation)	51	403190006	First degree burn	1095	39	79	3	36	76	980	1.06621	0.00355	1.07456	3.57014	0.32343	0.7563882304	1.0000000000	2.81370	0.06881	14	43	2	25	36	1	-0.49740	-1.17865
93	128613002	Seizure disorder	51	403190006	First degree burn	1095	39	79	3	36	76	980	1.06621	0.00355	1.07456	3.57014	0.32343	0.7563882304	1.0000000000	2.81370	0.06881	14	43	2	25	36	1	-0.49740	-1.17865
92	82423001	Chronic pain	51	403190006	First degree burn	1095	52	79	3	49	76	967	0.79966	-0.01247	0.77900	2.55774	0.23726	1.0000000000	1.0000000000	3.75160	-0.24841	24	43	2	28	36	1	-0.49740	-0.80235
91	64859006	Osteoporosis (disorder)	51	403190006	First degree burn	1095	37	79	7	30	72	986	2.62231	0.08460	3.19537	7.52693	1.35651	0.0136805918	0.1915282853	2.66941	1.12445	24	43	4	13	36	3	-0.10110	0.27193
89	47693006	Rupture of appendix	51	403190006	First degree burn	1095	20	79	3	17	76	999	2.07911	0.04104	2.31966	8.09106	0.66503	0.1701305727	0.7972585288	1.44292	0.71139	10	43	2	10	36	1	-0.49740	-0.60614
88	197927001	Recurrent urinary tract infection	51	403190006	First degree burn	1095	8	79	1	7	78	1009	1.73259	0.01753	1.84799	15.21088	0.22451	0.4517620517	1.0000000000	0.57717	0.34266	8	43	1	0	36	0	3.78419	2.19722
86	713197008	Recurrent rectal polyp	51	403190006	First degree burn	1095	22	79	2	20	77	996	1.26007	0.01038	1.29351	5.63659	0.29684	0.6692076941	1.0000000000	1.58721	0.21356	12	43	1	10	36	1	0.17327	0.16705
85	241929008	Acute allergic reaction	51	403190006	First degree burn	1095	47	79	0	47	79	969	0.00000	-0.05905	0.00000	0.00000	0.00000	0.0433600188	0.3987203055	3.39087	-2.13451	25	43	0	22	36	0	0.00000	0.00000
84	232353008	Perennial allergic rhinitis with seasonal variation	51	403190006	First degree burn	1095	29	79	2	27	77	989	0.95591	-0.00203	0.95142	4.07600	0.22208	1.0000000000	1.0000000000	2.09224	-0.04369	14	43	1	15	36	1	0.17327	-0.06454
83	110030002	Concussion injury of brain	51	403190006	First degree burn	1095	7	79	0	7	79	1009	0.00000	-0.02237	0.00000	0.00000	0.00000	1.0000000000	1.0000000000	0.50502	-0.58979	1	43	0	6	36	0	0.00000	0.00000
82	94260004	Secondary malignant neoplasm of colon	51	403190006	First degree burn	1095	4	79	0	4	79	1012	0.00000	-0.01688	0.00000	0.00000	0.00000	1.0000000000	1.0000000000	0.28858	-0.36579	2	43	0	2	36	0	0.00000	0.00000
81	236077008	Protracted diarrhea	51	403190006	First degree burn	1095	4	79	0	4	79	1012	0.00000	-0.01688	0.00000	0.00000	0.00000	1.0000000000	1.0000000000	0.28858	-0.36579	2	43	0	2	36	0	0.00000	0.00000
80	6072007	Bleeding from anus	51	403190006	First degree burn	1095	4	79	0	4	79	1012	0.00000	-0.01688	0.00000	0.00000	0.00000	1.0000000000	1.0000000000	0.28858	-0.36579	2	43	0	2	36	0	0.00000	0.00000
79	45816000	Pyelonephritis	51	403190006	First degree burn	1095	1	79	0	1	79	1015	0.00000	-0.00843	0.00000	0.00000	0.00000	1.0000000000	1.0000000000	0.07215	-0.10050	1	43	0	0	36	0	0.00000	0.00000
78	239872002	Osteoarthritis of hip	51	403190006	First degree burn	1095	21	79	3	18	76	998	1.98011	0.03822	2.18860	7.59558	0.63062	0.1887253461	0.8197086037	1.51507	0.66940	13	43	2	8	36	1	-0.49740	-0.18232
77	422034002	Diabetic retinopathy associated with type II diabetes mellitus (disorder)	51	403190006	First degree burn	1095	20	79	1	19	78	997	0.69304	-0.01168	0.67274	5.09188	0.08888	1.0000000000	1.0000000000	1.44292	-0.28861	8	43	0	12	36	1	-3.61092	-2.56495
76	127013003	Diabetic renal disease (disorder)	51	403190006	First degree burn	1095	28	79	2	26	77	990	0.99005	-0.00045	0.98901	4.24502	0.23042	1.0000000000	1.0000000000	2.02009	-0.00963	10	43	1	18	36	1	0.17327	-0.54654
75	431855005	Chronic kidney disease stage 1 (disorder)	51	403190006	First degree burn	1095	28	79	2	26	77	990	0.99005	-0.00045	0.98901	4.24502	0.23042	1.0000000000	1.0000000000	2.02009	-0.00963	10	43	1	18	36	1	0.17327	-0.54654
73	196416002	Impacted molars	51	403190006	First degree burn	1095	49	79	4	45	75	971	1.13149	0.00794	1.15081	3.28614	0.40302	0.7752467518	1.0000000000	3.53516	0.14077	25	43	2	24	36	2	0.16908	0.03774
72	35999006	Blighted ovum	51	403190006	First degree burn	1095	53	79	3	50	76	966	0.78457	-0.01355	0.76263	2.50235	0.23242	1.0000000000	1.0000000000	3.82374	-0.27015	53	43	3	0	36	0	2.73003	2.92674
71	201834006	Localized  primary osteoarthritis of the hand	51	403190006	First degree burn	1095	28	79	2	26	77	990	0.99005	-0.00045	0.98901	4.24502	0.23042	1.0000000000	1.0000000000	2.02009	-0.00963	19	43	2	9	36	0	3.11352	2.35138
70	87433001	Pulmonary emphysema (disorder)	51	403190006	First degree burn	1095	17	79	2	15	77	1001	1.63068	0.02208	1.73333	7.71797	0.38928	0.3503388884	1.0000000000	1.22648	0.43020	9	43	1	8	36	1	0.17327	0.10536
69	233604007	Pneumonia	51	403190006	First degree burn	1095	7	79	2	5	77	1011	3.96022	0.06621	5.25195	27.51452	1.00249	0.0851615132	0.5765898706	0.50502	0.99518	3	43	1	4	36	1	0.17327	-0.22314
68	26929004	Alzheimer's disease (disorder)	51	403190006	First degree burn	1095	23	79	3	20	76	996	1.80793	0.03300	1.96579	6.76389	0.57132	0.2273427266	0.8856025459	1.65936	0.58892	15	43	2	8	36	1	-0.49740	-0.05716
67	403191005	Second degree burn	51	403190006	First degree burn	1095	49	79	9	40	70	976	2.54585	0.09330	3.13714	6.72608	1.46321	0.0063855020	0.1099057573	3.53516	1.14077	23	43	5	26	36	4	-0.04082	-0.29214
65	239873007	Osteoarthritis of knee	51	403190006	First degree burn	1095	57	79	11	46	68	970	2.67488	0.10944	3.41113	6.88479	1.69007	0.0016550744	0.0368737127	4.11233	1.23098	30	43	7	27	36	4	-0.33647	-0.38269
64	444448004	Injury of medial collateral ligament of knee	51	403190006	First degree burn	1095	32	79	1	31	78	985	0.43315	-0.02742	0.40736	3.02398	0.05488	0.7235420724	1.0000000000	2.30868	-0.72625	17	43	0	15	36	1	-3.61092	-2.77259
63	68496003	Polyp of colon	51	403190006	First degree burn	1095	91	79	10	81	69	935	1.52316	0.04392	1.67293	3.37212	0.82995	0.1414494986	0.7399545286	6.56530	0.54003	43	43	7	48	36	3	-0.59884	-0.86710
62	185086009	Chronic obstructive bronchitis (disorder)	51	403190006	First degree burn	1095	6	79	0	6	79	1010	0.00000	-0.02070	0.00000	0.00000	0.00000	1.0000000000	1.0000000000	0.43288	-0.51891	4	43	0	2	36	0	0.00000	0.00000
61	198992004	Antepartum eclampsia	51	403190006	First degree burn	1095	96	79	9	87	70	929	1.29945	0.02588	1.37291	2.84323	0.66293	0.4061908868	1.0000000000	6.92603	0.33533	96	43	9	0	36	0	1.75402	2.45674
60	301011002	Escherichia coli urinary tract infection	51	403190006	First degree burn	1095	92	79	9	83	70	933	1.35594	0.03006	1.44527	2.99742	0.69687	0.2952669744	0.9832524664	6.63744	0.38884	85	43	9	7	36	0	1.75402	2.34607
59	262574004	Bullet wound	51	403190006	First degree burn	1095	20	79	2	18	77	998	1.38608	0.01468	1.44012	6.32098	0.32810	0.6503601194	1.0000000000	1.44292	0.29635	9	43	2	11	36	0	3.11352	1.70475
58	239720000	Tear of meniscus of knee	51	403190006	First degree burn	1095	20	79	1	19	78	997	0.69304	-0.01168	0.67274	5.09188	0.08888	1.0000000000	1.0000000000	1.44292	-0.28861	10	43	1	10	36	0	3.78419	2.39790
57	192127007	Child attention deficit disorder	51	403190006	First degree burn	1095	76	79	6	70	73	946	1.09427	0.00718	1.11076	2.64353	0.46672	0.8170921353	1.0000000000	5.48311	0.11067	24	43	4	52	36	2	-0.48059	-1.34993
56	92691004	Carcinoma in situ of prostate (disorder)	51	403190006	First degree burn	1095	23	79	3	20	76	996	1.80793	0.03300	1.96579	6.76389	0.57132	0.2273427266	0.8856025459	1.65936	0.58892	0	43	0	23	36	3	-2.56495	-2.15948
55	126906006	Neoplasm of prostate	51	403190006	First degree burn	1095	24	79	3	21	76	995	1.73259	0.03058	1.87030	6.41154	0.54558	0.2472056909	0.9133257124	1.73151	0.55030	0	43	0	24	36	3	-2.56495	-2.19722
54	5602001	Opioid abuse (disorder)	51	403190006	First degree burn	1095	7	79	1	6	78	1010	1.98011	0.02192	2.15812	18.15119	0.25659	0.4088375741	1.0000000000	0.50502	0.41021	0	43	0	7	36	1	-3.61092	-2.07944
53	7200002	Alcoholism	51	403190006	First degree burn	1095	5	79	1	4	78	1012	2.77215	0.03347	3.24359	29.37253	0.35819	0.3127912652	1.0000000000	0.36073	0.55562	0	43	0	5	36	1	-3.61092	-1.79176
52	124171000119105	Chronic intractable migraine without aura	51	403190006	First degree burn	1095	51	79	4	47	75	969	1.08712	0.00537	1.09957	3.13440	0.38574	0.7815487176	1.0000000000	3.67945	0.09559	21	43	1	30	36	3	1.21924	0.69315
50	446096008	Perennial allergic rhinitis	51	403190006	First degree burn	1095	26	79	0	26	79	990	0.00000	-0.04349	0.00000	0.00000	0.00000	0.2508997701	0.9133257124	1.87580	-1.52396	14	43	0	12	36	0	0.00000	0.00000
49	88805009	Chronic congestive heart failure (disorder)	51	403190006	First degree burn	1095	10	79	2	8	77	1008	2.77215	0.04744	3.27273	15.67937	0.68311	0.1587630630	0.7768414475	0.72146	0.80133	5	43	1	5	36	1	0.17327	0.00000
48	55680006	Drug overdose	51	403190006	First degree burn	1095	50	79	4	46	75	970	1.10886	0.00664	1.12464	3.20855	0.39420	0.7782732082	1.0000000000	3.60731	0.11800	24	43	2	26	36	2	0.16908	-0.07411
47	359817006	Closed fracture of hip	51	403190006	First degree burn	1095	29	79	3	26	76	990	1.43387	0.01995	1.50304	5.07910	0.44479	0.4598667677	1.0000000000	2.09224	0.37135	11	43	1	18	36	2	0.83975	0.18232
46	62564004	Concussion with loss of consciousness	51	403190006	First degree burn	1095	67	79	8	59	71	957	1.65502	0.04663	1.82764	3.97420	0.84049	0.1387770718	0.7312035629	4.83379	0.62549	36	43	3	31	36	5	0.62589	0.59087
45	263102004	Fracture subluxation of wrist	51	403190006	First degree burn	1095	109	79	8	101	71	915	1.01730	0.00160	1.02078	2.18116	0.47772	1.0000000000	1.0000000000	7.86393	0.02198	51	43	2	58	36	6	1.16761	0.91002
44	58150001	Fracture of clavicle	51	403190006	First degree burn	1095	112	79	7	105	72	911	0.86630	-0.01258	0.84352	1.88073	0.37832	0.8472948607	1.0000000000	8.08037	-0.18275	55	43	4	57	36	3	-0.10110	-0.30449
43	307731004	Injury of tendon of the rotator cuff of shoulder	51	403190006	First degree burn	1095	51	79	4	47	75	969	1.08712	0.00537	1.09957	3.13440	0.38574	0.7815487176	1.0000000000	3.67945	0.09559	26	43	2	25	36	2	0.16908	0.03637
42	16114001	Fracture of ankle	51	403190006	First degree burn	1095	108	79	14	94	65	922	1.79677	0.07349	2.11260	3.90854	1.14188	0.0282966730	0.3104262714	7.79178	0.77074	48	43	8	60	36	6	-0.09353	-0.45199
41	283385000	Laceration of thigh	51	403190006	First degree burn	1095	105	79	14	91	65	925	1.84810	0.07702	2.18935	4.05491	1.18208	0.0165077953	0.2190854429	7.57534	0.80670	50	43	9	55	36	5	-0.35012	-0.60459
40	428251008	History of appendectomy	51	403190006	First degree burn	1095	51	79	4	47	75	969	1.08712	0.00537	1.09957	3.13440	0.38574	0.7815487176	1.0000000000	3.67945	0.09559	27	43	3	24	36	1	-0.88089	-0.91629
39	74400008	Appendicitis	51	403190006	First degree burn	1095	51	79	4	47	75	969	1.08712	0.00537	1.09957	3.13440	0.38574	0.7815487176	1.0000000000	3.67945	0.09559	27	43	3	24	36	1	-0.88089	-0.91629
38	398254007	Preeclampsia	51	403190006	First degree burn	1095	101	79	11	90	68	926	1.50959	0.04530	1.66438	3.26144	0.84937	0.1542272864	0.7722801598	7.28676	0.53415	101	43	11	0	36	0	1.59109	2.32060
37	38822007	Cystitis	51	403190006	First degree burn	1095	71	79	5	66	74	950	0.97611	-0.00175	0.97256	2.48823	0.38014	1.0000000000	1.0000000000	5.12237	-0.02913	68	43	4	3	36	1	-1.14706	1.50408
35	19169002	Miscarriage in first trimester	51	403190006	First degree burn	1095	174	79	23	151	56	865	1.83217	0.10086	2.35277	3.93873	1.40541	0.0020286995	0.0437541138	12.55342	0.82438	174	43	23	0	36	0	1.05416	2.14771
33	429007001	History of cardiac arrest (situation)	51	403190006	First degree burn	1095	42	79	2	40	77	976	0.66004	-0.01893	0.63377	2.67214	0.15031	0.7630388059	1.0000000000	3.03014	-0.42587	24	43	1	18	36	1	0.17327	0.27444
32	410429000	Cardiac Arrest	51	403190006	First degree burn	1095	42	79	2	40	77	976	0.66004	-0.01893	0.63377	2.67214	0.15031	0.7630388059	1.0000000000	3.03014	-0.42587	24	43	1	18	36	1	0.17327	0.27444
31	230690007	Stroke	51	403190006	First degree burn	1095	62	79	10	52	69	964	2.23561	0.08441	2.68673	5.51695	1.30843	0.0104952334	0.1594859701	4.47306	1.00708	32	43	9	30	36	1	-1.85690	-1.91764
30	399211009	History of myocardial infarction (situation)	51	403190006	First degree burn	1095	31	79	2	29	77	987	0.89424	-0.00503	0.88401	3.77447	0.20704	1.0000000000	1.0000000000	2.23653	-0.10949	2	43	0	29	36	2	-2.94444	-2.74084
29	22298006	Myocardial Infarction	51	403190006	First degree burn	1095	31	79	2	29	77	987	0.89424	-0.00503	0.88401	3.77447	0.20704	1.0000000000	1.0000000000	2.23653	-0.10949	2	43	0	29	36	2	-2.94444	-2.74084
28	53741008	Coronary Heart Disease	51	403190006	First degree burn	1095	80	79	6	74	73	942	1.03956	0.00310	1.04628	2.48583	0.44038	0.8240390810	1.0000000000	5.77169	0.04784	24	43	2	56	36	4	0.81093	-0.14310
27	408512008	Body mass index 40+ - severely obese (finding)	51	403190006	First degree burn	1095	97	79	9	88	70	928	1.28605	0.02487	1.35584	2.80693	0.65492	0.4094853709	1.0000000000	6.99817	0.32226	67	43	6	30	36	3	-0.46489	0.10080
26	33737001	Fracture of rib	51	403190006	First degree burn	1095	54	79	3	51	76	965	0.77004	-0.01460	0.74690	2.44919	0.22778	0.7919994930	1.0000000000	3.89589	-0.29157	32	43	1	22	36	2	0.83975	1.01160
25	284551006	Laceration of foot	51	403190006	First degree burn	1095	118	79	11	107	68	909	1.29210	0.02831	1.37424	2.67947	0.70482	0.3459920010	1.0000000000	8.51324	0.33503	53	43	5	65	36	6	0.31585	-0.01992
24	162864005	Body mass index 30+ - obesity (finding)	51	403190006	First degree burn	1095	439	79	41	398	38	618	1.29451	0.06718	1.67535	2.65115	1.05871	0.0315727480	0.3275952503	31.67215	0.36233	226	43	25	213	36	16	-0.17802	-0.35456
23	36971009	Sinusitis (disorder)	51	403190006	First degree burn	1095	190	79	15	175	64	841	1.09427	0.01204	1.12634	2.02249	0.62727	0.6461926824	1.0000000000	13.70776	0.12149	84	43	10	106	36	5	-0.43643	-0.85938
22	70704007	Sprain of wrist	51	403190006	First degree burn	1095	195	79	20	175	59	841	1.42162	0.05472	1.62906	2.77496	0.95635	0.0913202656	0.5996557347	14.06849	0.47885	90	43	13	105	36	7	-0.35489	-0.70281
21	15777000	Prediabetes	51	403190006	First degree burn	1095	333	79	32	301	47	715	1.33196	0.06119	1.61730	2.58496	1.01188	0.0560282550	0.4598658412	24.02466	0.39912	159	43	20	174	36	12	-0.23889	-0.54919
20	80394007	Hyperglycemia (disorder)	51	403190006	First degree burn	1095	55	79	6	49	73	967	1.51208	0.03284	1.62203	3.91241	0.67247	0.2796232527	0.9574808819	3.96804	0.49468	23	43	2	32	36	4	0.81093	0.32850
19	237602007	Metabolic syndrome X (disorder)	51	403190006	First degree burn	1095	64	79	6	58	73	958	1.29945	0.02080	1.35758	3.25199	0.56674	0.4547436139	1.0000000000	4.61735	0.31746	28	43	2	36	36	4	0.81093	0.40547
18	302870006	Hypertriglyceridemia (disorder)	51	403190006	First degree burn	1095	64	79	6	58	73	958	1.29945	0.02080	1.35758	3.25199	0.56674	0.4547436139	1.0000000000	4.61735	0.31746	28	43	2	36	36	4	0.81093	0.40547
17	368581000119106	Neuropathy due to type 2 diabetes mellitus (disorder)	51	403190006	First degree burn	1095	28	79	2	26	77	990	0.99005	-0.00045	0.98901	4.24502	0.23042	1.0000000000	1.0000000000	2.02009	-0.00963	7	43	0	21	36	2	-2.94444	-2.44235
16	44054006	Diabetes	51	403190006	First degree burn	1095	68	79	6	62	73	954	1.22301	0.01600	1.26469	3.02210	0.52925	0.6251309379	1.0000000000	4.90594	0.24519	29	43	2	39	36	4	0.81093	0.36593
15	40055000	Chronic sinusitis (disorder)	51	403190006	First degree burn	1095	216	79	23	193	56	823	1.47591	0.06579	1.75139	2.91683	1.05161	0.0388487583	0.3751533558	15.58356	0.53328	104	43	14	112	36	9	-0.20544	-0.46694
14	10509002	Acute bronchitis (disorder)	51	403190006	First degree burn	1095	863	79	70	793	9	223	1.12428	0.06684	2.18719	4.44773	1.07556	0.0309784508	0.3255611102	62.26210	0.16648	418	43	40	445	36	30	-0.05850	-0.32413
13	370247008	Facial laceration	51	403190006	First degree burn	1095	109	79	12	97	67	919	1.52596	0.04876	1.69688	3.24729	0.88671	0.1171729264	0.6784590683	7.86393	0.55249	55	43	7	54	36	5	-0.13802	-0.28688
12	65966004	Fracture of forearm	51	403190006	First degree burn	1095	123	79	11	112	68	904	1.23958	0.02376	1.30567	2.54276	0.67044	0.4575488918	1.0000000000	8.87397	0.28133	55	43	7	68	36	4	-0.33647	-0.70915
11	38341003	Hypertension	51	403190006	First degree burn	1095	278	79	24	254	55	762	1.19661	0.03198	1.30909	2.15848	0.79395	0.2855165903	0.9661775750	20.05662	0.24765	131	43	10	147	36	14	0.39474	0.20383
10	62106007	Concussion with no loss of consciousness	51	403190006	First degree burn	1095	206	79	12	194	67	822	0.80742	-0.02585	0.75889	1.43058	0.40257	0.4567277092	1.0000000000	14.86210	-0.28707	96	43	4	110	36	8	0.75911	0.52763
9	44465007	Sprain of ankle	51	403190006	First degree burn	1095	362	79	29	333	50	683	1.11039	0.02163	1.18961	1.91458	0.73916	0.4597610919	1.0000000000	26.11689	0.14577	185	43	12	177	36	17	0.38535	0.36365
8	233678006	Childhood asthma	51	403190006	First degree burn	1095	45	79	1	44	78	972	0.30802	-0.03995	0.28322	2.08329	0.03850	0.2476303887	0.9133257124	3.24658	-1.08630	25	43	1	20	36	0	3.78419	3.25810
7	75498004	Acute bacterial sinusitis (disorder)	51	403190006	First degree burn	1095	187	79	16	171	63	845	1.18595	0.02353	1.25499	2.22534	0.70776	0.4382333920	1.0000000000	13.49132	0.23035	89	43	10	98	36	6	-0.27820	-0.56010
6	39848009	Whiplash injury to neck	51	403190006	First degree burn	1095	182	79	17	165	62	851	1.29469	0.03669	1.41417	2.48045	0.80626	0.2130794255	0.8671354646	13.13059	0.34917	92	43	10	90	36	7	-0.14758	-0.30641
5	284549007	Laceration of hand	51	403190006	First degree burn	1095	104	79	8	96	71	920	1.06621	0.00598	1.07981	2.31027	0.50470	0.8416463587	1.0000000000	7.50320	0.08192	54	43	6	50	36	2	-0.84438	-0.95551
4	195662009	Acute viral pharyngitis (disorder)	51	403190006	First degree burn	1095	890	79	69	821	10	195	1.07460	0.04334	1.63886	3.23918	0.82918	0.1782199101	0.8051220167	64.21005	0.10226	430	43	36	460	36	33	0.04833	-0.14333
3	65363002	Otitis media	51	403190006	First degree burn	1095	580	79	38	542	41	474	0.90812	-0.02719	0.81055	1.28170	0.51259	0.4131328045	1.0000000000	41.84475	-0.13564	277	43	17	303	36	21	0.26260	0.11415
115	36923009	Major depression  single episode	25	284551006	Laceration of foot	1095	6	118	2	4	116	973	3.09322	0.05400	4.19397	23.14805	0.75986	0.1294282185	0.7077283894	0.64658	0.86549	3	53	0	3	65	2	-3.51155	-0.91629
1	444814009	Viral sinusitis (disorder)	51	403190006	First degree burn	1095	993	79	77	916	2	100	1.07480	0.06508	4.20306	17.36916	1.01707	0.0263629893	0.2963541316	71.64110	0.10269	478	43	42	515	36	35	-0.00235	-0.23841
113	443165006	Pathological fracture due to osteoporosis (disorder)	25	284551006	Laceration of foot	1095	10	118	1	9	117	968	0.92797	-0.00240	0.91928	7.32071	0.11544	1.0000000000	1.0000000000	1.07763	-0.05494	7	53	1	3	65	0	3.98898	2.07944
112	49436004	Atrial Fibrillation	25	284551006	Laceration of foot	1095	35	118	6	29	112	948	1.59080	0.03731	1.75123	4.30987	0.71158	0.2593569001	0.9243340923	3.77169	0.55285	9	53	3	26	65	3	-0.19416	-0.88239
111	235919008	Cholelithiasis	25	284551006	Laceration of foot	1095	9	118	4	5	114	972	4.12429	0.09884	6.82105	25.76559	1.80577	0.0105197513	0.1594859701	0.96986	1.34383	7	53	3	2	65	1	-1.26292	0.10536
110	65275009	Acute Cholecystitis	25	284551006	Laceration of foot	1095	9	118	4	5	114	972	4.12429	0.09884	6.82105	25.76559	1.80577	0.0105197513	0.1594859701	0.96986	1.34383	7	53	3	2	65	1	-1.26292	0.10536
109	90560007	Gout	25	284551006	Laceration of foot	1095	4	118	0	4	118	973	0.00000	-0.02104	0.00000	0.00000	0.00000	1.0000000000	1.0000000000	0.43105	-0.51707	0	53	0	4	65	0	0.00000	0.00000
108	40930008	Hypothyroidism (disorder)	25	284551006	Laceration of foot	1095	13	118	3	10	115	967	2.14146	0.04348	2.52261	9.29899	0.68433	0.1568357634	0.7751713578	1.40091	0.73642	11	53	2	2	65	1	-0.87547	0.77319
107	40275004	Contact dermatitis	25	284551006	Laceration of foot	1095	18	118	3	15	115	962	1.54661	0.02456	1.67304	5.86633	0.47714	0.4316017004	1.0000000000	1.93973	0.44432	9	53	1	9	65	2	0.47744	0.59784
106	24079001	Atopic dermatitis	25	284551006	Laceration of foot	1095	20	118	1	19	117	958	0.46398	-0.02541	0.43095	3.24871	0.05717	0.7142221573	1.0000000000	2.15525	-0.65775	13	53	0	7	65	1	-4.18965	-2.07944
105	363406005	Malignant tumor of colon	25	284551006	Laceration of foot	1095	6	118	1	5	117	972	1.54661	0.01410	1.66154	14.34396	0.19246	0.4963120407	1.0000000000	0.64658	0.28053	4	53	1	2	65	0	3.98898	1.60944
104	367498001	Seasonal allergic rhinitis	25	284551006	Laceration of foot	1095	20	118	2	18	116	959	0.92797	-0.00341	0.91858	4.00923	0.21046	1.0000000000	1.0000000000	2.15525	-0.07279	9	53	1	11	65	1	-0.20067	-0.18232
103	157141000119108	Proteinuria due to type 2 diabetes mellitus (disorder)	25	284551006	Laceration of foot	1095	3	118	0	3	118	974	0.00000	-0.01822	0.00000	0.00000	0.00000	1.0000000000	1.0000000000	0.32329	-0.40413	1	53	0	2	65	0	0.00000	0.00000
102	90781000119102	Microalbuminuria due to type 2 diabetes mellitus (disorder)	25	284551006	Laceration of foot	1095	6	118	1	5	117	972	1.54661	0.01410	1.66154	14.34396	0.19246	0.4963120407	1.0000000000	0.64658	0.28053	3	53	1	3	65	0	3.98898	1.38629
101	433144002	Chronic kidney disease stage 3 (disorder)	25	284551006	Laceration of foot	1095	3	118	0	3	118	974	0.00000	-0.01822	0.00000	0.00000	0.00000	1.0000000000	1.0000000000	0.32329	-0.40413	1	53	0	2	65	0	0.00000	0.00000
100	161622006	History of lower limb amputation (situation)	25	284551006	Laceration of foot	1095	1	118	0	1	118	976	0.00000	-0.01051	0.00000	0.00000	0.00000	1.0000000000	1.0000000000	0.10776	-0.14765	0	53	0	1	65	0	0.00000	0.00000
99	30832001	Rupture of patellar tendon	25	284551006	Laceration of foot	1095	23	118	1	22	117	955	0.40346	-0.03037	0.37102	2.77787	0.04955	0.5007765753	1.0000000000	2.47854	-0.79848	14	53	1	9	65	0	3.98898	2.70805
98	1551000119108	Nonproliferative diabetic retinopathy due to type 2 diabetes mellitus (disorder)	25	284551006	Laceration of foot	1095	12	118	2	10	116	967	1.54661	0.02000	1.66724	7.70231	0.36089	0.3769186760	1.0000000000	1.29315	0.38763	7	53	2	5	65	0	3.31419	1.50408
97	403192003	Third degree burn	25	284551006	Laceration of foot	1095	8	118	0	8	118	969	0.00000	-0.02981	0.00000	0.00000	0.00000	1.0000000000	1.0000000000	0.86210	-0.89693	3	53	0	5	65	0	0.00000	0.00000
96	283371005	Laceration of forearm	25	284551006	Laceration of foot	1095	75	118	8	67	110	910	0.98983	-0.00096	0.98779	2.11086	0.46224	1.0000000000	1.0000000000	8.08219	-0.01312	39	53	3	36	65	5	0.28768	0.53492
95	84757009	Epilepsy	25	284551006	Laceration of foot	1095	30	118	1	29	117	948	0.30932	-0.04029	0.27940	2.07008	0.03771	0.2416981666	0.9105752038	3.23288	-1.08164	13	53	1	17	65	0	3.98898	2.63906
94	703151001	History of single seizure (situation)	25	284551006	Laceration of foot	1095	39	118	1	38	117	939	0.23794	-0.05090	0.21120	1.55258	0.02873	0.1136023895	0.6648011833	4.20274	-1.37927	14	53	1	25	65	0	3.98898	2.70805
93	128613002	Seizure disorder	25	284551006	Laceration of foot	1095	39	118	1	38	117	939	0.23794	-0.05090	0.21120	1.55258	0.02873	0.1136023895	0.6648011833	4.20274	-1.37927	14	53	1	25	65	0	3.98898	2.70805
92	82423001	Chronic pain	25	284551006	Laceration of foot	1095	52	118	5	47	113	930	0.89228	-0.00836	0.87554	2.24680	0.34118	1.0000000000	1.0000000000	5.60365	-0.13830	24	53	3	28	65	2	-0.58481	-0.51083
91	64859006	Osteoporosis (disorder)	25	284551006	Laceration of foot	1095	37	118	6	31	112	946	1.50481	0.03281	1.63479	4.00423	0.66743	0.2773188387	0.9538811780	3.98721	0.48912	24	53	5	13	65	1	-1.73865	-0.88120
89	47693006	Rupture of appendix	25	284551006	Laceration of foot	1095	20	118	3	17	115	960	1.39195	0.01858	1.47315	5.10348	0.42523	0.4676536003	1.0000000000	2.15525	0.34225	10	53	1	10	65	2	0.47744	0.60614
88	197927001	Recurrent urinary tract infection	25	284551006	Laceration of foot	1095	8	118	0	8	118	969	0.00000	-0.02981	0.00000	0.00000	0.00000	1.0000000000	1.0000000000	0.86210	-0.89693	8	53	0	0	65	0	0.00000	0.00000
86	713197008	Recurrent rectal polyp	25	284551006	Laceration of foot	1095	22	118	7	15	111	962	2.95262	0.09717	4.04444	10.13258	1.61435	0.0060751869	0.1051834127	2.37078	1.24692	12	53	5	10	65	2	-1.06054	-0.56798
85	241929008	Acute allergic reaction	25	284551006	Laceration of foot	1095	47	118	4	43	114	934	0.78976	-0.01547	0.76214	2.16238	0.26862	0.8104515534	1.0000000000	5.06484	-0.27854	25	53	1	22	65	3	0.86809	1.13783
84	232353008	Perennial allergic rhinitis with seasonal variation	25	284551006	Laceration of foot	1095	29	118	6	23	112	954	1.91993	0.05273	2.22205	5.57332	0.88592	0.1174365669	0.6795373660	3.12511	0.76292	14	53	3	15	65	3	-0.19416	-0.05716
83	110030002	Concussion injury of brain	25	284551006	Laceration of foot	1095	7	118	0	7	118	970	0.00000	-0.02788	0.00000	0.00000	0.00000	1.0000000000	1.0000000000	0.75434	-0.81093	1	53	0	6	65	0	0.00000	0.00000
82	94260004	Secondary malignant neoplasm of colon	25	284551006	Laceration of foot	1095	4	118	0	4	118	973	0.00000	-0.02104	0.00000	0.00000	0.00000	1.0000000000	1.0000000000	0.43105	-0.51707	2	53	0	2	65	0	0.00000	0.00000
81	236077008	Protracted diarrhea	25	284551006	Laceration of foot	1095	4	118	0	4	118	973	0.00000	-0.02104	0.00000	0.00000	0.00000	1.0000000000	1.0000000000	0.43105	-0.51707	2	53	0	2	65	0	0.00000	0.00000
80	6072007	Bleeding from anus	25	284551006	Laceration of foot	1095	4	118	0	4	118	973	0.00000	-0.02104	0.00000	0.00000	0.00000	1.0000000000	1.0000000000	0.43105	-0.51707	2	53	0	2	65	0	0.00000	0.00000
79	45816000	Pyelonephritis	25	284551006	Laceration of foot	1095	1	118	0	1	118	976	0.00000	-0.01051	0.00000	0.00000	0.00000	1.0000000000	1.0000000000	0.10776	-0.14765	1	53	0	0	65	0	0.00000	0.00000
78	239872002	Osteoarthritis of hip	25	284551006	Laceration of foot	1095	21	118	4	17	114	960	1.76755	0.03730	1.98142	5.99051	0.65538	0.2716424260	0.9443474120	2.26301	0.61572	13	53	3	8	65	1	-1.26292	-0.52325
77	422034002	Diabetic retinopathy associated with type II diabetes mellitus (disorder)	25	284551006	Laceration of foot	1095	20	118	3	17	115	960	1.39195	0.01858	1.47315	5.10348	0.42523	0.4676536003	1.0000000000	2.15525	0.34225	8	53	2	12	65	1	-0.87547	-0.95551
76	127013003	Diabetic renal disease (disorder)	25	284551006	Laceration of foot	1095	28	118	5	23	113	954	1.65708	0.03699	1.83532	4.92241	0.68430	0.2146455887	0.8672161313	3.01735	0.57872	10	53	2	18	65	3	0.19329	-0.15415
75	431855005	Chronic kidney disease stage 1 (disorder)	25	284551006	Laceration of foot	1095	28	118	5	23	113	954	1.65708	0.03699	1.83532	4.92241	0.68430	0.2146455887	0.8672161313	3.01735	0.57872	10	53	2	18	65	3	0.19329	-0.15415
73	196416002	Impacted molars	25	284551006	Laceration of foot	1095	49	118	7	42	111	935	1.32567	0.02450	1.40390	3.20031	0.61586	0.4755377829	1.0000000000	5.28037	0.34915	25	53	4	24	65	3	-0.46414	-0.21622
72	35999006	Blighted ovum	25	284551006	Laceration of foot	1095	53	118	5	48	113	929	0.87544	-0.00976	0.85638	2.19564	0.33402	1.0000000000	1.0000000000	5.71142	-0.16165	53	53	5	0	65	0	2.45101	2.45101
71	201834006	Localized  primary osteoarthritis of the hand	25	284551006	Laceration of foot	1095	28	118	5	23	113	954	1.65708	0.03699	1.83532	4.92241	0.68430	0.2146455887	0.8672161313	3.01735	0.57872	19	53	3	9	65	2	-0.58481	0.28768
70	87433001	Pulmonary emphysema (disorder)	25	284551006	Laceration of foot	1095	17	118	2	15	116	962	1.09172	0.00400	1.10575	4.89617	0.24972	0.7040692281	1.0000000000	1.83196	0.08316	9	53	1	8	65	1	-0.20067	0.10536
69	233604007	Pneumonia	25	284551006	Laceration of foot	1095	7	118	0	7	118	970	0.00000	-0.02788	0.00000	0.00000	0.00000	1.0000000000	1.0000000000	0.75434	-0.81093	3	53	0	4	65	0	0.00000	0.00000
68	26929004	Alzheimer's disease (disorder)	25	284551006	Laceration of foot	1095	23	118	2	21	116	956	0.80693	-0.00983	0.78489	3.39037	0.18171	1.0000000000	1.0000000000	2.47854	-0.21352	15	53	2	8	65	0	3.31419	2.14007
67	403191005	Second degree burn	25	284551006	Laceration of foot	1095	49	118	8	41	110	936	1.51505	0.03874	1.66031	3.63238	0.75891	0.2329227109	0.8937472100	5.28037	0.51908	23	53	3	26	65	5	0.28768	0.33493
65	239873007	Osteoarthritis of knee	25	284551006	Laceration of foot	1095	57	118	7	50	111	927	1.13961	0.01137	1.16919	2.64163	0.51749	0.6616072291	1.0000000000	6.14247	0.16358	30	53	4	27	65	3	-0.46414	-0.16252
64	444448004	Injury of medial collateral ligament of knee	25	284551006	Laceration of foot	1095	32	118	5	27	113	950	1.44995	0.02713	1.55687	4.12325	0.58785	0.3794661424	1.0000000000	3.44840	0.43168	17	53	3	15	65	2	-0.58481	-0.24295
63	68496003	Polyp of colon	25	284551006	Laceration of foot	1095	91	118	14	77	104	900	1.42764	0.04474	1.57343	2.88006	0.85959	0.1558129139	0.7747075658	9.80639	0.47308	43	53	7	48	65	7	-0.18232	-0.09531
62	185086009	Chronic obstructive bronchitis (disorder)	25	284551006	Laceration of foot	1095	6	118	2	4	116	973	3.09322	0.05400	4.19397	23.14805	0.75986	0.1294282185	0.7077283894	0.64658	0.86549	4	53	0	2	65	2	-3.51155	-0.69315
60	301011002	Escherichia coli urinary tract infection	25	284551006	Laceration of foot	1095	92	118	17	75	101	902	1.71472	0.07523	2.02429	3.56244	1.15026	0.0207388061	0.2564017461	9.91416	0.72180	85	53	15	7	65	2	-2.00009	0.39304
59	262574004	Bullet wound	25	284551006	Laceration of foot	1095	20	118	0	20	118	957	0.00000	-0.04740	0.00000	0.00000	0.00000	0.1550915192	0.7747075658	2.15525	-1.65775	9	53	0	11	65	0	0.00000	0.00000
58	239720000	Tear of meniscus of knee	25	284551006	Laceration of foot	1095	20	118	4	16	114	961	1.85593	0.04057	2.10746	6.41222	0.69264	0.2604646643	0.9271528076	2.15525	0.66417	10	53	3	10	65	1	-1.26292	-0.93156
57	192127007	Child attention deficit disorder	25	284551006	Laceration of foot	1095	76	118	8	68	110	909	0.97681	-0.00220	0.97219	2.07639	0.45519	1.0000000000	1.0000000000	8.18995	-0.03013	24	53	1	52	65	7	1.65823	1.08725
56	92691004	Carcinoma in situ of prostate (disorder)	25	284551006	Laceration of foot	1095	23	118	5	18	113	959	2.01732	0.05179	2.35742	6.47129	0.85878	0.0920335797	0.6002633183	2.47854	0.78648	0	53	0	23	65	5	-2.63906	-1.72277
54	5602001	Opioid abuse (disorder)	25	284551006	Laceration of foot	1095	7	118	2	5	116	972	2.65133	0.04603	3.35172	17.47138	0.64300	0.1688454887	0.7953568293	0.75434	0.77404	0	53	0	7	65	2	-3.51155	-1.50408
53	7200002	Alcoholism	25	284551006	Laceration of foot	1095	5	118	2	3	116	974	3.71186	0.06383	5.59770	33.84797	0.92574	0.0926644234	0.6016333641	0.53881	0.96314	0	53	0	5	65	2	-3.51155	-1.25276
52	124171000119105	Chronic intractable migraine without aura	25	284551006	Laceration of foot	1095	51	118	6	45	112	932	1.09172	0.00705	1.10952	2.65919	0.46294	0.8162165694	1.0000000000	5.49589	0.10783	21	53	2	30	65	4	0.46637	0.30228
50	446096008	Perennial allergic rhinitis	25	284551006	Laceration of foot	1095	26	118	1	25	117	952	0.35691	-0.03485	0.32547	2.42419	0.04370	0.3490914712	1.0000000000	2.80183	-0.92669	14	53	0	12	65	1	-4.18965	-2.56495
49	88805009	Chronic congestive heart failure (disorder)	25	284551006	Laceration of foot	1095	10	118	2	8	116	969	1.85593	0.02856	2.08836	9.95215	0.43822	0.2940166757	0.9804462338	1.07763	0.53003	5	53	1	5	65	1	-0.20067	0.00000
47	359817006	Closed fracture of hip	25	284551006	Laceration of foot	1095	29	118	2	27	116	950	0.63998	-0.02064	0.60664	2.58410	0.14241	0.7610851484	1.0000000000	3.12511	-0.45947	11	53	0	18	65	2	-3.51155	-2.30259
46	62564004	Concussion with loss of consciousness	25	284551006	Laceration of foot	1095	67	118	10	57	108	920	1.38502	0.03416	1.49448	3.01227	0.74145	0.3055848889	0.9960728388	7.22009	0.42028	36	53	5	31	65	5	-0.18805	0.13005
45	263102004	Fracture subluxation of wrist	25	284551006	Laceration of foot	1095	109	118	7	102	111	875	0.59594	-0.04669	0.54098	1.19301	0.24531	0.1430929140	0.7404942507	11.74612	-0.67199	51	53	4	58	65	3	-0.46414	-0.39122
44	58150001	Fracture of clavicle	25	284551006	Laceration of foot	1095	112	118	14	98	104	879	1.15996	0.01876	1.20742	2.19069	0.66548	0.5207442932	1.0000000000	12.06941	0.19877	55	53	4	57	65	10	0.64185	0.78914
43	307731004	Injury of tendon of the rotator cuff of shoulder	25	284551006	Laceration of foot	1095	51	118	9	42	109	935	1.63759	0.04897	1.83814	3.87874	0.87110	0.1073423192	0.6449355771	5.49589	0.62240	26	53	4	25	65	5	0.01770	0.22314
42	16114001	Fracture of ankle	25	284551006	Laceration of foot	1095	108	118	13	95	105	882	1.11700	0.01345	1.14947	2.12380	0.62214	0.6251630258	1.0000000000	11.63836	0.14762	48	53	3	60	65	10	0.91184	0.88730
41	283385000	Laceration of thigh	25	284551006	Laceration of foot	1095	105	118	19	86	99	891	1.67918	0.07687	1.98837	3.40689	1.16048	0.0189710617	0.2403001155	11.31507	0.69958	50	53	9	55	65	10	-0.08499	0.00851
40	428251008	History of appendectomy	25	284551006	Laceration of foot	1095	51	118	10	41	108	936	1.81954	0.06295	2.11382	4.34003	1.02954	0.0589058886	0.4704967154	5.49589	0.75990	27	53	5	24	65	5	-0.18805	0.09844
39	74400008	Appendicitis	25	284551006	Laceration of foot	1095	51	118	10	41	108	936	1.81954	0.06295	2.11382	4.34003	1.02954	0.0589058886	0.4704967154	5.49589	0.75990	27	53	5	24	65	5	-0.18805	0.09844
38	398254007	Preeclampsia	25	284551006	Laceration of foot	1095	101	118	14	87	104	890	1.28629	0.03172	1.37710	2.50882	0.75590	0.3108660186	1.0000000000	10.88402	0.33594	101	53	14	0	65	0	1.56564	2.10587
37	38822007	Cystitis	25	284551006	Laceration of foot	1095	71	118	7	64	111	913	0.91490	-0.00779	0.89963	2.01170	0.40232	1.0000000000	1.0000000000	7.65114	-0.11289	68	53	6	3	65	1	-1.90388	1.12601
35	19169002	Miscarriage in first trimester	25	284551006	Laceration of foot	1095	174	118	25	149	93	828	1.33328	0.05034	1.49383	2.40150	0.92922	0.1089390900	0.6492584851	18.75068	0.39661	174	53	25	0	65	0	1.13783	2.07443
33	429007001	History of cardiac arrest (situation)	25	284551006	Laceration of foot	1095	42	118	6	36	112	941	1.32567	0.02260	1.40030	3.39694	0.57724	0.4442768705	1.0000000000	4.52603	0.34111	24	53	4	18	65	2	-0.85479	-0.35667
32	410429000	Cardiac Arrest	25	284551006	Laceration of foot	1095	42	118	6	36	112	941	1.32567	0.02260	1.40030	3.39694	0.57724	0.4442768705	1.0000000000	4.52603	0.34111	24	53	4	18	65	2	-0.85479	-0.35667
31	230690007	Stroke	25	284551006	Laceration of foot	1095	62	118	7	55	111	922	1.04770	0.00406	1.05717	2.37832	0.46991	0.8337084056	1.0000000000	6.68128	0.05865	32	53	4	30	65	3	-0.46414	-0.20067
30	399211009	History of myocardial infarction (situation)	25	284551006	Laceration of foot	1095	31	118	5	26	113	951	1.49672	0.02947	1.61845	4.29837	0.60939	0.3699892089	1.0000000000	3.34064	0.46705	2	53	1	29	65	4	1.14117	-1.01160
29	22298006	Myocardial Infarction	25	284551006	Laceration of foot	1095	31	118	5	26	113	951	1.49672	0.02947	1.61845	4.29837	0.60939	0.3699892089	1.0000000000	3.34064	0.46705	2	53	1	29	65	4	1.14117	-1.01160
28	53741008	Coronary Heart Disease	25	284551006	Laceration of foot	1095	80	118	16	64	102	913	1.85593	0.08351	2.23775	4.01590	1.24692	0.0130714281	0.1844690856	8.62100	0.82128	24	53	7	56	65	9	0.04159	-0.48909
27	408512008	Body mass index 40+ - severely obese (finding)	25	284551006	Laceration of foot	1095	97	118	10	87	108	890	0.95667	-0.00470	0.94721	1.87763	0.47784	1.0000000000	1.0000000000	10.45297	-0.05822	67	53	5	30	65	5	-0.18805	0.72132
26	33737001	Fracture of rib	25	284551006	Laceration of foot	1095	54	118	8	46	110	931	1.37476	0.02966	1.47194	3.19934	0.67720	0.3636823693	1.0000000000	5.81918	0.40033	32	53	4	22	65	4	-0.19106	0.32542
24	162864005	Body mass index 30+ - obesity (finding)	25	284551006	Laceration of foot	1095	439	118	66	373	52	604	1.39512	0.11233	2.05527	3.02246	1.39758	0.0003117120	0.0093705747	47.30776	0.47191	226	53	26	213	65	40	0.14627	0.42682
23	36971009	Sinusitis (disorder)	25	284551006	Laceration of foot	1095	190	118	24	166	94	811	1.17217	0.02742	1.24737	2.01250	0.77314	0.3683130127	1.0000000000	20.47489	0.21928	84	53	9	106	65	15	0.25593	0.24763
22	70704007	Sprain of wrist	25	284551006	Laceration of foot	1095	195	118	24	171	94	806	1.14211	0.02299	1.20343	1.94029	0.74641	0.4456078393	1.0000000000	21.01370	0.18353	90	53	11	105	65	13	-0.03077	0.01149
21	15777000	Prediabetes	25	284551006	Laceration of foot	1095	333	118	58	275	60	702	1.61628	0.14158	2.46764	3.63340	1.67590	0.0000067141	0.0002991680	35.88493	0.67768	159	53	21	174	65	37	0.24549	0.40749
20	80394007	Hyperglycemia (disorder)	25	284551006	Laceration of foot	1095	55	118	7	48	111	929	1.18105	0.01447	1.22053	2.76303	0.53915	0.6534657938	1.0000000000	5.92694	0.20778	23	53	3	32	65	4	0.07893	-0.03774
19	237602007	Metabolic syndrome X (disorder)	25	284551006	Laceration of foot	1095	64	118	7	57	111	920	1.01496	0.00130	1.01786	2.28644	0.45312	1.0000000000	1.0000000000	6.89680	0.01873	28	53	3	36	65	4	0.07893	0.03279
18	302870006	Hypertriglyceridemia (disorder)	25	284551006	Laceration of foot	1095	64	118	7	57	111	920	1.01496	0.00130	1.01786	2.28644	0.45312	1.0000000000	1.0000000000	6.89680	0.01873	28	53	3	36	65	4	0.07893	0.03279
17	368581000119106	Neuropathy due to type 2 diabetes mellitus (disorder)	25	284551006	Laceration of foot	1095	28	118	1	27	117	950	0.33142	-0.03764	0.30073	2.23357	0.04049	0.3515236109	1.0000000000	3.01735	-1.00624	7	53	0	21	65	1	-4.18965	-3.09104
15	40055000	Chronic sinusitis (disorder)	25	284551006	Laceration of foot	1095	216	118	25	191	93	786	1.07403	0.01275	1.10623	1.76820	0.69209	0.7132278869	1.0000000000	23.27671	0.09894	104	53	14	112	65	11	-0.36720	-0.28266
14	10509002	Acute bronchitis (disorder)	25	284551006	Laceration of foot	1095	863	118	102	761	16	216	1.09678	0.06487	1.80946	3.13079	1.04579	0.0317865928	0.3282620135	92.99909	0.13193	418	53	48	445	65	54	-0.04622	0.04936
13	370247008	Facial laceration	25	284551006	Laceration of foot	1095	109	118	16	93	102	884	1.36215	0.04185	1.49104	2.63310	0.84433	0.1907827663	0.8254734124	11.74612	0.41548	55	53	8	54	65	8	-0.17959	0.01600
12	65966004	Fracture of forearm	25	284551006	Laceration of foot	1095	123	118	16	107	102	870	1.20711	0.02560	1.27543	2.24175	0.72564	0.4390806919	1.0000000000	13.25479	0.25409	55	53	9	68	65	7	-0.40085	-0.40992
11	38341003	Hypertension	25	284551006	Laceration of foot	1095	278	118	34	244	84	733	1.13492	0.02735	1.21594	1.85787	0.79581	0.3713375274	1.0000000000	29.95799	0.17704	131	53	14	147	65	20	0.11872	0.21541
10	62106007	Concussion with no loss of consciousness	25	284551006	Laceration of foot	1095	206	118	22	184	96	793	0.99103	-0.00150	0.98766	1.61258	0.60491	1.0000000000	1.0000000000	22.19909	-0.01243	96	53	11	110	65	11	-0.17185	-0.12296
9	44465007	Sprain of ankle	25	284551006	Laceration of foot	1095	362	118	41	321	77	656	1.05101	0.01246	1.08816	1.62619	0.72814	0.6796573391	1.0000000000	39.01005	0.07003	185	53	21	177	65	20	-0.18738	-0.00412
8	233678006	Childhood asthma	25	284551006	Laceration of foot	1095	45	118	8	37	110	940	1.64972	0.04674	1.84767	4.06835	0.83913	0.1367145722	0.7296699408	4.84932	0.62166	25	53	3	20	65	5	0.28768	0.62415
7	75498004	Acute bacterial sinusitis (disorder)	25	284551006	Laceration of foot	1095	187	118	24	163	94	814	1.19097	0.03012	1.27503	2.05800	0.78994	0.3031586057	0.9949586182	20.15160	0.24116	89	53	11	98	65	13	-0.03077	0.06269
6	39848009	Whiplash injury to neck	25	284551006	Laceration of foot	1095	182	118	22	160	96	817	1.12172	0.01889	1.17018	1.91641	0.71453	0.5144442853	1.0000000000	19.61279	0.15809	92	53	10	90	65	12	-0.01835	0.18232
5	284549007	Laceration of hand	25	284551006	Laceration of foot	1095	104	118	12	92	106	885	1.07073	0.00796	1.08901	2.05374	0.57745	0.7410787061	1.0000000000	11.20731	0.09077	54	53	6	50	65	6	-0.18514	0.06899
4	195662009	Acute viral pharyngitis (disorder)	25	284551006	Laceration of foot	1095	890	118	105	785	13	192	1.09479	0.06864	1.97550	3.59055	1.08691	0.0240061037	0.2843799981	95.90868	0.12937	430	53	46	460	65	59	0.02373	0.16241
3	65363002	Otitis media	25	284551006	Laceration of foot	1095	580	118	46	534	72	443	0.73597	-0.09738	0.53001	0.78345	0.35856	0.0016898584	0.0375533602	62.50228	-0.43415	277	53	26	303	65	20	-0.33557	-0.32628
1	444814009	Viral sinusitis (disorder)	25	284551006	Laceration of foot	1095	993	118	117	876	1	101	1.09337	0.10125	13.48973	97.61186	1.86425	0.0001446515	0.0048279512	107.00822	0.12765	478	53	53	515	65	64	-0.00778	0.10205
118	48333001	Burn injury(morphologic abnormality)	56	92691004	Carcinoma in situ of prostate (disorder)	1095	1	23	0	1	23	1071	0.00000	-0.00443	0.00000	0.00000	0.00000	1.0000000000	1.0000000000	0.02100	-0.02999	0	0	0	1	23	0	0.00000	0.00000
130	314994000	Metastasis from malignant tumor of prostate (disorder)	56	92691004	Carcinoma in situ of prostate (disorder)	1095	1	23	0	1	23	1071	0.00000	-0.00443	0.00000	0.00000	0.00000	1.0000000000	1.0000000000	0.02100	-0.02999	0	0	0	1	23	0	0.00000	0.00000
130	314994000	Metastasis from malignant tumor of prostate (disorder)	112	49436004	Atrial Fibrillation	1095	1	35	0	1	35	1059	0.00000	-0.00549	0.00000	0.00000	0.00000	1.0000000000	1.0000000000	0.03196	-0.04539	0	9	0	1	26	0	0.00000	0.00000
129	47505003	Posttraumatic stress disorder	112	49436004	Atrial Fibrillation	1095	4	35	1	3	34	1057	7.82143	0.07505	10.36275	102.20808	1.05067	0.1220126900	0.6889733259	0.12785	0.82642	1	9	0	3	26	1	-3.29584	-1.38629
128	86849004	Suicidal deliberate poisoning	112	49436004	Atrial Fibrillation	1095	1	35	0	1	35	1059	0.00000	-0.00549	0.00000	0.00000	0.00000	1.0000000000	1.0000000000	0.03196	-0.04539	0	9	0	1	26	0	0.00000	0.00000
125	1734006	Fracture of the vertebral column with spinal cord injury	112	49436004	Atrial Fibrillation	1095	5	35	0	5	35	1055	0.00000	-0.01231	0.00000	0.00000	0.00000	1.0000000000	1.0000000000	0.15982	-0.21390	3	9	0	2	26	0	0.00000	0.00000
124	1501000119109	Proliferative diabetic retinopathy due to type II diabetes mellitus (disorder)	112	49436004	Atrial Fibrillation	1095	1	35	0	1	35	1059	0.00000	-0.00549	0.00000	0.00000	0.00000	1.0000000000	1.0000000000	0.03196	-0.04539	1	9	0	0	26	0	0.00000	0.00000
121	254637007	Non-small cell lung cancer (disorder)	112	49436004	Atrial Fibrillation	1095	8	35	1	7	34	1053	3.91071	0.04537	4.42437	36.96863	0.52950	0.2295125394	0.8880487574	0.25571	0.67150	0	9	0	8	26	1	-3.29584	-2.19722
120	162573006	Suspected lung cancer (situation)	112	49436004	Atrial Fibrillation	1095	8	35	1	7	34	1053	3.91071	0.04537	4.42437	36.96863	0.52950	0.2295125394	0.8880487574	0.25571	0.67150	0	9	0	8	26	1	-3.29584	-2.19722
118	48333001	Burn injury(morphologic abnormality)	112	49436004	Atrial Fibrillation	1095	1	35	0	1	35	1059	0.00000	-0.00549	0.00000	0.00000	0.00000	1.0000000000	1.0000000000	0.03196	-0.04539	0	9	0	1	26	0	0.00000	0.00000
117	230265002	Familial Alzheimer's disease of early onset (disorder)	112	49436004	Atrial Fibrillation	1095	6	35	0	6	35	1054	0.00000	-0.01349	0.00000	0.00000	0.00000	1.0000000000	1.0000000000	0.19178	-0.25312	2	9	0	4	26	0	0.00000	0.00000
115	36923009	Major depression  single episode	112	49436004	Atrial Fibrillation	1095	6	35	0	6	35	1054	0.00000	-0.01349	0.00000	0.00000	0.00000	1.0000000000	1.0000000000	0.19178	-0.25312	3	9	0	3	26	0	0.00000	0.00000
114	449868002	Smokes tobacco daily	112	49436004	Atrial Fibrillation	1095	9	35	3	6	32	1054	10.42857	0.15597	16.46875	68.80651	3.94177	0.0022054406	0.0466490536	0.28767	1.63524	2	9	0	7	26	3	-2.26868	-1.20397
111	235919008	Cholelithiasis	112	49436004	Atrial Fibrillation	1095	9	35	2	7	33	1053	6.95238	0.09846	9.11688	45.57423	1.82378	0.0310429083	0.3255611102	0.28767	1.22020	7	9	1	2	26	1	-0.99325	0.98083
109	90560007	Gout	112	49436004	Atrial Fibrillation	1095	4	35	0	4	35	1056	0.00000	-0.01100	0.00000	0.00000	0.00000	1.0000000000	1.0000000000	0.12785	-0.17358	0	9	0	4	26	0	0.00000	0.00000
108	40930008	Hypothyroidism (disorder)	112	49436004	Atrial Fibrillation	1095	13	35	1	12	34	1048	2.40659	0.02802	2.56863	20.32319	0.32465	0.3460218257	1.0000000000	0.41553	0.49866	11	9	0	2	26	1	-3.29584	-1.09861
107	40275004	Contact dermatitis	112	49436004	Atrial Fibrillation	1095	18	35	1	17	34	1043	1.73810	0.01734	1.80450	13.95434	0.23335	0.4453413343	1.0000000000	0.57534	0.34433	9	9	0	9	26	1	-3.29584	-2.30259
106	24079001	Atopic dermatitis	112	49436004	Atrial Fibrillation	1095	20	35	1	19	34	1041	1.56429	0.01399	1.61146	12.38920	0.20960	0.4808220056	1.0000000000	0.63927	0.28695	13	9	1	7	26	0	2.30259	2.63906
105	363406005	Malignant tumor of colon	112	49436004	Atrial Fibrillation	1095	6	35	2	4	33	1056	10.42857	0.12717	16.00000	90.46568	2.82980	0.0137399673	0.1920532378	0.19178	1.33184	4	9	1	2	26	1	-0.99325	0.51083
104	367498001	Seasonal allergic rhinitis	112	49436004	Atrial Fibrillation	1095	20	35	0	20	35	1040	0.00000	-0.02479	0.00000	0.00000	0.00000	1.0000000000	1.0000000000	0.63927	-0.71305	9	9	0	11	26	0	0.00000	0.00000
102	90781000119102	Microalbuminuria due to type 2 diabetes mellitus (disorder)	112	49436004	Atrial Fibrillation	1095	6	35	0	6	35	1054	0.00000	-0.01349	0.00000	0.00000	0.00000	1.0000000000	1.0000000000	0.19178	-0.25312	3	9	0	3	26	0	0.00000	0.00000
101	433144002	Chronic kidney disease stage 3 (disorder)	112	49436004	Atrial Fibrillation	1095	3	35	0	3	35	1057	0.00000	-0.00952	0.00000	0.00000	0.00000	1.0000000000	1.0000000000	0.09589	-0.13210	1	9	0	2	26	0	0.00000	0.00000
100	161622006	History of lower limb amputation (situation)	112	49436004	Atrial Fibrillation	1095	1	35	0	1	35	1059	0.00000	-0.00549	0.00000	0.00000	0.00000	1.0000000000	1.0000000000	0.03196	-0.04539	0	9	0	1	26	0	0.00000	0.00000
98	1551000119108	Nonproliferative diabetic retinopathy due to type 2 diabetes mellitus (disorder)	112	49436004	Atrial Fibrillation	1095	12	35	1	11	34	1049	2.60714	0.03074	2.80481	22.34829	0.35202	0.3241809515	1.0000000000	0.38356	0.53161	7	9	0	5	26	1	-3.29584	-1.79176
97	403192003	Third degree burn	112	49436004	Atrial Fibrillation	1095	8	35	2	6	33	1054	7.82143	0.10634	10.64646	54.74103	2.07061	0.0246345822	0.2894810738	0.25571	1.25646	3	9	0	5	26	2	-2.63906	-1.25276
96	283371005	Laceration of forearm	112	49436004	Atrial Fibrillation	1095	75	35	3	72	32	988	1.25143	0.01239	1.28646	4.30285	0.38462	0.7281130297	1.0000000000	2.39726	0.23563	39	9	1	36	26	2	-0.33647	0.74444
95	84757009	Epilepsy	112	49436004	Atrial Fibrillation	1095	30	35	0	30	35	1030	0.00000	-0.03050	0.00000	0.00000	0.00000	0.6207896768	1.0000000000	0.95890	-0.97005	13	9	0	17	26	0	0.00000	0.00000
94	703151001	History of single seizure (situation)	112	49436004	Atrial Fibrillation	1095	39	35	1	38	34	1022	0.80220	-0.00691	0.79102	5.93188	0.10548	1.0000000000	1.0000000000	1.24658	-0.16773	14	9	0	25	26	1	-3.29584	-3.25810
93	128613002	Seizure disorder	112	49436004	Atrial Fibrillation	1095	39	35	1	38	34	1022	0.80220	-0.00691	0.79102	5.93188	0.10548	1.0000000000	1.0000000000	1.24658	-0.16773	14	9	0	25	26	1	-3.29584	-3.25810
89	47693006	Rupture of appendix	112	49436004	Atrial Fibrillation	1095	20	35	0	20	35	1040	0.00000	-0.02479	0.00000	0.00000	0.00000	1.0000000000	1.0000000000	0.63927	-0.71305	10	9	0	10	26	0	0.00000	0.00000
86	713197008	Recurrent rectal polyp	112	49436004	Atrial Fibrillation	1095	22	35	4	18	31	1042	5.68831	0.12199	7.46953	23.37381	2.38703	0.0042539086	0.0803028161	0.70320	1.55368	12	9	1	10	26	3	0.03390	1.09861
82	94260004	Secondary malignant neoplasm of colon	112	49436004	Atrial Fibrillation	1095	4	35	1	3	34	1057	7.82143	0.07505	10.36275	102.20808	1.05067	0.1220126900	0.6889733259	0.12785	0.82642	2	9	0	2	26	1	-3.29584	-1.09861
80	6072007	Bleeding from anus	112	49436004	Atrial Fibrillation	1095	4	35	1	3	34	1057	7.82143	0.07505	10.36275	102.20808	1.05067	0.1220126900	0.6889733259	0.12785	0.82642	2	9	0	2	26	1	-3.29584	-1.09861
78	239872002	Osteoarthritis of hip	112	49436004	Atrial Fibrillation	1095	21	35	2	19	33	1041	2.97959	0.05030	3.32057	14.84714	0.74265	0.1427526139	0.7404942507	0.67123	0.84405	13	9	1	8	26	1	-0.99325	0.44183
76	127013003	Diabetic renal disease (disorder)	112	49436004	Atrial Fibrillation	1095	28	35	2	26	33	1034	2.23469	0.03634	2.41026	10.58171	0.54900	0.2243313614	0.8794911525	0.89498	0.66278	10	9	0	18	26	2	-2.63906	-2.30259
75	431855005	Chronic kidney disease stage 1 (disorder)	112	49436004	Atrial Fibrillation	1095	28	35	2	26	33	1034	2.23469	0.03634	2.41026	10.58171	0.54900	0.2243313614	0.8794911525	0.89498	0.66278	10	9	0	18	26	2	-2.63906	-2.30259
73	196416002	Impacted molars	112	49436004	Atrial Fibrillation	1095	49	35	3	46	32	1014	1.91545	0.03600	2.06658	6.99826	0.61026	0.2032589842	0.8521851499	1.56621	0.64036	25	9	0	24	26	3	-2.26868	-2.19722
72	35999006	Blighted ovum	112	49436004	Atrial Fibrillation	1095	53	35	1	52	34	1008	0.59030	-0.01679	0.57014	4.24668	0.07654	1.0000000000	1.0000000000	1.69406	-0.42978	53	9	1	0	26	0	2.30259	3.98898
71	201834006	Localized  primary osteoarthritis of the hand	112	49436004	Atrial Fibrillation	1095	28	35	0	28	35	1032	0.00000	-0.02944	0.00000	0.00000	0.00000	1.0000000000	1.0000000000	0.89498	-0.92218	19	9	0	9	26	0	0.00000	0.00000
70	87433001	Pulmonary emphysema (disorder)	112	49436004	Atrial Fibrillation	1095	17	35	0	17	35	1043	0.00000	-0.02282	0.00000	0.00000	0.00000	1.0000000000	1.0000000000	0.54338	-0.62609	9	9	0	8	26	0	0.00000	0.00000
69	233604007	Pneumonia	112	49436004	Atrial Fibrillation	1095	7	35	1	6	34	1054	4.46939	0.05057	5.16667	44.10628	0.60523	0.2039027947	0.8524167357	0.22374	0.70870	3	9	0	4	26	1	-3.29584	-1.60944
68	26929004	Alzheimer's disease (disorder)	112	49436004	Atrial Fibrillation	1095	23	35	4	19	31	1041	5.44099	0.11820	7.06961	22.01351	2.27040	0.0050329933	0.0916589524	0.73516	1.52686	15	9	2	8	26	2	-0.93431	0.53063
67	403191005	Second degree burn	112	49436004	Atrial Fibrillation	1095	49	35	3	46	32	1014	1.91545	0.03600	2.06658	6.99826	0.61026	0.2032589842	0.8521851499	1.56621	0.64036	23	9	1	26	26	2	-0.33647	0.53900
65	239873007	Osteoarthritis of knee	112	49436004	Atrial Fibrillation	1095	57	35	4	53	31	1007	2.19549	0.05091	2.45161	7.19977	0.83481	0.1037845789	0.6331122908	1.82192	0.82525	30	9	1	27	26	3	0.03390	1.13140
64	444448004	Injury of medial collateral ligament of knee	112	49436004	Atrial Fibrillation	1095	32	35	1	31	34	1029	0.97768	-0.00070	0.97628	7.36263	0.12945	1.0000000000	1.0000000000	1.02283	-0.01638	17	9	0	15	26	1	-3.29584	-2.77259
63	68496003	Polyp of colon	112	49436004	Atrial Fibrillation	1095	91	35	12	79	23	981	4.12559	0.17099	6.47881	13.50648	3.10777	0.0000090085	0.0003864551	2.90868	1.73376	43	9	4	48	26	8	-0.26826	0.51794
62	185086009	Chronic obstructive bronchitis (disorder)	112	49436004	Atrial Fibrillation	1095	6	35	0	6	35	1054	0.00000	-0.01349	0.00000	0.00000	0.00000	1.0000000000	1.0000000000	0.19178	-0.25312	4	9	0	2	26	0	0.00000	0.00000
59	262574004	Bullet wound	112	49436004	Atrial Fibrillation	1095	20	35	1	19	34	1041	1.56429	0.01399	1.61146	12.38920	0.20960	0.4808220056	1.0000000000	0.63927	0.28695	9	9	1	11	26	0	2.30259	2.30259
58	239720000	Tear of meniscus of knee	112	49436004	Atrial Fibrillation	1095	20	35	0	20	35	1040	0.00000	-0.02479	0.00000	0.00000	0.00000	1.0000000000	1.0000000000	0.63927	-0.71305	10	9	0	10	26	0	0.00000	0.00000
57	192127007	Child attention deficit disorder	112	49436004	Atrial Fibrillation	1095	76	35	0	76	35	984	0.00000	-0.04963	0.00000	0.00000	0.00000	0.1662829392	0.7915572889	2.42922	-1.77788	24	9	0	52	26	0	0.00000	0.00000
56	92691004	Carcinoma in situ of prostate (disorder)	112	49436004	Atrial Fibrillation	1095	23	35	12	11	23	1049	16.32298	0.40784	49.75494	124.41724	19.89719	0.0000000000	0.0000000000	0.73516	2.90537	0	9	0	23	26	12	-1.15268	-1.07044
54	5602001	Opioid abuse (disorder)	112	49436004	Atrial Fibrillation	1095	7	35	0	7	35	1053	0.00000	-0.01458	0.00000	0.00000	0.00000	1.0000000000	1.0000000000	0.22374	-0.29130	0	9	0	7	26	0	0.00000	0.00000
52	124171000119105	Chronic intractable migraine without aura	112	49436004	Atrial Fibrillation	1095	51	35	4	47	31	1013	2.45378	0.05839	2.78106	8.20225	0.94295	0.0751568987	0.5403171639	1.63014	0.92679	21	9	0	30	26	4	-2.01490	-2.14007
50	446096008	Perennial allergic rhinitis	112	49436004	Atrial Fibrillation	1095	26	35	0	26	35	1034	0.00000	-0.02834	0.00000	0.00000	0.00000	1.0000000000	1.0000000000	0.83105	-0.87267	14	9	0	12	26	0	0.00000	0.00000
49	88805009	Chronic congestive heart failure (disorder)	112	49436004	Atrial Fibrillation	1095	10	35	0	10	35	1050	0.00000	-0.01744	0.00000	0.00000	0.00000	1.0000000000	1.0000000000	0.31963	-0.40014	5	9	0	5	26	0	0.00000	0.00000
47	359817006	Closed fracture of hip	112	49436004	Atrial Fibrillation	1095	29	35	3	26	32	1034	3.23645	0.06703	3.72837	12.95864	1.07270	0.0618861927	0.4836892708	0.92694	1.05369	11	9	2	18	26	1	-1.59109	-1.07264
46	62564004	Concussion with loss of consciousness	112	49436004	Atrial Fibrillation	1095	67	35	2	65	33	995	0.93390	-0.00307	0.92774	3.95179	0.21780	1.0000000000	1.0000000000	2.14155	-0.06652	36	9	1	31	26	1	-0.99325	0.14518
45	263102004	Fracture subluxation of wrist	112	49436004	Atrial Fibrillation	1095	109	35	7	102	28	958	2.00917	0.06097	2.34804	5.51021	1.00056	0.0750925499	0.5403171639	3.48402	0.83521	51	9	3	58	26	4	-0.62861	0.14953
44	58150001	Fracture of clavicle	112	49436004	Atrial Fibrillation	1095	112	35	5	107	30	953	1.39668	0.02433	1.48442	3.90649	0.56406	0.3936490182	1.0000000000	3.57991	0.38964	55	9	0	57	26	5	-1.82455	-2.51770
43	307731004	Injury of tendon of the rotator cuff of shoulder	112	49436004	Atrial Fibrillation	1095	51	35	1	50	34	1010	0.61345	-0.01552	0.59412	4.42856	0.07970	1.0000000000	1.0000000000	1.63014	-0.39514	26	9	1	25	26	0	2.30259	3.29584
42	16114001	Fracture of ankle	112	49436004	Atrial Fibrillation	1095	108	35	4	104	31	956	1.15873	0.00954	1.18610	3.42619	0.41061	0.7706093952	1.0000000000	3.45205	0.16746	48	9	0	60	26	4	-2.01490	-2.77259
41	283385000	Laceration of thigh	112	49436004	Atrial Fibrillation	1095	105	35	5	100	30	960	1.48980	0.02898	1.60000	4.21605	0.60720	0.3731491837	1.0000000000	3.35616	0.46190	50	9	2	55	26	3	-0.56394	0.29627
39	74400008	Appendicitis	112	49436004	Atrial Fibrillation	1095	51	35	5	46	30	1014	3.06723	0.08302	3.67391	9.90504	1.36270	0.0201577923	0.2499224584	1.63014	1.18982	27	9	3	24	26	2	-1.25276	-0.26236
38	398254007	Preeclampsia	112	49436004	Atrial Fibrillation	1095	101	35	1	100	34	960	0.30976	-0.03998	0.28235	2.08469	0.03824	0.2447570200	0.9133257124	3.22831	-1.08008	101	9	1	0	26	0	2.30259	4.62497
35	19169002	Miscarriage in first trimester	112	49436004	Atrial Fibrillation	1095	174	35	6	168	29	892	1.07882	0.00623	1.09852	2.68674	0.44915	0.8144713568	1.0000000000	5.56164	0.09330	174	9	6	0	26	0	0.91629	3.40120
33	429007001	History of cardiac arrest (situation)	112	49436004	Atrial Fibrillation	1095	42	35	0	42	35	1018	0.00000	-0.03629	0.00000	0.00000	0.00000	0.6410592496	1.0000000000	1.34247	-1.22803	24	9	0	18	26	0	0.00000	0.00000
32	410429000	Cardiac Arrest	112	49436004	Atrial Fibrillation	1095	42	35	0	42	35	1018	0.00000	-0.03629	0.00000	0.00000	0.00000	0.6410592496	1.0000000000	1.34247	-1.22803	24	9	0	18	26	0	0.00000	0.00000
125	1734006	Fracture of the vertebral column with spinal cord injury	5	284549007	Laceration of hand	1095	5	104	1	4	103	987	2.10577	0.02426	2.39563	21.63546	0.26526	0.3934309513	1.0000000000	0.47489	0.43940	3	54	0	2	50	1	-3.93183	-1.09861
30	399211009	History of myocardial infarction (situation)	112	49436004	Atrial Fibrillation	1095	31	35	0	31	35	1029	0.00000	-0.03102	0.00000	0.00000	0.00000	0.6206591193	1.0000000000	0.99087	-0.99340	2	9	0	29	26	0	0.00000	0.00000
29	22298006	Myocardial Infarction	112	49436004	Atrial Fibrillation	1095	31	35	0	31	35	1029	0.00000	-0.03102	0.00000	0.00000	0.00000	0.6206591193	1.0000000000	0.99087	-0.99340	2	9	0	29	26	0	0.00000	0.00000
27	408512008	Body mass index 40+ - severely obese (finding)	112	49436004	Atrial Fibrillation	1095	97	35	5	92	30	968	1.61267	0.03471	1.75362	4.62874	0.66437	0.2283514641	0.8877188448	3.10046	0.54918	67	9	2	30	26	3	-0.56394	1.14306
24	162864005	Body mass index 30+ - obesity (finding)	112	49436004	Atrial Fibrillation	1095	439	35	24	415	11	645	1.71038	0.10560	3.39102	6.99610	1.64363	0.0006802413	0.0182047297	14.03196	0.73389	226	9	7	213	26	17	-0.10131	0.90026
23	36971009	Sinusitis (disorder)	112	49436004	Atrial Fibrillation	1095	190	35	11	179	24	881	1.81128	0.06755	2.25582	4.68808	1.08546	0.0380011484	0.3681833120	6.07306	0.76263	84	9	4	106	26	7	-0.37194	0.30956
21	15777000	Prediabetes	112	49436004	Atrial Fibrillation	1095	333	35	20	313	15	747	1.87902	0.10559	3.18211	6.29580	1.60834	0.0011032662	0.0269762415	10.64384	0.85082	159	9	6	174	26	14	-0.13353	0.71680
20	80394007	Hyperglycemia (disorder)	112	49436004	Atrial Fibrillation	1095	55	35	5	50	30	1010	2.84416	0.07706	3.36667	9.04619	1.25295	0.0272076146	0.3038529778	1.75799	1.12134	23	9	0	32	26	5	-1.82455	-2.00148
19	237602007	Metabolic syndrome X (disorder)	112	49436004	Atrial Fibrillation	1095	64	35	5	59	30	1001	2.44420	0.06538	2.82768	7.55304	1.05862	0.0484118011	0.4232510452	2.04566	0.97821	28	9	0	36	26	5	-1.82455	-2.10413
18	302870006	Hypertriglyceridemia (disorder)	112	49436004	Atrial Fibrillation	1095	64	35	5	59	30	1001	2.44420	0.06538	2.82768	7.55304	1.05862	0.0484118011	0.4232510452	2.04566	0.97821	28	9	0	36	26	5	-1.82455	-2.10413
17	368581000119106	Neuropathy due to type 2 diabetes mellitus (disorder)	112	49436004	Atrial Fibrillation	1095	28	35	3	25	32	1035	3.35204	0.06923	3.88125	13.52200	1.11404	0.0567017724	0.4634340392	0.89498	1.07782	7	9	0	21	26	3	-2.26868	-2.07944
15	40055000	Chronic sinusitis (disorder)	112	49436004	Atrial Fibrillation	1095	216	35	17	199	18	861	2.46230	0.13172	4.08626	8.07023	2.06903	0.0000884408	0.0030564289	6.90411	1.18732	104	9	4	112	26	13	0.08004	1.03247
14	10509002	Acute bronchitis (disorder)	112	49436004	Atrial Fibrillation	1095	863	35	33	830	2	230	1.19633	0.06880	4.57229	19.19696	1.08902	0.0197652910	0.2463827683	27.58447	0.25030	418	9	7	445	26	26	0.13353	1.20942
13	370247008	Facial laceration	112	49436004	Atrial Fibrillation	1095	109	35	4	105	31	955	1.14810	0.00895	1.17358	3.38945	0.40635	0.7717648773	1.0000000000	3.48402	0.15714	55	9	2	54	26	2	-0.93431	0.01770
125	1734006	Fracture of the vertebral column with spinal cord injury	86	713197008	Recurrent rectal polyp	1095	5	22	0	5	22	1068	0.00000	-0.00970	0.00000	0.00000	0.00000	1.0000000000	1.0000000000	0.10046	-0.13810	3	12	0	2	10	0	0.00000	0.00000
10	62106007	Concussion with no loss of consciousness	112	49436004	Atrial Fibrillation	1095	206	35	9	197	26	863	1.36685	0.03209	1.51640	3.28704	0.69956	0.2759544234	0.9505356881	6.58447	0.39888	96	9	2	110	26	7	0.15415	1.07556
8	233678006	Childhood asthma	112	49436004	Atrial Fibrillation	1095	45	35	0	45	35	1015	0.00000	-0.03762	0.00000	0.00000	0.00000	0.3952082832	1.0000000000	1.43836	-1.28591	25	9	0	20	26	0	0.00000	0.00000
7	75498004	Acute bacterial sinusitis (disorder)	112	49436004	Atrial Fibrillation	1095	187	35	8	179	27	881	1.33843	0.02791	1.45831	3.26231	0.65189	0.3608567101	1.0000000000	5.97717	0.36728	89	9	2	98	26	6	0.03077	0.96508
6	39848009	Whiplash injury to neck	112	49436004	Atrial Fibrillation	1095	182	35	6	176	29	884	1.03140	0.00255	1.03918	2.54019	0.42513	1.0000000000	1.0000000000	5.81735	0.03814	92	9	0	90	26	6	-1.67398	-2.77259
5	284549007	Laceration of hand	112	49436004	Atrial Fibrillation	1095	104	35	2	102	33	958	0.60165	-0.02345	0.56922	2.40686	0.13462	0.7666321082	1.0000000000	3.32420	-0.52747	54	9	0	50	26	2	-2.63906	-3.25810
1	444814009	Viral sinusitis (disorder)	112	49436004	Atrial Fibrillation	1095	993	35	35	958	0	102	1.10272	0.05824	0.00000	0.00000	0.00000	0.0681849175	0.5133166434	31.73973	0.13695	478	9	9	515	26	26	0.00000	0.95572
96	283371005	Laceration of forearm	86	713197008	Recurrent rectal polyp	1095	75	22	5	70	17	1003	3.31818	0.09001	4.21429	11.75906	1.51034	0.0138277840	0.1929734302	1.50685	1.25909	39	12	3	36	10	2	-0.18232	-0.30538
94	703151001	History of single seizure (situation)	86	713197008	Recurrent rectal polyp	1095	39	22	1	38	21	1035	1.27622	0.00760	1.29699	9.89561	0.16999	0.5532483632	1.0000000000	0.78356	0.16524	14	12	0	25	10	1	-2.39790	-3.25810
75	431855005	Chronic kidney disease stage 1 (disorder)	86	713197008	Recurrent rectal polyp	1095	28	22	2	26	20	1047	3.55519	0.05927	4.02692	18.13306	0.89428	0.1063461212	0.6411444039	0.56256	0.94105	10	12	1	18	10	1	0.16705	-0.54654
44	58150001	Fracture of clavicle	86	713197008	Recurrent rectal polyp	1095	112	22	3	109	19	964	1.33320	0.01610	1.39643	4.79498	0.40668	0.4854893708	1.0000000000	2.25023	0.29946	55	12	1	57	10	2	0.77319	0.64096
42	16114001	Fracture of ankle	86	713197008	Recurrent rectal polyp	1095	108	22	2	106	20	967	0.92172	-0.00371	0.91226	3.95702	0.21032	1.0000000000	1.0000000000	2.16986	-0.07946	48	12	2	60	10	0	1.94591	3.21888
41	283385000	Laceration of thigh	86	713197008	Recurrent rectal polyp	1095	105	22	1	104	21	969	0.47403	-0.02453	0.44368	3.33212	0.05908	0.7144056427	1.0000000000	2.10959	-0.63672	50	12	0	55	10	1	-2.39790	-4.02535
33	429007001	History of cardiac arrest (situation)	86	713197008	Recurrent rectal polyp	1095	42	22	1	41	21	1032	1.18506	0.00529	1.19861	9.12834	0.15738	0.5806180630	1.0000000000	0.84384	0.11729	24	12	1	18	10	0	2.56495	3.21888
21	15777000	Prediabetes	86	713197008	Recurrent rectal polyp	1095	333	22	14	319	8	754	2.09255	0.10342	4.13636	9.95712	1.71832	0.0014837505	0.0337418703	6.69041	0.96383	159	12	8	174	10	6	-0.06454	-0.36265
131	93761005	Primary malignant neoplasm of colon	60	301011002	Escherichia coli urinary tract infection	1095	5	92	1	4	91	999	2.38043	0.02832	2.74451	24.81366	0.30355	0.3557280433	1.0000000000	0.42009	0.49402	3	85	1	2	7	0	4.45435	1.38629
130	314994000	Metastasis from malignant tumor of prostate (disorder)	60	301011002	Escherichia coli urinary tract infection	1095	1	92	0	1	92	1002	0.00000	-0.00916	0.00000	0.00000	0.00000	1.0000000000	1.0000000000	0.08402	-0.11639	0	85	0	1	7	0	0.00000	0.00000
129	47505003	Posttraumatic stress disorder	60	301011002	Escherichia coli urinary tract infection	1095	4	92	0	4	92	999	0.00000	-0.01834	0.00000	0.00000	0.00000	1.0000000000	1.0000000000	0.33607	-0.41800	1	85	0	3	7	0	0.00000	0.00000
15	40055000	Chronic sinusitis (disorder)	86	713197008	Recurrent rectal polyp	1095	216	22	7	209	15	864	1.61301	0.04351	1.92919	4.79168	0.77671	0.1728119479	0.7996618359	4.33973	0.58323	104	12	1	112	10	6	1.58412	1.67504
14	10509002	Acute bronchitis (disorder)	86	713197008	Recurrent rectal polyp	1095	863	22	20	843	2	230	1.15348	0.04239	2.72835	11.75809	0.63309	0.1958453901	0.8340316782	17.33881	0.19549	418	12	11	445	10	9	-0.00962	-0.25731
126	698754002	Chronic paralysis due to lesion of spinal cord	60	301011002	Escherichia coli urinary tract infection	1095	2	92	0	2	92	1001	0.00000	-0.01296	0.00000	0.00000	0.00000	1.0000000000	1.0000000000	0.16804	-0.22409	2	85	0	0	7	0	0.00000	0.00000
125	1734006	Fracture of the vertebral column with spinal cord injury	60	301011002	Escherichia coli urinary tract infection	1095	5	92	0	5	92	998	0.00000	-0.02051	0.00000	0.00000	0.00000	1.0000000000	1.0000000000	0.42009	-0.50598	3	85	0	2	7	0	0.00000	0.00000
124	1501000119109	Proliferative diabetic retinopathy due to type II diabetes mellitus (disorder)	60	301011002	Escherichia coli urinary tract infection	1095	1	92	0	1	92	1002	0.00000	-0.00916	0.00000	0.00000	0.00000	1.0000000000	1.0000000000	0.08402	-0.11639	1	85	0	0	7	0	0.00000	0.00000
123	195967001	Asthma	60	301011002	Escherichia coli urinary tract infection	1095	2	92	0	2	92	1001	0.00000	-0.01296	0.00000	0.00000	0.00000	1.0000000000	1.0000000000	0.16804	-0.22409	1	85	0	1	7	0	0.00000	0.00000
121	254637007	Non-small cell lung cancer (disorder)	60	301011002	Escherichia coli urinary tract infection	1095	8	92	0	8	92	995	0.00000	-0.02598	0.00000	0.00000	0.00000	1.0000000000	1.0000000000	0.67215	-0.74170	0	85	0	8	7	0	0.00000	0.00000
120	162573006	Suspected lung cancer (situation)	60	301011002	Escherichia coli urinary tract infection	1095	8	92	0	8	92	995	0.00000	-0.02598	0.00000	0.00000	0.00000	1.0000000000	1.0000000000	0.67215	-0.74170	0	85	0	8	7	0	0.00000	0.00000
119	275272006	Brain damage - traumatic	60	301011002	Escherichia coli urinary tract infection	1095	4	92	0	4	92	999	0.00000	-0.01834	0.00000	0.00000	0.00000	1.0000000000	1.0000000000	0.33607	-0.41800	0	85	0	4	7	0	0.00000	0.00000
118	48333001	Burn injury(morphologic abnormality)	60	301011002	Escherichia coli urinary tract infection	1095	1	92	0	1	92	1002	0.00000	-0.00916	0.00000	0.00000	0.00000	1.0000000000	1.0000000000	0.08402	-0.11639	0	85	0	1	7	0	0.00000	0.00000
117	230265002	Familial Alzheimer's disease of early onset (disorder)	60	301011002	Escherichia coli urinary tract infection	1095	6	92	1	5	91	998	1.98370	0.02211	2.19341	18.97632	0.25353	0.4101069607	1.0000000000	0.50411	0.41109	2	85	1	4	7	0	4.45435	1.09861
115	36923009	Major depression  single episode	60	301011002	Escherichia coli urinary tract infection	1095	6	92	0	6	92	997	0.00000	-0.02248	0.00000	0.00000	0.00000	1.0000000000	1.0000000000	0.50411	-0.58891	3	85	0	3	7	0	0.00000	0.00000
114	449868002	Smokes tobacco daily	60	301011002	Escherichia coli urinary tract infection	1095	9	92	1	8	91	995	1.32246	0.00889	1.36676	11.04914	0.16907	0.5474521252	1.0000000000	0.75616	0.18757	2	85	1	7	7	0	4.45435	1.09861
113	443165006	Pathological fracture due to osteoporosis (disorder)	60	301011002	Escherichia coli urinary tract infection	1095	10	92	1	9	91	994	1.19022	0.00553	1.21368	9.68677	0.15206	0.5857895142	1.0000000000	0.84018	0.12015	7	85	1	3	7	0	4.45435	2.07944
112	49436004	Atrial Fibrillation	60	301011002	Escherichia coli urinary tract infection	1095	35	92	2	33	90	970	0.68012	-0.01760	0.65320	2.76671	0.15422	0.7620028732	1.0000000000	2.94064	-0.39347	9	85	1	26	7	1	2.37491	-0.99325
111	235919008	Cholelithiasis	60	301011002	Escherichia coli urinary tract infection	1095	9	92	2	7	90	996	2.64493	0.04535	3.16190	15.44650	0.64724	0.1708595218	0.7972585288	0.75616	0.77253	7	85	2	2	7	0	3.77276	1.50408
110	65275009	Acute Cholecystitis	60	301011002	Escherichia coli urinary tract infection	1095	9	92	2	7	90	996	2.64493	0.04535	3.16190	15.44650	0.64724	0.1708595218	0.7972585288	0.75616	0.77253	7	85	2	2	7	0	3.77276	1.50408
109	90560007	Gout	60	301011002	Escherichia coli urinary tract infection	1095	4	92	0	4	92	999	0.00000	-0.01834	0.00000	0.00000	0.00000	1.0000000000	1.0000000000	0.33607	-0.41800	0	85	0	4	7	0	0.00000	0.00000
108	40930008	Hypothyroidism (disorder)	60	301011002	Escherichia coli urinary tract infection	1095	13	92	4	9	88	994	3.66221	0.08838	5.02020	16.63096	1.51539	0.0185008664	0.2363909835	1.09224	1.25688	11	85	4	2	7	0	3.10234	1.32176
107	40275004	Contact dermatitis	60	301011002	Escherichia coli urinary tract infection	1095	18	92	2	16	90	987	1.32246	0.01263	1.37083	6.05662	0.31027	0.6584005308	1.0000000000	1.51233	0.25594	9	85	2	9	7	0	3.77276	1.70475
106	24079001	Atopic dermatitis	60	301011002	Escherichia coli urinary tract infection	1095	20	92	0	20	92	983	0.00000	-0.04131	0.00000	0.00000	0.00000	0.4027200259	1.0000000000	1.68037	-1.42243	13	85	0	7	7	0	0.00000	0.00000
105	363406005	Malignant tumor of colon	60	301011002	Escherichia coli urinary tract infection	1095	6	92	2	4	90	999	3.96739	0.06671	5.55000	30.71741	1.00277	0.0838334561	0.5713432277	0.50411	0.99605	4	85	2	2	7	0	3.77276	1.09861
104	367498001	Seasonal allergic rhinitis	60	301011002	Escherichia coli urinary tract infection	1095	20	92	0	20	92	983	0.00000	-0.04131	0.00000	0.00000	0.00000	0.4027200259	1.0000000000	1.68037	-1.42243	9	85	0	11	7	0	0.00000	0.00000
102	90781000119102	Microalbuminuria due to type 2 diabetes mellitus (disorder)	60	301011002	Escherichia coli urinary tract infection	1095	6	92	1	5	91	998	1.98370	0.02211	2.19341	18.97632	0.25353	0.4101069607	1.0000000000	0.50411	0.41109	3	85	1	3	7	0	4.45435	1.38629
101	433144002	Chronic kidney disease stage 3 (disorder)	60	301011002	Escherichia coli urinary tract infection	1095	3	92	0	3	92	1000	0.00000	-0.01587	0.00000	0.00000	0.00000	1.0000000000	1.0000000000	0.25205	-0.32430	1	85	0	2	7	0	0.00000	0.00000
100	161622006	History of lower limb amputation (situation)	60	301011002	Escherichia coli urinary tract infection	1095	1	92	0	1	92	1002	0.00000	-0.00916	0.00000	0.00000	0.00000	1.0000000000	1.0000000000	0.08402	-0.11639	0	85	0	1	7	0	0.00000	0.00000
99	30832001	Rupture of patellar tendon	60	301011002	Escherichia coli urinary tract infection	1095	23	92	3	20	89	983	1.55246	0.02451	1.65674	5.68361	0.48293	0.4336087286	1.0000000000	1.93242	0.44791	14	85	3	9	7	0	3.37872	1.73460
98	1551000119108	Nonproliferative diabetic retinopathy due to type 2 diabetes mellitus (disorder)	60	301011002	Escherichia coli urinary tract infection	1095	12	92	1	11	91	992	0.99185	-0.00026	0.99101	7.76256	0.12652	1.0000000000	1.0000000000	1.00822	-0.00592	7	85	1	5	7	0	4.45435	2.07944
97	403192003	Third degree burn	60	301011002	Escherichia coli urinary tract infection	1095	8	92	0	8	92	995	0.00000	-0.02598	0.00000	0.00000	0.00000	1.0000000000	1.0000000000	0.67215	-0.74170	3	85	0	5	7	0	0.00000	0.00000
96	283371005	Laceration of forearm	60	301011002	Escherichia coli urinary tract infection	1095	75	92	7	68	85	935	1.11087	0.00911	1.13235	2.54303	0.50421	0.6702486973	1.0000000000	6.30137	0.13183	39	85	5	36	7	2	1.38629	-0.76969
95	84757009	Epilepsy	60	301011002	Escherichia coli urinary tract infection	1095	30	92	1	29	91	974	0.39674	-0.03066	0.36908	2.74086	0.04970	0.5058070332	1.0000000000	2.52055	-0.81580	13	85	0	17	7	1	-2.07944	-2.89037
94	703151001	History of single seizure (situation)	60	301011002	Escherichia coli urinary tract infection	1095	39	92	1	38	91	965	0.30518	-0.04044	0.27906	2.05622	0.03787	0.2458189159	0.9133257124	3.27671	-1.09650	14	85	0	25	7	1	-2.07944	-3.25810
93	128613002	Seizure disorder	60	301011002	Escherichia coli urinary tract infection	1095	39	92	1	38	91	965	0.30518	-0.04044	0.27906	2.05622	0.03787	0.2458189159	0.9133257124	3.27671	-1.09650	14	85	0	25	7	1	-2.07944	-3.25810
91	64859006	Osteoporosis (disorder)	60	301011002	Escherichia coli urinary tract infection	1095	37	92	5	32	87	971	1.60840	0.03446	1.74389	4.58974	0.66260	0.2299735982	0.8885159531	3.10868	0.54629	24	85	5	13	7	0	2.89037	1.75786
89	47693006	Rupture of appendix	60	301011002	Escherichia coli urinary tract infection	1095	20	92	2	18	90	985	1.19022	0.00786	1.21605	5.32460	0.27773	0.6819027983	1.0000000000	1.68037	0.16253	10	85	2	10	7	0	3.77276	1.79176
86	713197008	Recurrent rectal polyp	60	301011002	Escherichia coli urinary tract infection	1095	22	92	3	19	89	984	1.62302	0.02702	1.74571	6.01339	0.50679	0.4219030316	1.0000000000	1.84840	0.48985	12	85	3	10	7	0	3.37872	1.60944
85	241929008	Acute allergic reaction	60	301011002	Escherichia coli urinary tract infection	1095	47	92	3	44	89	959	0.75971	-0.01541	0.73468	2.41379	0.22361	0.7912851175	1.0000000000	3.94886	-0.30710	25	85	3	22	7	0	3.37872	2.23359
83	110030002	Concussion injury of brain	60	301011002	Escherichia coli urinary tract infection	1095	7	92	0	7	92	996	0.00000	-0.02429	0.00000	0.00000	0.00000	1.0000000000	1.0000000000	0.58813	-0.66733	1	85	0	6	7	0	0.00000	0.00000
82	94260004	Secondary malignant neoplasm of colon	60	301011002	Escherichia coli urinary tract infection	1095	4	92	1	3	91	1000	2.97554	0.03623	3.66300	35.57382	0.37718	0.2963956909	0.9843970393	0.33607	0.58200	2	85	1	2	7	0	4.45435	1.09861
81	236077008	Protracted diarrhea	60	301011002	Escherichia coli urinary tract infection	1095	4	92	1	3	91	1000	2.97554	0.03623	3.66300	35.57382	0.37718	0.2963956909	0.9843970393	0.33607	0.58200	2	85	1	2	7	0	4.45435	1.09861
80	6072007	Bleeding from anus	60	301011002	Escherichia coli urinary tract infection	1095	4	92	1	3	91	1000	2.97554	0.03623	3.66300	35.57382	0.37718	0.2963956909	0.9843970393	0.33607	0.58200	2	85	1	2	7	0	4.45435	1.09861
79	45816000	Pyelonephritis	60	301011002	Escherichia coli urinary tract infection	1095	1	92	0	1	92	1002	0.00000	-0.00916	0.00000	0.00000	0.00000	1.0000000000	1.0000000000	0.08402	-0.11639	1	85	0	0	7	0	0.00000	0.00000
78	239872002	Osteoarthritis of hip	60	301011002	Escherichia coli urinary tract infection	1095	21	92	7	14	85	989	3.96739	0.12567	5.81765	14.80313	2.28634	0.0010319239	0.0255161348	1.76438	1.53304	13	85	7	8	7	0	2.57588	1.04982
76	127013003	Diabetic renal disease (disorder)	60	301011002	Escherichia coli urinary tract infection	1095	28	92	3	25	89	978	1.27523	0.01350	1.31865	4.45341	0.39045	0.7246973959	1.0000000000	2.35251	0.25476	10	85	3	18	7	0	3.37872	1.46634
75	431855005	Chronic kidney disease stage 1 (disorder)	60	301011002	Escherichia coli urinary tract infection	1095	28	92	3	25	89	978	1.27523	0.01350	1.31865	4.45341	0.39045	0.7246973959	1.0000000000	2.35251	0.25476	10	85	3	18	7	0	3.37872	1.46634
73	196416002	Impacted molars	60	301011002	Escherichia coli urinary tract infection	1095	49	92	8	41	84	962	1.94321	0.06183	2.23461	4.92218	1.01449	0.0585365922	0.4688268308	4.11689	0.81466	25	85	7	24	7	1	0.49644	-1.69905
72	35999006	Blighted ovum	60	301011002	Escherichia coli urinary tract infection	1095	53	92	16	37	76	966	3.59311	0.17712	5.49644	10.33277	2.92379	0.0000019656	0.0000974784	4.45297	1.64042	53	85	16	0	7	0	1.84253	1.46152
71	201834006	Localized  primary osteoarthritis of the hand	60	301011002	Escherichia coli urinary tract infection	1095	28	92	6	22	86	981	2.55047	0.07607	3.11099	7.87866	1.22842	0.0247101997	0.2898426609	2.35251	1.06211	19	85	6	9	7	0	2.71910	1.42712
70	87433001	Pulmonary emphysema (disorder)	60	301011002	Escherichia coli urinary tract infection	1095	17	92	0	17	92	986	0.00000	-0.03803	0.00000	0.00000	0.00000	0.3879941822	1.0000000000	1.42831	-1.27995	9	85	0	8	7	0	0.00000	0.00000
69	233604007	Pneumonia	60	301011002	Escherichia coli urinary tract infection	1095	7	92	0	7	92	996	0.00000	-0.02429	0.00000	0.00000	0.00000	1.0000000000	1.0000000000	0.58813	-0.66733	3	85	0	4	7	0	0.00000	0.00000
68	26929004	Alzheimer's disease (disorder)	60	301011002	Escherichia coli urinary tract infection	1095	23	92	2	21	90	982	1.03497	0.00155	1.03915	4.50317	0.23980	1.0000000000	1.0000000000	1.93242	0.03287	15	85	2	8	7	0	3.77276	2.14007
67	403191005	Second degree burn	60	301011002	Escherichia coli urinary tract infection	1095	49	92	4	45	88	958	0.97161	-0.00186	0.96768	2.75330	0.34010	1.0000000000	1.0000000000	4.11689	-0.03334	23	85	2	26	7	2	2.26868	-0.11333
65	239873007	Osteoarthritis of knee	60	301011002	Escherichia coli urinary tract infection	1095	57	92	10	47	82	956	2.08810	0.07722	2.48054	5.09025	1.20880	0.0224908769	0.2721606699	4.78904	0.92611	30	85	8	27	7	2	0.94908	-1.11600
64	444448004	Injury of medial collateral ligament of knee	60	301011002	Escherichia coli urinary tract infection	1095	32	92	5	27	87	976	1.85971	0.04518	2.07748	5.53044	0.78039	0.1813952601	0.8137869183	2.68858	0.70190	17	85	5	15	7	0	2.89037	1.48160
63	68496003	Polyp of colon	60	301011002	Escherichia coli urinary tract infection	1095	91	92	14	77	78	926	1.83110	0.07578	2.15851	3.99072	1.16750	0.0176029472	0.2282402808	7.64566	0.79491	43	85	12	48	7	2	0.58573	-1.69645
62	185086009	Chronic obstructive bronchitis (disorder)	60	301011002	Escherichia coli urinary tract infection	1095	6	92	4	2	88	1001	7.93478	0.15590	22.75000	125.94912	4.10930	0.0006157494	0.0167858630	0.50411	1.73302	4	85	3	2	7	1	1.29928	-0.25131
59	262574004	Bullet wound	60	301011002	Escherichia coli urinary tract infection	1095	20	92	3	17	89	986	1.78533	0.03244	1.95506	6.79931	0.56215	0.2326071746	0.8937472100	1.68037	0.57757	9	85	2	11	7	1	1.69332	-0.78016
58	239720000	Tear of meniscus of knee	60	301011002	Escherichia coli urinary tract infection	1095	20	92	2	18	90	985	1.19022	0.00786	1.21605	5.32460	0.27773	0.6819027983	1.0000000000	1.68037	0.16253	10	85	2	10	7	0	3.77276	1.79176
57	192127007	Child attention deficit disorder	60	301011002	Escherichia coli urinary tract infection	1095	76	92	3	73	89	930	0.46982	-0.04385	0.42943	1.39042	0.13263	0.1967137895	0.8353912164	6.38539	-0.88467	24	85	3	52	7	0	3.37872	2.19722
56	92691004	Carcinoma in situ of prostate (disorder)	60	301011002	Escherichia coli urinary tract infection	1095	23	92	0	23	92	980	0.00000	-0.04436	0.00000	0.00000	0.00000	0.2503709802	0.9133257124	1.93242	-1.55209	0	85	0	23	7	0	0.00000	0.00000
54	5602001	Opioid abuse (disorder)	60	301011002	Escherichia coli urinary tract infection	1095	7	92	0	7	92	996	0.00000	-0.02429	0.00000	0.00000	0.00000	1.0000000000	1.0000000000	0.58813	-0.66733	0	85	0	7	7	0	0.00000	0.00000
53	7200002	Alcoholism	60	301011002	Escherichia coli urinary tract infection	1095	5	92	0	5	92	998	0.00000	-0.02051	0.00000	0.00000	0.00000	1.0000000000	1.0000000000	0.42009	-0.50598	0	85	0	5	7	0	0.00000	0.00000
52	124171000119105	Chronic intractable migraine without aura	60	301011002	Escherichia coli urinary tract infection	1095	51	92	6	45	86	958	1.40026	0.02679	1.48527	3.58061	0.61610	0.4321264916	1.0000000000	4.28493	0.40547	21	85	6	30	7	0	2.71910	1.50408
50	446096008	Perennial allergic rhinitis	60	301011002	Escherichia coli urinary tract infection	1095	26	92	2	24	90	979	0.91555	-0.00399	0.90648	3.89766	0.21082	1.0000000000	1.0000000000	2.18447	-0.08609	14	85	2	12	7	0	3.77276	2.07944
49	88805009	Chronic congestive heart failure (disorder)	60	301011002	Escherichia coli urinary tract infection	1095	10	92	3	7	89	996	3.57065	0.07474	4.79615	18.87032	1.21901	0.0446351133	0.4077076214	0.84018	1.12015	5	85	3	5	7	0	3.37872	0.98083
47	359817006	Closed fracture of hip	60	301011002	Escherichia coli urinary tract infection	1095	29	92	3	26	89	977	1.23126	0.01155	1.26664	4.26737	0.37596	0.7292461147	1.0000000000	2.43653	0.21905	11	85	2	18	7	1	1.69332	-1.07264
46	62564004	Concussion with loss of consciousness	60	301011002	Escherichia coli urinary tract infection	1095	67	92	10	57	82	946	1.77644	0.06003	2.02396	4.11193	0.99623	0.0644350165	0.4935519847	5.62922	0.73059	36	85	10	31	7	0	2.25129	1.52606
45	263102004	Fracture subluxation of wrist	60	301011002	Escherichia coli urinary tract infection	1095	109	92	6	103	86	900	0.65517	-0.03472	0.60962	1.42963	0.25995	0.3606990705	1.0000000000	9.15799	-0.53719	51	85	5	58	7	1	0.81093	-1.66162
44	58150001	Fracture of clavicle	60	301011002	Escherichia coli urinary tract infection	1095	112	92	19	93	73	910	2.01912	0.10418	2.54677	4.40549	1.47226	0.0017435677	0.0384548664	9.41005	0.94202	55	85	17	57	7	2	0.28768	-1.94094
43	307731004	Injury of tendon of the rotator cuff of shoulder	60	301011002	Escherichia coli urinary tract infection	1095	51	92	7	44	85	959	1.63363	0.04241	1.79492	4.10736	0.78438	0.1886085567	0.8196068864	4.28493	0.59812	26	85	7	25	7	0	2.57588	1.55060
42	16114001	Fracture of ankle	60	301011002	Escherichia coli urinary tract infection	1095	108	92	10	98	82	905	1.10205	0.01022	1.12618	2.24258	0.56555	0.7149277771	1.0000000000	9.07397	0.12687	48	85	9	60	7	1	0.26663	-2.26505
41	283385000	Laceration of thigh	60	301011002	Escherichia coli urinary tract infection	1095	105	92	12	93	80	910	1.36025	0.03553	1.46774	2.79238	0.77148	0.2643372468	0.9322428094	8.82192	0.40443	50	85	10	55	7	2	0.74721	-1.55814
40	428251008	History of appendectomy	60	301011002	Escherichia coli urinary tract infection	1095	51	92	5	46	87	957	1.16688	0.01117	1.19565	3.08750	0.46302	0.6100035634	1.0000000000	4.28493	0.18308	27	85	4	24	7	1	1.02290	-1.17118
39	74400008	Appendicitis	60	301011002	Escherichia coli urinary tract infection	1095	51	92	5	46	87	957	1.16688	0.01117	1.19565	3.08750	0.46302	0.6100035634	1.0000000000	4.28493	0.18308	27	85	4	24	7	1	1.02290	-1.17118
38	398254007	Preeclampsia	60	301011002	Escherichia coli urinary tract infection	1095	101	92	25	76	67	927	2.94608	0.18788	4.55126	7.62055	2.71817	0.0000001151	0.0000067361	8.48584	1.45466	101	85	25	0	7	0	1.48160	1.61741
37	38822007	Cystitis	60	301011002	Escherichia coli urinary tract infection	1095	71	92	22	49	70	954	3.68800	0.21436	6.11895	10.69615	3.50047	0.0000000087	0.0000005823	5.96530	1.72338	68	85	22	3	7	0	1.58179	1.40877
35	19169002	Miscarriage in first trimester	60	301011002	Escherichia coli urinary tract infection	1095	174	92	45	129	47	874	3.07815	0.27357	6.48689	10.15959	4.14187	0.0000000000	0.0000000000	14.61918	1.55832	174	85	45	0	7	0	1.06087	1.58241
33	429007001	History of cardiac arrest (situation)	60	301011002	Escherichia coli urinary tract infection	1095	42	92	3	39	89	964	0.85016	-0.00906	0.83319	2.75031	0.25241	1.0000000000	1.0000000000	3.52877	-0.17912	24	85	3	18	7	0	3.37872	2.19722
32	410429000	Cardiac Arrest	60	301011002	Escherichia coli urinary tract infection	1095	42	92	3	39	89	964	0.85016	-0.00906	0.83319	2.75031	0.25241	1.0000000000	1.0000000000	3.52877	-0.17912	24	85	3	18	7	0	3.37872	2.19722
30	399211009	History of myocardial infarction (situation)	60	301011002	Escherichia coli urinary tract infection	1095	31	92	1	30	91	973	0.38394	-0.03185	0.35641	2.64387	0.04805	0.5081405810	1.0000000000	2.60457	-0.84983	2	85	0	29	7	1	-2.07944	-3.40120
29	22298006	Myocardial Infarction	60	301011002	Escherichia coli urinary tract infection	1095	31	92	1	30	91	973	0.38394	-0.03185	0.35641	2.64387	0.04805	0.5081405810	1.0000000000	2.60457	-0.84983	2	85	0	29	7	1	-2.07944	-3.40120
28	53741008	Coronary Heart Disease	60	301011002	Escherichia coli urinary tract infection	1095	80	92	5	75	87	928	0.74389	-0.02178	0.71111	1.80513	0.28013	0.6740236895	1.0000000000	6.72146	-0.36391	24	85	3	56	7	2	1.87465	-1.17007
27	408512008	Body mass index 40+ - severely obese (finding)	60	301011002	Escherichia coli urinary tract infection	1095	97	92	18	79	74	924	2.20865	0.11412	2.84502	5.00073	1.61859	0.0007374264	0.0194973772	8.14977	1.05419	67	85	16	30	7	2	0.33845	-1.12634
26	33737001	Fracture of rib	60	301011002	Escherichia coli urinary tract infection	1095	54	92	8	46	84	957	1.76329	0.05265	1.98137	4.33625	0.90535	0.1234996930	0.6913144812	4.53699	0.70082	32	85	7	22	7	1	0.49644	-1.41784
24	162864005	Body mass index 30+ - obesity (finding)	60	301011002	Escherichia coli urinary tract infection	1095	439	92	60	379	32	624	1.62672	0.15527	3.08707	4.82998	1.97310	0.0000006067	0.0000318914	36.88402	0.68722	226	85	55	213	7	5	0.05884	-2.14404
23	36971009	Sinusitis (disorder)	60	301011002	Escherichia coli urinary tract infection	1095	190	92	18	172	74	831	1.12757	0.01770	1.17520	2.01793	0.68442	0.5652818254	1.0000000000	15.96347	0.16357	84	85	16	106	7	2	0.33845	-2.15640
21	15777000	Prediabetes	60	301011002	Escherichia coli urinary tract infection	1095	333	92	54	279	38	724	1.93008	0.18621	3.68761	5.71081	2.38118	0.0000000046	0.0000003248	27.97808	0.92447	159	85	51	174	7	3	-0.22314	-2.66226
20	80394007	Hyperglycemia (disorder)	60	301011002	Escherichia coli urinary tract infection	1095	55	92	9	46	83	957	1.94763	0.06600	2.25589	4.76979	1.06693	0.0418136945	0.3917189013	4.62100	0.83110	23	85	8	32	7	1	0.37372	-2.14196
19	237602007	Metabolic syndrome X (disorder)	60	301011002	Escherichia coli urinary tract infection	1095	64	92	9	55	83	948	1.67374	0.05084	1.86900	3.91575	0.89208	0.1021330326	0.6291042150	5.37717	0.64901	28	85	8	36	7	1	0.37372	-2.10684
18	302870006	Hypertriglyceridemia (disorder)	60	301011002	Escherichia coli urinary tract infection	1095	64	92	9	55	83	948	1.67374	0.05084	1.86900	3.91575	0.89208	0.1021330326	0.6291042150	5.37717	0.64901	28	85	8	36	7	1	0.37372	-2.10684
17	368581000119106	Neuropathy due to type 2 diabetes mellitus (disorder)	60	301011002	Escherichia coli urinary tract infection	1095	28	92	1	27	91	976	0.42508	-0.02821	0.39723	2.95715	0.05336	0.5051309018	1.0000000000	2.35251	-0.74524	7	85	0	21	7	1	-2.07944	-3.09104
129	47505003	Posttraumatic stress disorder	34	72892002	Normal pregnancy	1095	4	384	1	3	383	708	0.71289	-0.01278	0.61619	5.94400	0.06388	1.0000000000	1.0000000000	1.40274	-0.26468	1	384	1	3	0	0	5.95324	0.69315
15	40055000	Chronic sinusitis (disorder)	60	301011002	Escherichia coli urinary tract infection	1095	216	92	28	188	64	815	1.54287	0.08150	1.89661	3.03929	1.18354	0.0092655740	0.1462827487	18.14795	0.59886	104	85	26	112	7	2	-0.05264	-2.43361
14	10509002	Acute bronchitis (disorder)	60	301011002	Escherichia coli urinary tract infection	1095	863	92	80	783	12	220	1.10333	0.06036	1.87314	3.49915	1.00271	0.0458944511	0.4105382250	72.50776	0.14003	418	85	73	445	7	7	0.07899	-2.26179
13	370247008	Facial laceration	60	301011002	Escherichia coli urinary tract infection	1095	109	92	12	97	80	906	1.31033	0.03125	1.40103	2.66197	0.73738	0.2786307242	0.9565195531	9.15799	0.35590	55	85	12	54	7	0	2.08980	1.71979
125	1734006	Fracture of the vertebral column with spinal cord injury	34	72892002	Normal pregnancy	1095	5	384	1	4	383	707	0.57031	-0.02139	0.46149	4.14348	0.05140	0.6625532957	1.0000000000	1.75342	-0.46123	3	384	1	2	0	0	5.95324	1.38629
124	1501000119109	Proliferative diabetic retinopathy due to type II diabetes mellitus (disorder)	34	72892002	Normal pregnancy	1095	1	384	1	0	383	711	2.85156	0.04114	0.00000	0.00000	0.00000	0.3506849315	1.0000000000	0.35068	0.56631	1	384	1	0	0	0	5.95324	0.69315
10	62106007	Concussion with no loss of consciousness	60	301011002	Escherichia coli urinary tract infection	1095	206	92	20	186	72	817	1.15555	0.02268	1.22013	2.05305	0.72513	0.4854367600	1.0000000000	17.30776	0.19793	96	85	19	110	7	1	-0.37949	-2.90904
9	44465007	Sprain of ankle	60	301011002	Escherichia coli urinary tract infection	1095	362	92	36	326	56	677	1.18364	0.03909	1.33501	2.07091	0.86062	0.2038553846	0.8524167357	30.41461	0.23609	185	85	34	177	7	2	-0.25131	-2.63153
8	233678006	Childhood asthma	60	301011002	Escherichia coli urinary tract infection	1095	45	92	4	41	88	962	1.05797	0.00363	1.06652	3.04659	0.37336	0.7861656022	1.0000000000	3.78082	0.06467	25	85	4	20	7	0	3.10234	1.98100
7	75498004	Acute bacterial sinusitis (disorder)	60	301011002	Escherichia coli urinary tract infection	1095	187	92	23	164	69	839	1.46390	0.06376	1.70528	2.81350	1.03359	0.0421941173	0.3931846725	15.71142	0.52220	89	85	22	98	7	1	-0.49766	-2.97663
6	39848009	Whiplash injury to neck	60	301011002	Escherichia coli urinary tract infection	1095	182	92	20	162	72	841	1.30793	0.04164	1.44204	2.43326	0.85461	0.1868737064	0.8181443419	15.29132	0.36629	92	85	19	90	7	1	-0.37949	-2.74577
5	284549007	Laceration of hand	60	301011002	Escherichia coli urinary tract infection	1095	104	92	13	91	79	912	1.48777	0.04786	1.64919	3.08090	0.88280	0.1342508654	0.7198864363	8.73790	0.52374	54	85	12	50	7	1	0.01036	-2.22708
4	195662009	Acute viral pharyngitis (disorder)	60	301011002	Escherichia coli urinary tract infection	1095	890	92	86	804	6	199	1.15010	0.09472	3.54768	8.23433	1.52848	0.0011202267	0.0272154825	74.77626	0.19927	430	85	79	460	7	7	0.03727	-2.33742
3	65363002	Otitis media	60	301011002	Escherichia coli urinary tract infection	1095	580	92	35	545	57	458	0.71823	-0.09056	0.51601	0.80030	0.33272	0.0031068105	0.0617004139	48.73059	-0.46614	277	85	32	303	7	3	0.09247	-2.35737
115	36923009	Major depression  single episode	34	72892002	Normal pregnancy	1095	6	384	3	3	381	708	1.42578	0.02323	1.85827	9.25153	0.37325	0.4284578995	1.0000000000	2.10411	0.36582	3	384	3	3	0	0	4.85981	0.69315
1	444814009	Viral sinusitis (disorder)	60	301011002	Escherichia coli urinary tract infection	1095	993	92	91	902	1	101	1.09073	0.08574	10.18958	73.90444	1.40489	0.0020763648	0.0446723784	83.43014	0.12388	478	85	84	515	7	7	0.00593	-2.41107
113	443165006	Pathological fracture due to osteoporosis (disorder)	34	72892002	Normal pregnancy	1095	10	384	4	6	380	705	1.14062	0.00992	1.23684	4.40988	0.34690	0.7472136338	1.0000000000	3.50685	0.14981	7	384	4	3	0	0	4.57471	1.01160
112	49436004	Atrial Fibrillation	34	72892002	Normal pregnancy	1095	35	384	3	32	381	679	0.24442	-0.10090	0.16708	0.54924	0.05082	0.0004521393	0.0128028349	12.27397	-1.73053	9	384	3	26	0	0	4.85981	1.38629
111	235919008	Cholelithiasis	34	72892002	Normal pregnancy	1095	9	384	7	2	377	709	2.21788	0.08148	6.58223	31.84246	1.36063	0.0110297229	0.1640998430	3.15616	0.94475	7	384	7	2	0	0	4.02280	0.69315
110	65275009	Acute Cholecystitis	34	72892002	Normal pregnancy	1095	9	384	7	2	377	709	2.21788	0.08148	6.58223	31.84246	1.36063	0.0110297229	0.1640998430	3.15616	0.94475	7	384	7	2	0	0	4.02280	0.69315
109	90560007	Gout	34	72892002	Normal pregnancy	1095	4	384	0	4	384	707	0.00000	-0.04450	0.00000	0.00000	0.00000	0.3039494249	0.9949586182	1.40274	-1.26468	0	384	0	4	0	0	0.00000	0.00000
108	40930008	Hypothyroidism (disorder)	34	72892002	Normal pregnancy	1095	13	384	10	3	374	708	2.19351	0.09614	6.31016	23.06780	1.72613	0.0024217311	0.0506141803	4.55890	0.98463	11	384	10	2	0	0	3.67377	0.74194
107	40275004	Contact dermatitis	34	72892002	Normal pregnancy	1095	18	384	8	10	376	701	1.26736	0.02540	1.49149	3.81093	0.58373	0.4572056144	1.0000000000	6.31233	0.29959	9	384	8	9	0	0	3.89182	0.75377
106	24079001	Atopic dermatitis	34	72892002	Normal pregnancy	1095	20	384	5	15	379	696	0.71289	-0.02878	0.61214	1.69728	0.22077	0.4789673734	1.0000000000	7.01370	-0.41751	13	384	5	7	0	0	4.35414	1.28093
105	363406005	Malignant tumor of colon	34	72892002	Normal pregnancy	1095	6	384	2	4	382	707	0.95052	-0.00270	0.92539	5.07537	0.16873	1.0000000000	1.0000000000	2.10411	-0.04922	4	384	2	2	0	0	5.26269	1.09861
104	367498001	Seasonal allergic rhinitis	34	72892002	Normal pregnancy	1095	20	384	5	15	379	696	0.71289	-0.02878	0.61214	1.69728	0.22077	0.4789673734	1.0000000000	7.01370	-0.41751	9	384	5	11	0	0	4.35414	1.02962
103	157141000119108	Proteinuria due to type 2 diabetes mellitus (disorder)	34	72892002	Normal pregnancy	1095	3	384	1	2	383	709	0.95052	-0.00191	0.92559	10.24047	0.08366	1.0000000000	1.0000000000	1.05205	-0.03707	1	384	1	2	0	0	5.95324	0.69315
102	90781000119102	Microalbuminuria due to type 2 diabetes mellitus (disorder)	34	72892002	Normal pregnancy	1095	6	384	3	3	381	708	1.42578	0.02323	1.85827	9.25153	0.37325	0.4284578995	1.0000000000	2.10411	0.36582	3	384	3	3	0	0	4.85981	0.69315
101	433144002	Chronic kidney disease stage 3 (disorder)	34	72892002	Normal pregnancy	1095	3	384	1	2	383	709	0.95052	-0.00191	0.92559	10.24047	0.08366	1.0000000000	1.0000000000	1.05205	-0.03707	1	384	1	2	0	0	5.95324	0.69315
100	161622006	History of lower limb amputation (situation)	34	72892002	Normal pregnancy	1095	1	384	0	1	384	710	0.00000	-0.02222	0.00000	0.00000	0.00000	1.0000000000	1.0000000000	0.35068	-0.43369	0	384	0	1	0	0	0.00000	0.00000
99	30832001	Rupture of patellar tendon	34	72892002	Normal pregnancy	1095	23	384	12	11	372	700	1.48777	0.05251	2.05279	4.69709	0.89714	0.1196726255	0.6843537581	8.06575	0.52001	14	384	12	9	0	0	3.49651	0.77319
98	1551000119108	Nonproliferative diabetic retinopathy due to type 2 diabetes mellitus (disorder)	34	72892002	Normal pregnancy	1095	12	384	7	5	377	706	1.66341	0.05132	2.62175	8.31674	0.82647	0.1254887310	0.6945902319	4.20822	0.61921	7	384	7	5	0	0	4.02280	0.69315
97	403192003	Third degree burn	34	72892002	Normal pregnancy	1095	8	384	2	6	382	705	0.71289	-0.01810	0.61518	3.06273	0.12357	0.7202140001	1.0000000000	2.80548	-0.34312	3	384	2	5	0	0	5.26269	0.91629
96	283371005	Laceration of forearm	34	72892002	Normal pregnancy	1095	75	384	35	40	349	671	1.33073	0.06591	1.68231	2.69633	1.04963	0.0330981789	0.3362683035	26.30137	0.39902	39	384	35	36	0	0	2.48252	0.74872
95	84757009	Epilepsy	34	72892002	Normal pregnancy	1095	30	384	8	22	376	689	0.76042	-0.02955	0.66634	1.51126	0.29380	0.4381566098	1.0000000000	10.52055	-0.35621	13	384	8	17	0	0	3.89182	0.96508
94	703151001	History of single seizure (situation)	34	72892002	Normal pregnancy	1095	39	384	9	30	375	681	0.65805	-0.04829	0.54480	1.15969	0.25594	0.1254821149	0.6945902319	13.67671	-0.55353	14	384	9	25	0	0	3.77659	0.93827
93	128613002	Seizure disorder	34	72892002	Normal pregnancy	1095	39	384	9	30	375	681	0.65805	-0.04829	0.54480	1.15969	0.25594	0.1254821149	0.6945902319	13.67671	-0.55353	14	384	9	25	0	0	3.77659	0.93827
92	82423001	Chronic pain	34	72892002	Normal pregnancy	1095	52	384	17	35	367	676	0.93224	-0.01112	0.89467	1.61913	0.49436	0.7676382306	1.0000000000	18.23562	-0.09578	24	384	17	28	0	0	3.16075	0.88036
91	64859006	Osteoporosis (disorder)	34	72892002	Normal pregnancy	1095	37	384	14	23	370	688	1.07897	0.01085	1.13184	2.22586	0.57554	0.7281065506	1.0000000000	12.97534	0.10208	24	384	14	13	0	0	3.34739	0.99853
90	444470001	Injury of anterior cruciate ligament	34	72892002	Normal pregnancy	1095	19	384	7	12	377	699	1.05058	0.00494	1.08156	2.77024	0.42227	1.0000000000	1.0000000000	6.66301	0.06209	10	384	7	9	0	0	4.02280	0.88730
89	47693006	Rupture of appendix	34	72892002	Normal pregnancy	1095	20	384	8	12	376	699	1.14062	0.01410	1.23936	3.05853	0.50221	0.6420731151	1.0000000000	7.01370	0.16746	10	384	8	10	0	0	3.89182	0.81093
88	197927001	Recurrent urinary tract infection	34	72892002	Normal pregnancy	1095	8	384	8	0	376	711	2.85156	0.11673	0.00000	0.00000	0.00000	0.0002180680	0.0069355119	2.80548	1.24185	8	384	8	0	0	0	3.89182	0.69315
87	109838007	Overlapping malignant neoplasm of colon	34	72892002	Normal pregnancy	1095	8	384	4	4	380	707	1.42578	0.02684	1.86053	7.48096	0.46272	0.4616682986	1.0000000000	2.80548	0.39385	5	384	4	3	0	0	4.57471	0.81093
86	713197008	Recurrent rectal polyp	34	72892002	Normal pregnancy	1095	22	384	8	14	376	697	1.03693	0.00389	1.05927	2.54785	0.44039	1.0000000000	1.0000000000	7.71507	0.04641	12	384	8	10	0	0	3.89182	0.91629
85	241929008	Acute allergic reaction	34	72892002	Normal pregnancy	1095	47	384	17	30	367	681	1.03142	0.00489	1.05150	1.93208	0.57226	0.8766898115	1.0000000000	16.48219	0.04211	25	384	17	22	0	0	3.16075	0.90446
84	232353008	Perennial allergic rhinitis with seasonal variation	34	72892002	Normal pregnancy	1095	29	384	12	17	372	694	1.17996	0.02181	1.31689	2.78684	0.62228	0.5545045521	1.0000000000	10.16986	0.21890	14	384	12	15	0	0	3.49651	0.77319
83	110030002	Concussion injury of brain	34	72892002	Normal pregnancy	1095	7	384	1	6	383	705	0.40737	-0.03493	0.30679	2.55758	0.03680	0.4320698707	1.0000000000	2.45479	-0.78860	1	384	1	6	0	0	5.95324	0.69315
82	94260004	Secondary malignant neoplasm of colon	34	72892002	Normal pregnancy	1095	4	384	2	2	382	709	1.42578	0.01895	1.85602	13.22812	0.26042	0.6155045907	1.0000000000	1.40274	0.32028	2	384	2	2	0	0	5.26269	0.69315
81	236077008	Protracted diarrhea	34	72892002	Normal pregnancy	1095	4	384	2	2	382	709	1.42578	0.01895	1.85602	13.22812	0.26042	0.6155045907	1.0000000000	1.40274	0.32028	2	384	2	2	0	0	5.26269	0.69315
80	6072007	Bleeding from anus	34	72892002	Normal pregnancy	1095	4	384	2	2	382	709	1.42578	0.01895	1.85602	13.22812	0.26042	0.6155045907	1.0000000000	1.40274	0.32028	2	384	2	2	0	0	5.26269	0.69315
79	45816000	Pyelonephritis	34	72892002	Normal pregnancy	1095	1	384	0	1	384	710	0.00000	-0.02222	0.00000	0.00000	0.00000	1.0000000000	1.0000000000	0.35068	-0.43369	1	384	0	0	0	0	0.00000	0.00000
78	239872002	Osteoarthritis of hip	34	72892002	Normal pregnancy	1095	21	384	11	10	373	701	1.49368	0.05073	2.06729	4.91246	0.86997	0.1075793907	0.6459178466	7.36438	0.52070	13	384	11	8	0	0	3.58099	0.78016
77	422034002	Diabetic retinopathy associated with type II diabetes mellitus (disorder)	34	72892002	Normal pregnancy	1095	20	384	8	12	376	699	1.14062	0.01410	1.23936	3.05853	0.50221	0.6420731151	1.0000000000	7.01370	0.16746	8	384	8	12	0	0	3.89182	0.69315
76	127013003	Diabetic renal disease (disorder)	34	72892002	Normal pregnancy	1095	28	384	9	19	375	692	0.91657	-0.00993	0.87411	1.95120	0.39158	0.8425845215	1.0000000000	9.81918	-0.11359	10	384	9	18	0	0	3.77659	0.74721
75	431855005	Chronic kidney disease stage 1 (disorder)	34	72892002	Normal pregnancy	1095	28	384	9	19	375	692	0.91657	-0.00993	0.87411	1.95120	0.39158	0.8425845215	1.0000000000	9.81918	-0.11359	10	384	9	18	0	0	3.77659	0.74721
74	79586000	Tubal pregnancy	34	72892002	Normal pregnancy	1095	23	384	23	0	361	711	2.85156	0.19931	0.00000	0.00000	0.00000	0.0000000000	0.0000000019	8.06575	1.40454	23	384	23	0	0	0	2.87332	0.69315
73	196416002	Impacted molars	34	72892002	Normal pregnancy	1095	49	384	21	28	363	683	1.22210	0.03533	1.41116	2.52023	0.79015	0.2834759319	0.9659403678	17.18356	0.27487	25	384	21	24	0	0	2.95936	0.78412
72	35999006	Blighted ovum	34	72892002	Normal pregnancy	1095	53	384	53	0	331	711	2.85156	0.30688	0.00000	0.00000	0.00000	0.0000000000	0.0000000000	18.58630	1.46311	53	384	53	0	0	0	2.10964	0.69315
71	201834006	Localized  primary osteoarthritis of the hand	34	72892002	Normal pregnancy	1095	28	384	19	9	365	702	1.93499	0.11131	4.06027	9.06458	1.81871	0.0004301580	0.0123396314	9.81918	0.88641	19	384	19	9	0	0	3.05450	0.69315
70	87433001	Pulmonary emphysema (disorder)	34	72892002	Normal pregnancy	1095	17	384	7	10	377	701	1.17417	0.01607	1.30159	3.44715	0.49146	0.6140009066	1.0000000000	5.96164	0.20057	9	384	7	8	0	0	4.02280	0.82668
69	233604007	Pneumonia	34	72892002	Normal pregnancy	1095	7	384	2	5	382	706	0.81473	-0.01092	0.73927	3.82840	0.14275	1.0000000000	1.0000000000	2.45479	-0.20364	3	384	2	4	0	0	5.26269	0.91629
68	26929004	Alzheimer's disease (disorder)	34	72892002	Normal pregnancy	1095	23	384	12	11	372	700	1.48777	0.05251	2.05279	4.69709	0.89714	0.1196726255	0.6843537581	8.06575	0.52001	15	384	12	8	0	0	3.49651	0.81093
67	403191005	Second degree burn	34	72892002	Normal pregnancy	1095	49	384	18	31	366	680	1.04751	0.00756	1.07879	1.95499	0.59530	0.8784132790	1.0000000000	17.18356	0.06336	23	384	18	26	0	0	3.10608	0.82320
66	55822004	Hyperlipidemia	34	72892002	Normal pregnancy	1095	119	384	55	64	329	647	1.31795	0.08159	1.69002	2.48127	1.15109	0.0081107602	0.1325982198	41.73151	0.39013	64	384	55	55	0	0	2.07717	0.77179
65	239873007	Osteoarthritis of knee	34	72892002	Normal pregnancy	1095	57	384	27	30	357	681	1.35074	0.06040	1.71681	2.93273	1.00501	0.0627838441	0.4872825669	19.98904	0.41579	30	384	27	27	0	0	2.72276	0.74721
64	444448004	Injury of medial collateral ligament of knee	34	72892002	Normal pregnancy	1095	32	384	14	18	370	693	1.24756	0.03157	1.45676	2.96226	0.71639	0.3473895320	1.0000000000	11.22192	0.29549	17	384	14	15	0	0	3.34739	0.79493
63	68496003	Polyp of colon	34	72892002	Normal pregnancy	1095	91	384	36	55	348	656	1.12809	0.02834	1.23386	1.91548	0.79479	0.3600101741	1.0000000000	31.91233	0.16890	43	384	36	48	0	0	2.45674	0.78593
62	185086009	Chronic obstructive bronchitis (disorder)	34	72892002	Normal pregnancy	1095	6	384	4	2	380	709	1.90104	0.04915	3.73158	20.46630	0.68037	0.1919356224	0.8268943621	2.10411	0.68775	4	384	4	2	0	0	4.57471	0.69315
61	198992004	Antepartum eclampsia	34	72892002	Normal pregnancy	1095	96	384	96	0	288	711	2.85156	0.42182	0.00000	0.00000	0.00000	0.0000000000	0.0000000000	33.66575	1.48447	96	384	96	0	0	0	1.60944	0.69315
60	301011002	Escherichia coli urinary tract infection	34	72892002	Normal pregnancy	1095	92	384	84	8	300	703	2.60360	0.35692	24.60500	51.45143	11.76655	0.0000000000	0.0000000000	32.26301	1.35354	85	384	84	7	0	0	1.71765	0.69908
59	262574004	Bullet wound	34	72892002	Normal pregnancy	1095	20	384	6	14	378	697	0.85547	-0.01449	0.79025	2.07325	0.30121	0.8138977132	1.0000000000	7.01370	-0.19511	9	384	6	11	0	0	4.17439	0.91629
58	239720000	Tear of meniscus of knee	34	72892002	Normal pregnancy	1095	20	384	8	12	376	699	1.14062	0.01410	1.23936	3.05853	0.50221	0.6420731151	1.0000000000	7.01370	0.16746	10	384	8	10	0	0	3.89182	0.81093
57	192127007	Child attention deficit disorder	34	72892002	Normal pregnancy	1095	76	384	21	55	363	656	0.78793	-0.04256	0.69001	1.15928	0.41069	0.1720623523	0.7978675799	26.65205	-0.32988	24	384	21	52	0	0	2.95936	0.76214
56	92691004	Carcinoma in situ of prostate (disorder)	34	72892002	Normal pregnancy	1095	23	384	0	23	384	688	0.00000	-0.10765	0.00000	0.00000	0.00000	0.0000666745	0.0023888504	8.06575	-3.18043	0	384	0	23	0	0	0.00000	0.00000
55	126906006	Neoplasm of prostate	34	72892002	Normal pregnancy	1095	24	384	0	24	384	687	0.00000	-0.11001	0.00000	0.00000	0.00000	0.0000376842	0.0014258270	8.41644	-3.23518	0	384	0	24	0	0	0.00000	0.00000
54	5602001	Opioid abuse (disorder)	34	72892002	Normal pregnancy	1095	7	384	0	7	384	704	0.00000	-0.05895	0.00000	0.00000	0.00000	0.1036422871	0.6331122908	2.45479	-1.78860	0	384	0	7	0	0	0.00000	0.00000
53	7200002	Alcoholism	34	72892002	Normal pregnancy	1095	5	384	0	5	384	706	0.00000	-0.04977	0.00000	0.00000	0.00000	0.1688454808	0.7953568293	1.75342	-1.46123	0	384	0	5	0	0	0.00000	0.00000
52	124171000119105	Chronic intractable migraine without aura	34	72892002	Normal pregnancy	1095	51	384	18	33	366	678	1.00643	0.00105	1.01043	1.81954	0.56112	1.0000000000	1.0000000000	17.88493	0.00876	21	384	18	30	0	0	3.10608	0.77319
51	403190006	First degree burn	34	72892002	Normal pregnancy	1095	79	384	37	42	347	669	1.33554	0.06876	1.69844	2.69191	1.07161	0.0273157313	0.3044518076	27.70411	0.40474	43	384	37	36	0	0	2.43171	0.77111
50	446096008	Perennial allergic rhinitis	34	72892002	Normal pregnancy	1095	26	384	8	18	376	693	0.87740	-0.01405	0.81915	1.90169	0.35285	0.8355793491	1.0000000000	9.11781	-0.16890	14	384	8	12	0	0	3.89182	1.01160
49	88805009	Chronic congestive heart failure (disorder)	34	72892002	Normal pregnancy	1095	10	384	4	6	380	705	1.14062	0.00992	1.23684	4.40988	0.34690	0.7472136338	1.0000000000	3.50685	0.14981	5	384	4	5	0	0	4.57471	0.81093
48	55680006	Drug overdose	34	72892002	Normal pregnancy	1095	50	384	21	29	363	682	1.19766	0.03177	1.36050	2.41985	0.76491	0.2923597691	0.9783965127	17.53425	0.24731	24	384	21	26	0	0	2.95936	0.76214
47	359817006	Closed fracture of hip	34	72892002	Normal pregnancy	1095	29	384	6	23	378	688	0.58998	-0.04970	0.47481	1.17628	0.19166	0.1162650019	0.6767733336	10.16986	-0.67418	11	384	6	18	0	0	4.17439	1.04145
46	62564004	Concussion with loss of consciousness	34	72892002	Normal pregnancy	1095	67	384	31	36	353	675	1.31938	0.05992	1.64660	2.70717	1.00152	0.0634639370	0.4910507321	23.49589	0.38553	36	384	31	31	0	0	2.59429	0.77071
45	263102004	Fracture subluxation of wrist	34	72892002	Normal pregnancy	1095	109	384	38	71	346	640	0.99412	-0.00144	0.98999	1.49934	0.65367	1.0000000000	1.0000000000	38.22466	-0.00829	51	384	38	58	0	0	2.40742	0.85105
44	58150001	Fracture of clavicle	34	72892002	Normal pregnancy	1095	112	384	49	63	335	648	1.24756	0.06141	1.50448	2.23532	1.01258	0.0470845649	0.4166414421	39.27671	0.31198	55	384	49	57	0	0	2.17892	0.75257
43	307731004	Injury of tendon of the rotator cuff of shoulder	34	72892002	Normal pregnancy	1095	51	384	24	27	360	684	1.34191	0.05554	1.68889	2.96993	0.96041	0.0721617161	0.5300715848	17.88493	0.40469	26	384	24	25	0	0	2.83321	0.73397
42	16114001	Fracture of ankle	34	72892002	Normal pregnancy	1095	108	384	41	67	343	644	1.08254	0.02006	1.14895	1.73146	0.76241	0.5247479352	1.0000000000	37.87397	0.11158	48	384	41	60	0	0	2.33852	0.77506
41	283385000	Laceration of thigh	34	72892002	Normal pregnancy	1095	105	384	46	59	338	652	1.24926	0.05966	1.50396	2.26004	1.00082	0.0530473810	0.4451719986	36.82192	0.31344	50	384	46	55	0	0	2.23514	0.73571
40	428251008	History of appendectomy	34	72892002	Normal pregnancy	1095	51	384	20	31	364	680	1.11826	0.01921	1.20525	2.14480	0.67727	0.5492262316	1.0000000000	17.88493	0.15315	27	384	20	24	0	0	3.00568	0.85442
39	74400008	Appendicitis	34	72892002	Normal pregnancy	1095	51	384	20	31	364	680	1.11826	0.01921	1.20525	2.14480	0.67727	0.5492262316	1.0000000000	17.88493	0.15315	27	384	20	24	0	0	3.00568	0.85442
38	398254007	Preeclampsia	34	72892002	Normal pregnancy	1095	101	384	101	0	283	711	2.85156	0.43375	0.00000	0.00000	0.00000	0.0000000000	0.0000000000	35.41918	1.48580	101	384	101	0	0	0	1.56903	0.69315
37	38822007	Cystitis	34	72892002	Normal pregnancy	1095	71	384	68	3	316	708	2.73107	0.33499	50.78481	162.62625	15.85904	0.0000000000	0.0000000000	24.89863	1.41372	68	384	68	3	0	0	1.89417	0.69315
36	156073000	Fetus with unknown complication	34	72892002	Normal pregnancy	1095	125	384	125	0	259	711	2.85156	0.48847	0.00000	0.00000	0.00000	0.0000000000	0.0000000000	43.83562	1.49071	125	384	125	0	0	0	1.40413	0.69315
35	19169002	Miscarriage in first trimester	34	72892002	Normal pregnancy	1095	174	384	168	6	216	705	2.75323	0.56004	91.38889	209.26110	39.91152	0.0000000000	0.0000000000	61.01918	1.44624	174	384	168	0	0	0	1.18958	0.71085
33	429007001	History of cardiac arrest (situation)	34	72892002	Normal pregnancy	1095	42	384	19	23	365	688	1.28999	0.04256	1.55712	2.89670	0.83703	0.1868682703	0.8181443419	14.72877	0.34659	24	384	19	18	0	0	3.05450	0.81676
32	410429000	Cardiac Arrest	34	72892002	Normal pregnancy	1095	42	384	19	23	365	688	1.28999	0.04256	1.55712	2.89670	0.83703	0.1868682703	0.8181443419	14.72877	0.34659	24	384	19	18	0	0	3.05450	0.81676
31	230690007	Stroke	34	72892002	Normal pregnancy	1095	62	384	24	38	360	673	1.10383	0.01869	1.18070	1.99955	0.69719	0.5840424394	1.0000000000	21.74247	0.13654	32	384	24	30	0	0	2.83321	0.84730
30	399211009	History of myocardial infarction (situation)	34	72892002	Normal pregnancy	1095	31	384	2	29	382	682	0.18397	-0.10236	0.12313	0.51883	0.02922	0.0003759758	0.0110378462	10.87123	-1.98444	2	384	2	29	0	0	5.26269	0.69315
29	22298006	Myocardial Infarction	34	72892002	Normal pregnancy	1095	31	384	2	29	382	682	0.18397	-0.10236	0.12313	0.51883	0.02922	0.0003759758	0.0110378462	10.87123	-1.98444	2	384	2	29	0	0	5.26269	0.69315
28	53741008	Coronary Heart Disease	34	72892002	Normal pregnancy	1095	80	384	22	58	362	653	0.78418	-0.04453	0.68423	1.13635	0.41199	0.1464415691	0.7491049496	28.05479	-0.33714	24	384	22	56	0	0	2.91531	0.73760
27	408512008	Body mass index 40+ - severely obese (finding)	34	72892002	Normal pregnancy	1095	97	384	62	35	322	676	1.82265	0.18848	3.71890	5.74624	2.40683	0.0000000014	0.0000001088	34.01644	0.84732	67	384	62	30	0	0	1.97318	0.73268
26	33737001	Fracture of rib	34	72892002	Normal pregnancy	1095	54	384	23	31	361	680	1.21455	0.03591	1.39755	2.43271	0.80287	0.2441392902	0.9133257124	18.93699	0.26759	32	384	23	22	0	0	2.87332	0.87184
25	284551006	Laceration of foot	34	72892002	Normal pregnancy	1095	118	384	44	74	340	637	1.06329	0.01617	1.11399	1.65468	0.74998	0.6102820121	1.0000000000	41.38082	0.08651	53	384	44	65	0	0	2.27493	0.79052
24	162864005	Body mass index 30+ - obesity (finding)	34	72892002	Normal pregnancy	1095	439	384	208	231	176	480	1.35108	0.21107	2.45573	3.16842	1.90335	0.0000000000	0.0000000004	153.95068	0.43169	226	384	208	213	0	0	1.04597	0.73551
23	36971009	Sinusitis (disorder)	34	72892002	Normal pregnancy	1095	190	384	68	122	316	589	1.02056	0.00692	1.03891	1.44016	0.74945	0.8672207511	1.0000000000	66.63014	0.02893	84	384	68	106	0	0	1.89417	0.80437
22	70704007	Sprain of wrist	34	72892002	Normal pregnancy	1095	195	384	73	122	311	589	1.06751	0.02309	1.13323	1.56203	0.82214	0.4569327576	1.0000000000	68.38356	0.09293	90	384	73	105	0	0	1.83422	0.80329
21	15777000	Prediabetes	34	72892002	Normal pregnancy	1095	333	384	148	185	236	526	1.26736	0.12989	1.78305	2.32442	1.36777	0.0000254949	0.0009902393	116.77808	0.33924	159	384	148	174	0	0	1.27943	0.72964
20	80394007	Hyperglycemia (disorder)	34	72892002	Normal pregnancy	1095	55	384	23	32	361	679	1.19247	0.03253	1.35189	2.34500	0.77936	0.3106937712	1.0000000000	19.28767	0.24243	23	384	23	32	0	0	2.87332	0.69315
19	237602007	Metabolic syndrome X (disorder)	34	72892002	Normal pregnancy	1095	64	384	27	37	357	674	1.20300	0.03717	1.37770	2.29979	0.82531	0.2263184424	0.8836028956	22.44384	0.25622	28	384	27	36	0	0	2.72276	0.71150
18	302870006	Hypertriglyceridemia (disorder)	34	72892002	Normal pregnancy	1095	64	384	27	37	357	674	1.20300	0.03717	1.37770	2.29979	0.82531	0.2263184424	0.8836028956	22.44384	0.25622	28	384	27	36	0	0	2.72276	0.71150
17	368581000119106	Neuropathy due to type 2 diabetes mellitus (disorder)	34	72892002	Normal pregnancy	1095	28	384	7	21	377	690	0.71289	-0.03418	0.61008	1.44831	0.25699	0.3183157652	1.0000000000	9.81918	-0.43552	7	384	7	21	0	0	4.02280	0.69315
16	44054006	Diabetes	34	72892002	Normal pregnancy	1095	68	384	28	40	356	671	1.17417	0.03294	1.31938	2.17474	0.80045	0.2947590139	0.9819334438	23.84658	0.22301	29	384	28	39	0	0	2.68882	0.71085
15	40055000	Chronic sinusitis (disorder)	34	72892002	Normal pregnancy	1095	216	384	86	130	298	581	1.13534	0.04931	1.28978	1.75174	0.94964	0.1115610166	0.6583985495	75.74795	0.18089	104	384	86	112	0	0	1.69839	0.79268
14	10509002	Acute bronchitis (disorder)	34	72892002	Normal pregnancy	1095	863	384	338	525	46	186	1.11683	0.16560	2.60323	3.69598	1.83356	0.0000000190	0.0000012376	302.64110	0.15892	418	384	338	445	0	0	0.75898	0.80500
13	370247008	Facial laceration	34	72892002	Normal pregnancy	1095	109	384	49	60	335	651	1.28190	0.06888	1.58701	2.36693	1.06409	0.0262095230	0.2953365763	38.22466	0.35017	55	384	49	54	0	0	2.17892	0.75257
12	65966004	Fracture of forearm	34	72892002	Normal pregnancy	1095	123	384	41	82	343	629	0.95052	-0.01294	0.91691	1.36418	0.61628	0.6897613922	1.0000000000	43.13425	-0.07151	55	384	41	68	0	0	2.33852	0.85078
11	38341003	Hypertension	34	72892002	Normal pregnancy	1095	278	384	114	164	270	547	1.16935	0.07260	1.40827	1.86322	1.06440	0.0197880897	0.2463827683	97.49041	0.22358	131	384	114	147	0	0	1.47440	0.76506
10	62106007	Concussion with no loss of consciousness	34	72892002	Normal pregnancy	1095	206	384	83	123	301	588	1.14893	0.05269	1.31821	1.79933	0.96573	0.0888735022	0.5905613944	72.24110	0.19774	96	384	83	110	0	0	1.72749	0.76855
9	44465007	Sprain of ankle	34	72892002	Normal pregnancy	1095	362	384	152	210	232	501	1.19734	0.10192	1.56305	2.02792	1.20475	0.0009567418	0.0240638391	126.94795	0.25797	185	384	152	177	0	0	1.26025	0.79620
8	233678006	Childhood asthma	34	72892002	Normal pregnancy	1095	45	384	17	28	367	683	1.07726	0.01175	1.12991	2.09170	0.61037	0.7502076672	1.0000000000	15.78082	0.10118	25	384	17	20	0	0	3.16075	0.90446
7	75498004	Acute bacterial sinusitis (disorder)	34	72892002	Normal pregnancy	1095	187	384	75	112	309	599	1.14367	0.04792	1.29811	1.79313	0.93975	0.1296721225	0.7083148048	65.57808	0.19095	89	384	75	98	0	0	1.81156	0.78238
6	39848009	Whiplash injury to neck	34	72892002	Normal pregnancy	1095	182	384	78	104	306	607	1.22210	0.07287	1.48775	2.05732	1.07586	0.0173078001	0.2250783253	63.82466	0.28531	92	384	78	90	0	0	1.77886	0.77909
5	284549007	Laceration of hand	34	72892002	Normal pregnancy	1095	104	384	52	52	332	659	1.42578	0.10137	1.98494	2.98015	1.32208	0.0011223519	0.0272154825	36.47123	0.50021	54	384	52	50	0	0	2.12640	0.71220
4	195662009	Acute viral pharyngitis (disorder)	34	72892002	Normal pregnancy	1095	890	384	342	548	42	163	1.09577	0.14665	2.42205	3.48923	1.68127	0.0000006399	0.0000332347	312.10959	0.13154	430	384	342	460	0	0	0.75274	0.81417
3	65363002	Otitis media	34	72892002	Normal pregnancy	1095	580	384	194	386	190	325	0.95380	-0.03603	0.85969	1.10230	0.67048	0.2534974921	0.9133257124	203.39726	-0.06790	277	384	194	303	0	0	1.09172	0.88700
2	43878008	Streptococcal sore throat (disorder)	34	72892002	Normal pregnancy	1095	523	384	195	328	189	383	1.06320	0.04441	1.20475	1.54466	0.93964	0.1453143213	0.7442060164	183.40822	0.08795	246	384	195	277	0	0	1.08830	0.81605
1	444814009	Viral sinusitis (disorder)	34	72892002	Normal pregnancy	1095	993	384	379	614	5	97	1.08836	0.20261	11.97492	29.68725	4.83031	0.0000000000	0.0000000000	348.23014	0.12182	478	384	379	515	0	0	0.69972	0.81590
111	235919008	Cholelithiasis	8	233678006	Childhood asthma	1095	9	45	1	8	44	1042	2.70370	0.03211	2.96023	24.18894	0.36227	0.3155189275	1.0000000000	0.36986	0.54597	7	25	1	2	20	0	3.25810	2.07944
109	90560007	Gout	8	233678006	Childhood asthma	1095	4	45	0	4	45	1046	0.00000	-0.01254	0.00000	0.00000	0.00000	1.0000000000	1.0000000000	0.16438	-0.21957	0	25	0	4	20	0	0.00000	0.00000
107	40275004	Contact dermatitis	8	233678006	Childhood asthma	1095	18	45	0	18	45	1032	0.00000	-0.02676	0.00000	0.00000	0.00000	1.0000000000	1.0000000000	0.73973	-0.79886	9	25	0	9	20	0	0.00000	0.00000
106	24079001	Atopic dermatitis	8	233678006	Childhood asthma	1095	20	45	9	11	36	1039	10.95000	0.28096	23.61364	60.54239	9.21014	0.0000000177	0.0000011569	0.82192	2.45647	13	25	7	7	20	2	-0.87807	-0.45426
102	90781000119102	Microalbuminuria due to type 2 diabetes mellitus (disorder)	8	233678006	Childhood asthma	1095	6	45	0	6	45	1044	0.00000	-0.01537	0.00000	0.00000	0.00000	1.0000000000	1.0000000000	0.24658	-0.31797	3	25	0	3	20	0	0.00000	0.00000
101	433144002	Chronic kidney disease stage 3 (disorder)	8	233678006	Childhood asthma	1095	3	45	0	3	45	1047	0.00000	-0.01085	0.00000	0.00000	0.00000	1.0000000000	1.0000000000	0.12329	-0.16773	1	25	0	2	20	0	0.00000	0.00000
100	161622006	History of lower limb amputation (situation)	8	233678006	Childhood asthma	1095	1	45	0	1	45	1049	0.00000	-0.00626	0.00000	0.00000	0.00000	1.0000000000	1.0000000000	0.04110	-0.05810	0	25	0	1	20	0	0.00000	0.00000
98	1551000119108	Nonproliferative diabetic retinopathy due to type 2 diabetes mellitus (disorder)	8	233678006	Childhood asthma	1095	12	45	0	12	45	1038	0.00000	-0.02179	0.00000	0.00000	0.00000	1.0000000000	1.0000000000	0.49315	-0.57836	7	25	0	5	20	0	0.00000	0.00000
97	403192003	Third degree burn	8	233678006	Childhood asthma	1095	8	45	0	8	45	1042	0.00000	-0.01776	0.00000	0.00000	0.00000	1.0000000000	1.0000000000	0.32877	-0.41009	3	25	0	5	20	0	0.00000	0.00000
96	283371005	Laceration of forearm	8	233678006	Childhood asthma	1095	75	45	5	70	40	980	1.62222	0.03493	1.75000	4.57411	0.66953	0.2276053023	0.8856025459	3.08219	0.55562	39	25	4	36	20	1	-1.06352	-1.23601
94	703151001	History of single seizure (situation)	8	233678006	Childhood asthma	1095	39	45	3	36	42	1014	1.87179	0.03468	2.01190	6.79808	0.59543	0.2129904959	0.8671354646	1.60274	0.61997	14	25	2	25	20	1	-0.44183	-1.17865
93	128613002	Seizure disorder	8	233678006	Childhood asthma	1095	39	45	3	36	42	1014	1.87179	0.03468	2.01190	6.79808	0.59543	0.2129904959	0.8671354646	1.60274	0.61997	14	25	2	25	20	1	-0.44183	-1.17865
89	47693006	Rupture of appendix	8	233678006	Childhood asthma	1095	20	45	1	19	44	1031	1.21667	0.00612	1.23325	9.42200	0.16142	0.5712202121	1.0000000000	0.82192	0.13454	10	25	1	10	20	0	3.25810	2.39790
86	713197008	Recurrent rectal polyp	8	233678006	Childhood asthma	1095	22	45	0	22	45	1028	0.00000	-0.02964	0.00000	0.00000	0.00000	1.0000000000	1.0000000000	0.90411	-0.92912	12	25	0	10	20	0	0.00000	0.00000
82	94260004	Secondary malignant neoplasm of colon	8	233678006	Childhood asthma	1095	4	45	0	4	45	1046	0.00000	-0.01254	0.00000	0.00000	0.00000	1.0000000000	1.0000000000	0.16438	-0.21957	2	25	0	2	20	0	0.00000	0.00000
78	239872002	Osteoarthritis of hip	8	233678006	Childhood asthma	1095	21	45	0	21	45	1029	0.00000	-0.02895	0.00000	0.00000	0.00000	1.0000000000	1.0000000000	0.86301	-0.89764	13	25	0	8	20	0	0.00000	0.00000
76	127013003	Diabetic renal disease (disorder)	8	233678006	Childhood asthma	1095	28	45	0	28	45	1022	0.00000	-0.03354	0.00000	0.00000	0.00000	0.6253180849	1.0000000000	1.15068	-1.10480	10	25	0	18	20	0	0.00000	0.00000
75	431855005	Chronic kidney disease stage 1 (disorder)	8	233678006	Childhood asthma	1095	28	45	0	28	45	1022	0.00000	-0.03354	0.00000	0.00000	0.00000	0.6253180849	1.0000000000	1.15068	-1.10480	10	25	0	18	20	0	0.00000	0.00000
72	35999006	Blighted ovum	8	233678006	Childhood asthma	1095	53	45	3	50	42	1000	1.37736	0.01762	1.42857	4.76798	0.42803	0.4755765626	1.0000000000	2.17808	0.33184	53	25	3	0	20	0	2.23359	2.92674
71	201834006	Localized  primary osteoarthritis of the hand	8	233678006	Childhood asthma	1095	28	45	0	28	45	1022	0.00000	-0.03354	0.00000	0.00000	0.00000	0.6253180849	1.0000000000	1.15068	-1.10480	19	25	0	9	20	0	0.00000	0.00000
70	87433001	Pulmonary emphysema (disorder)	8	233678006	Childhood asthma	1095	17	45	2	15	43	1035	2.86275	0.04843	3.20930	14.47851	0.71137	0.1520837058	0.7685611801	0.69863	0.82059	9	25	1	8	20	1	0.21357	0.10536
69	233604007	Pneumonia	8	233678006	Childhood asthma	1095	7	45	0	7	45	1043	0.00000	-0.01661	0.00000	0.00000	0.00000	1.0000000000	1.0000000000	0.28767	-0.36476	3	25	0	4	20	0	0.00000	0.00000
67	403191005	Second degree burn	8	233678006	Childhood asthma	1095	49	45	2	47	43	1003	0.99320	-0.00030	0.99258	4.22146	0.23338	1.0000000000	1.0000000000	2.01370	-0.00657	23	25	2	26	20	0	2.60269	2.52573
64	444448004	Injury of medial collateral ligament of knee	8	233678006	Childhood asthma	1095	32	45	0	32	45	1018	0.00000	-0.03592	0.00000	0.00000	0.00000	0.6382618927	1.0000000000	1.31507	-1.21105	17	25	0	15	20	0	0.00000	0.00000
63	68496003	Polyp of colon	8	233678006	Childhood asthma	1095	91	45	0	91	45	959	0.00000	-0.06233	0.00000	0.00000	0.00000	0.0461004031	0.4112472365	3.73973	-2.24480	43	25	0	48	20	0	0.00000	0.00000
59	262574004	Bullet wound	8	233678006	Childhood asthma	1095	20	45	0	20	45	1030	0.00000	-0.02824	0.00000	0.00000	0.00000	1.0000000000	1.0000000000	0.82192	-0.86546	9	25	0	11	20	0	0.00000	0.00000
58	239720000	Tear of meniscus of knee	8	233678006	Childhood asthma	1095	20	45	3	17	42	1033	3.65000	0.07483	4.34034	15.38682	1.22433	0.0453162362	0.4088241739	0.82192	1.13454	10	25	2	10	20	1	-0.44183	-0.60614
57	192127007	Child attention deficit disorder	8	233678006	Childhood asthma	1095	76	45	2	74	43	976	0.64035	-0.02033	0.61345	2.58229	0.14573	0.7640565197	1.0000000000	3.12329	-0.45883	24	25	1	52	20	1	0.21357	-0.75142
56	92691004	Carcinoma in situ of prostate (disorder)	8	233678006	Childhood asthma	1095	23	45	0	23	45	1027	0.00000	-0.03032	0.00000	0.00000	0.00000	0.6203225651	1.0000000000	0.94521	-0.95992	0	25	0	23	20	0	0.00000	0.00000
54	5602001	Opioid abuse (disorder)	8	233678006	Childhood asthma	1095	7	45	0	7	45	1043	0.00000	-0.01661	0.00000	0.00000	0.00000	1.0000000000	1.0000000000	0.28767	-0.36476	0	25	0	7	20	0	0.00000	0.00000
52	124171000119105	Chronic intractable migraine without aura	8	233678006	Childhood asthma	1095	51	45	4	47	41	1003	1.90850	0.04157	2.08199	6.05484	0.71591	0.1525864032	0.7697720963	2.09589	0.69157	21	25	1	30	20	3	1.22121	0.69315
50	446096008	Perennial allergic rhinitis	8	233678006	Childhood asthma	1095	26	45	8	18	37	1032	7.48718	0.20944	12.39640	30.34017	5.06492	0.0000038690	0.0001787474	1.06849	2.12134	14	25	6	12	20	2	-0.75567	-0.74194
49	88805009	Chronic congestive heart failure (disorder)	8	233678006	Childhood asthma	1095	10	45	0	10	45	1040	0.00000	-0.01987	0.00000	0.00000	0.00000	1.0000000000	1.0000000000	0.41096	-0.49668	5	25	0	5	20	0	0.00000	0.00000
47	359817006	Closed fracture of hip	8	233678006	Childhood asthma	1095	29	45	2	27	43	1023	1.67816	0.02316	1.76227	7.65204	0.40585	0.3365628544	1.0000000000	1.19178	0.45286	11	25	1	18	20	1	0.21357	-0.45953
45	263102004	Fracture subluxation of wrist	8	233678006	Childhood asthma	1095	109	45	9	100	36	950	2.00917	0.06946	2.37500	5.07304	1.11188	0.0363166162	0.3585908408	4.47945	0.86790	51	25	5	58	20	4	0.00000	-0.32493
44	58150001	Fracture of clavicle	8	233678006	Childhood asthma	1095	112	45	3	109	42	941	0.65179	-0.02433	0.61664	2.02286	0.18798	0.6145956035	1.0000000000	4.60274	-0.48613	55	25	3	57	20	0	2.23359	2.96183
43	307731004	Injury of tendon of the rotator cuff of shoulder	8	233678006	Childhood asthma	1095	51	45	4	47	41	1003	1.90850	0.04157	2.08199	6.05484	0.71591	0.1525864032	0.7697720963	2.09589	0.69157	26	25	2	25	20	2	0.20479	0.03637
42	16114001	Fracture of ankle	8	233678006	Childhood asthma	1095	108	45	3	105	42	945	0.67593	-0.02219	0.64286	2.11002	0.19586	0.6136817831	1.0000000000	4.43836	-0.44317	48	25	1	60	20	2	0.86020	0.45783
41	283385000	Laceration of thigh	8	233678006	Childhood asthma	1095	105	45	4	101	41	949	0.92698	-0.00492	0.91669	2.61164	0.32176	1.0000000000	1.0000000000	4.31507	-0.08816	50	25	4	55	20	0	1.98100	2.60269
39	74400008	Appendicitis	8	233678006	Childhood asthma	1095	51	45	6	45	39	1005	2.86275	0.08523	3.43590	8.53509	1.38316	0.0152466105	0.2090920355	2.09589	1.17700	27	25	4	24	20	2	-0.41689	-0.51726
38	398254007	Preeclampsia	8	233678006	Childhood asthma	1095	101	45	4	97	41	953	0.96370	-0.00240	0.95851	2.73282	0.33619	1.0000000000	1.0000000000	4.15068	-0.04284	101	25	4	0	20	0	1.98100	3.26767
35	19169002	Miscarriage in first trimester	8	233678006	Childhood asthma	1095	174	45	6	168	39	882	0.83908	-0.01448	0.80769	1.93793	0.33663	0.8348625777	1.0000000000	7.15068	-0.21957	174	25	6	0	20	0	1.64223	3.40120
33	429007001	History of cardiac arrest (situation)	8	233678006	Childhood asthma	1095	42	45	1	41	44	1009	0.57937	-0.01739	0.55931	4.15999	0.07520	1.0000000000	1.0000000000	1.72603	-0.44680	24	25	1	18	20	0	3.25810	3.21888
32	410429000	Cardiac Arrest	8	233678006	Childhood asthma	1095	42	45	1	41	44	1009	0.57937	-0.01739	0.55931	4.15999	0.07520	1.0000000000	1.0000000000	1.72603	-0.44680	24	25	1	18	20	0	3.25810	3.21888
30	399211009	History of myocardial infarction (situation)	8	233678006	Childhood asthma	1095	31	45	0	31	45	1019	0.00000	-0.03534	0.00000	0.00000	0.00000	0.6344494568	1.0000000000	1.27397	-1.18521	2	25	0	29	20	0	0.00000	0.00000
29	22298006	Myocardial Infarction	8	233678006	Childhood asthma	1095	31	45	0	31	45	1019	0.00000	-0.03534	0.00000	0.00000	0.00000	0.6344494568	1.0000000000	1.27397	-1.18521	2	25	0	29	20	0	0.00000	0.00000
27	408512008	Body mass index 40+ - severely obese (finding)	8	233678006	Childhood asthma	1095	97	45	6	91	39	959	1.50515	0.03260	1.62130	3.93225	0.66848	0.2797833746	0.9574808819	3.98630	0.48938	67	25	4	30	20	2	-0.41689	0.10380
24	162864005	Body mass index 30+ - obesity (finding)	8	233678006	Childhood asthma	1095	439	45	15	424	30	626	0.83144	-0.02855	0.73821	1.38875	0.39240	0.4376467508	1.0000000000	18.04110	-0.25104	226	25	10	213	20	5	-0.35667	-0.61381
23	36971009	Sinusitis (disorder)	8	233678006	Childhood asthma	1095	190	45	7	183	38	867	0.89649	-0.00982	0.87274	1.98504	0.38370	0.8432611168	1.0000000000	7.80822	-0.13885	84	25	3	106	20	4	0.44183	0.05311
21	15777000	Prediabetes	8	233678006	Childhood asthma	1095	333	45	11	322	34	728	0.80380	-0.02685	0.73146	1.46182	0.36600	0.4130402922	1.0000000000	13.68493	-0.29130	159	25	6	174	20	5	0.03279	-0.26376
20	80394007	Hyperglycemia (disorder)	8	233678006	Childhood asthma	1095	55	45	1	54	44	996	0.44242	-0.02654	0.41919	3.10035	0.05668	0.7227058143	1.0000000000	2.26027	-0.70499	23	25	0	32	20	1	-3.04452	-3.49651
19	237602007	Metabolic syndrome X (disorder)	8	233678006	Childhood asthma	1095	64	45	1	63	44	987	0.38021	-0.03197	0.35606	2.62677	0.04826	0.5119869833	1.0000000000	2.63014	-0.86002	28	25	0	36	20	1	-3.04452	-3.61092
18	302870006	Hypertriglyceridemia (disorder)	8	233678006	Childhood asthma	1095	64	45	1	63	44	987	0.38021	-0.03197	0.35606	2.62677	0.04826	0.5119869833	1.0000000000	2.63014	-0.86002	28	25	0	36	20	1	-3.04452	-3.61092
17	368581000119106	Neuropathy due to type 2 diabetes mellitus (disorder)	8	233678006	Childhood asthma	1095	28	45	1	27	44	1023	0.86905	-0.00439	0.86111	6.48235	0.11439	1.0000000000	1.0000000000	1.15068	-0.10480	7	25	0	21	20	1	-3.04452	-3.09104
15	40055000	Chronic sinusitis (disorder)	8	233678006	Childhood asthma	1095	216	45	8	208	37	842	0.90123	-0.01014	0.87526	1.90769	0.40158	0.8497743675	1.0000000000	8.87671	-0.13411	104	25	5	112	20	3	-0.24512	-0.56441
14	10509002	Acute bronchitis (disorder)	8	233678006	Childhood asthma	1095	863	45	36	827	9	223	1.01506	0.00601	1.07860	2.27259	0.51192	1.0000000000	1.0000000000	35.46575	0.02098	418	25	20	445	20	16	0.00000	-0.27432
13	370247008	Facial laceration	8	233678006	Childhood asthma	1095	109	45	6	103	39	947	1.33945	0.02336	1.41449	3.42122	0.58481	0.4419591306	1.0000000000	4.47945	0.35332	55	25	3	54	20	3	0.19671	0.01739
10	62106007	Concussion with no loss of consciousness	8	233678006	Childhood asthma	1095	206	45	11	195	34	855	1.29935	0.02983	1.41855	2.84927	0.70625	0.3304575796	1.0000000000	8.46575	0.34225	96	25	4	110	20	7	0.63107	0.40261
7	75498004	Acute bacterial sinusitis (disorder)	8	233678006	Childhood asthma	1095	187	45	9	178	36	872	1.17112	0.01608	1.22472	2.58758	0.57967	0.5480123990	1.0000000000	7.68493	0.20341	89	25	5	98	20	4	0.00000	-0.30482
6	39848009	Whiplash injury to neck	8	233678006	Childhood asthma	1095	182	45	3	179	42	871	0.40110	-0.05536	0.34757	1.13371	0.10655	0.0675882350	0.5101371685	7.47945	-1.08397	92	25	1	90	20	2	0.86020	0.70396
5	284549007	Laceration of hand	8	233678006	Childhood asthma	1095	104	45	3	101	42	949	0.70192	-0.01999	0.67115	2.20420	0.20435	0.7934266547	1.0000000000	4.27397	-0.39889	54	25	2	50	20	1	-0.44183	-0.59962
1	444814009	Viral sinusitis (disorder)	8	233678006	Childhood asthma	1095	993	45	41	952	4	98	1.00470	0.00304	1.05515	3.00777	0.37015	1.0000000000	1.0000000000	40.80822	0.00660	478	25	23	515	20	18	-0.01151	-0.30704
114	449868002	Smokes tobacco daily	74	79586000	Tubal pregnancy	1095	9	23	0	9	23	1063	0.00000	-0.01333	0.00000	0.00000	0.00000	1.0000000000	1.0000000000	0.18904	-0.24980	2	23	0	7	0	0	0.00000	0.00000
118	48333001	Burn injury(morphologic abnormality)	74	79586000	Tubal pregnancy	1095	1	23	0	1	23	1071	0.00000	-0.00443	0.00000	0.00000	0.00000	1.0000000000	1.0000000000	0.02100	-0.02999	0	23	0	1	0	0	0.00000	0.00000
119	275272006	Brain damage - traumatic	74	79586000	Tubal pregnancy	1095	4	23	0	4	23	1068	0.00000	-0.00887	0.00000	0.00000	0.00000	1.0000000000	1.0000000000	0.08402	-0.11639	0	23	0	4	0	0	0.00000	0.00000
120	162573006	Suspected lung cancer (situation)	74	79586000	Tubal pregnancy	1095	8	23	0	8	23	1064	0.00000	-0.01257	0.00000	0.00000	0.00000	1.0000000000	1.0000000000	0.16804	-0.22409	0	23	0	8	0	0	0.00000	0.00000
123	195967001	Asthma	74	79586000	Tubal pregnancy	1095	2	23	0	2	23	1070	0.00000	-0.00627	0.00000	0.00000	0.00000	1.0000000000	1.0000000000	0.04201	-0.05937	1	23	0	1	0	0	0.00000	0.00000
126	698754002	Chronic paralysis due to lesion of spinal cord	74	79586000	Tubal pregnancy	1095	2	23	0	2	23	1070	0.00000	-0.00627	0.00000	0.00000	0.00000	1.0000000000	1.0000000000	0.04201	-0.05937	2	23	0	0	0	0	0.00000	0.00000
127	431856006	Chronic kidney disease stage 2 (disorder)	74	79586000	Tubal pregnancy	1095	5	23	0	5	23	1067	0.00000	-0.00992	0.00000	0.00000	0.00000	1.0000000000	1.0000000000	0.10502	-0.14408	3	23	0	2	0	0	0.00000	0.00000
128	86849004	Suicidal deliberate poisoning	74	79586000	Tubal pregnancy	1095	1	23	0	1	23	1071	0.00000	-0.00443	0.00000	0.00000	0.00000	1.0000000000	1.0000000000	0.02100	-0.02999	0	23	0	1	0	0	0.00000	0.00000
130	314994000	Metastasis from malignant tumor of prostate (disorder)	74	79586000	Tubal pregnancy	1095	1	23	0	1	23	1071	0.00000	-0.00443	0.00000	0.00000	0.00000	1.0000000000	1.0000000000	0.02100	-0.02999	0	23	0	1	0	0	0.00000	0.00000
131	93761005	Primary malignant neoplasm of colon	74	79586000	Tubal pregnancy	1095	5	23	0	5	23	1067	0.00000	-0.00992	0.00000	0.00000	0.00000	1.0000000000	1.0000000000	0.10502	-0.14408	3	23	0	2	0	0	0.00000	0.00000
132	69896004	Rheumatoid arthritis	74	79586000	Tubal pregnancy	1095	3	23	0	3	23	1069	0.00000	-0.00768	0.00000	0.00000	0.00000	1.0000000000	1.0000000000	0.06301	-0.08816	2	23	0	1	0	0	0.00000	0.00000
133	97331000119101	Macular edema and retinopathy due to type 2 diabetes mellitus (disorder)	74	79586000	Tubal pregnancy	1095	4	23	0	4	23	1068	0.00000	-0.00887	0.00000	0.00000	0.00000	1.0000000000	1.0000000000	0.08402	-0.11639	2	23	0	2	0	0	0.00000	0.00000
118	48333001	Burn injury(morphologic abnormality)	19	237602007	Metabolic syndrome X (disorder)	1095	1	64	0	1	64	1030	0.00000	-0.00753	0.00000	0.00000	0.00000	1.0000000000	1.0000000000	0.05845	-0.08195	0	28	0	1	36	0	0.00000	0.00000
129	47505003	Posttraumatic stress disorder	19	237602007	Metabolic syndrome X (disorder)	1095	4	64	2	2	62	1029	8.55469	0.11397	16.59677	119.80462	2.29918	0.0186994393	0.2375451204	0.23379	1.28187	1	28	0	3	36	2	-2.94444	-0.91629
130	314994000	Metastasis from malignant tumor of prostate (disorder)	19	237602007	Metabolic syndrome X (disorder)	1095	1	64	1	0	63	1031	17.10937	0.12135	0.00000	0.00000	0.00000	0.0584474886	0.4685406893	0.05845	0.91805	0	28	0	1	36	1	-3.61092	-0.69315
130	314994000	Metastasis from malignant tumor of prostate (disorder)	121	254637007	Non-small cell lung cancer (disorder)	1095	1	8	0	1	8	1086	0.00000	-0.00259	0.00000	0.00000	0.00000	1.0000000000	1.0000000000	0.00731	-0.01050	0	0	0	1	8	0	0.00000	0.00000
129	47505003	Posttraumatic stress disorder	121	254637007	Non-small cell lung cancer (disorder)	1095	4	8	0	4	8	1083	0.00000	-0.00519	0.00000	0.00000	0.00000	1.0000000000	1.0000000000	0.02922	-0.04156	1	0	0	3	8	0	0.00000	0.00000
128	86849004	Suicidal deliberate poisoning	121	254637007	Non-small cell lung cancer (disorder)	1095	1	8	0	1	8	1086	0.00000	-0.00259	0.00000	0.00000	0.00000	1.0000000000	1.0000000000	0.00731	-0.01050	0	0	0	1	8	0	0.00000	0.00000
125	1734006	Fracture of the vertebral column with spinal cord injury	121	254637007	Non-small cell lung cancer (disorder)	1095	5	8	0	5	8	1082	0.00000	-0.00581	0.00000	0.00000	0.00000	1.0000000000	1.0000000000	0.03653	-0.05176	3	0	0	2	8	0	0.00000	0.00000
124	1501000119109	Proliferative diabetic retinopathy due to type II diabetes mellitus (disorder)	121	254637007	Non-small cell lung cancer (disorder)	1095	1	8	0	1	8	1086	0.00000	-0.00259	0.00000	0.00000	0.00000	1.0000000000	1.0000000000	0.00731	-0.01050	1	0	0	0	8	0	0.00000	0.00000
120	162573006	Suspected lung cancer (situation)	121	254637007	Non-small cell lung cancer (disorder)	1095	8	8	8	0	0	1087	136.87500	1.00000	0.00000	0.00000	0.00000	0.0000000000	0.0000000000	0.05845	3.08798	0	0	0	8	8	8	-0.69315	-0.69315
118	48333001	Burn injury(morphologic abnormality)	121	254637007	Non-small cell lung cancer (disorder)	1095	1	8	0	1	8	1086	0.00000	-0.00259	0.00000	0.00000	0.00000	1.0000000000	1.0000000000	0.00731	-0.01050	0	0	0	1	8	0	0.00000	0.00000
117	230265002	Familial Alzheimer's disease of early onset (disorder)	121	254637007	Non-small cell lung cancer (disorder)	1095	6	8	0	6	8	1081	0.00000	-0.00637	0.00000	0.00000	0.00000	1.0000000000	1.0000000000	0.04384	-0.06189	2	0	0	4	8	0	0.00000	0.00000
115	36923009	Major depression  single episode	121	254637007	Non-small cell lung cancer (disorder)	1095	6	8	0	6	8	1081	0.00000	-0.00637	0.00000	0.00000	0.00000	1.0000000000	1.0000000000	0.04384	-0.06189	3	0	0	3	8	0	0.00000	0.00000
114	449868002	Smokes tobacco daily	121	254637007	Non-small cell lung cancer (disorder)	1095	9	8	1	8	7	1079	15.20833	0.11096	19.26786	175.23894	2.11854	0.0640919301	0.4928640393	0.06575	0.90813	2	0	0	7	8	1	-2.19722	-2.07944
111	235919008	Cholelithiasis	121	254637007	Non-small cell lung cancer (disorder)	1095	9	8	0	9	8	1078	0.00000	-0.00781	0.00000	0.00000	0.00000	1.0000000000	1.0000000000	0.06575	-0.09187	7	0	0	2	8	0	0.00000	0.00000
109	90560007	Gout	121	254637007	Non-small cell lung cancer (disorder)	1095	4	8	0	4	8	1083	0.00000	-0.00519	0.00000	0.00000	0.00000	1.0000000000	1.0000000000	0.02922	-0.04156	0	0	0	4	8	0	0.00000	0.00000
108	40930008	Hypothyroidism (disorder)	121	254637007	Non-small cell lung cancer (disorder)	1095	13	8	0	13	8	1074	0.00000	-0.00940	0.00000	0.00000	0.00000	1.0000000000	1.0000000000	0.09498	-0.13090	11	0	0	2	8	0	0.00000	0.00000
107	40275004	Contact dermatitis	121	254637007	Non-small cell lung cancer (disorder)	1095	18	8	0	18	8	1069	0.00000	-0.01109	0.00000	0.00000	0.00000	1.0000000000	1.0000000000	0.13151	-0.17825	9	0	0	9	8	0	0.00000	0.00000
106	24079001	Atopic dermatitis	121	254637007	Non-small cell lung cancer (disorder)	1095	20	8	0	20	8	1067	0.00000	-0.01170	0.00000	0.00000	0.00000	1.0000000000	1.0000000000	0.14612	-0.19676	13	0	0	7	8	0	0.00000	0.00000
105	363406005	Malignant tumor of colon	121	254637007	Non-small cell lung cancer (disorder)	1095	6	8	0	6	8	1081	0.00000	-0.00637	0.00000	0.00000	0.00000	1.0000000000	1.0000000000	0.04384	-0.06189	4	0	0	2	8	0	0.00000	0.00000
102	90781000119102	Microalbuminuria due to type 2 diabetes mellitus (disorder)	121	254637007	Non-small cell lung cancer (disorder)	1095	6	8	1	5	7	1082	22.81250	0.13890	30.91429	299.83803	3.18736	0.0431395216	0.3985498161	0.04384	0.93811	3	0	0	3	8	1	-2.19722	-1.38629
101	433144002	Chronic kidney disease stage 3 (disorder)	121	254637007	Non-small cell lung cancer (disorder)	1095	3	8	0	3	8	1084	0.00000	-0.00450	0.00000	0.00000	0.00000	1.0000000000	1.0000000000	0.02192	-0.03128	1	0	0	2	8	0	0.00000	0.00000
100	161622006	History of lower limb amputation (situation)	121	254637007	Non-small cell lung cancer (disorder)	1095	1	8	0	1	8	1086	0.00000	-0.00259	0.00000	0.00000	0.00000	1.0000000000	1.0000000000	0.00731	-0.01050	0	0	0	1	8	0	0.00000	0.00000
98	1551000119108	Nonproliferative diabetic retinopathy due to type 2 diabetes mellitus (disorder)	121	254637007	Non-small cell lung cancer (disorder)	1095	12	8	0	12	8	1075	0.00000	-0.00903	0.00000	0.00000	0.00000	1.0000000000	1.0000000000	0.08767	-0.12124	7	0	0	5	8	0	0.00000	0.00000
97	403192003	Third degree burn	121	254637007	Non-small cell lung cancer (disorder)	1095	8	8	0	8	8	1079	0.00000	-0.00736	0.00000	0.00000	0.00000	1.0000000000	1.0000000000	0.05845	-0.08195	3	0	0	5	8	0	0.00000	0.00000
96	283371005	Laceration of forearm	121	254637007	Non-small cell lung cancer (disorder)	1095	75	8	1	74	7	1013	1.82500	0.01919	1.95560	16.10676	0.23744	0.4341934482	1.0000000000	0.54795	0.36965	39	0	0	36	8	1	-2.19722	-3.61092
95	84757009	Epilepsy	121	254637007	Non-small cell lung cancer (disorder)	1095	30	8	1	29	7	1058	4.56250	0.05129	5.21182	43.74820	0.62090	0.1998532808	0.8434192785	0.21918	0.71409	13	0	0	17	8	1	-2.19722	-2.89037
94	703151001	History of single seizure (situation)	121	254637007	Non-small cell lung cancer (disorder)	1095	39	8	1	38	7	1049	3.50962	0.04137	3.94361	32.85942	0.47329	0.2525427859	0.9133257124	0.28493	0.63831	14	0	0	25	8	1	-2.19722	-3.25810
93	128613002	Seizure disorder	121	254637007	Non-small cell lung cancer (disorder)	1095	39	8	1	38	7	1049	3.50962	0.04137	3.94361	32.85942	0.47329	0.2525427859	0.9133257124	0.28493	0.63831	14	0	0	25	8	1	-2.19722	-3.25810
89	47693006	Rupture of appendix	121	254637007	Non-small cell lung cancer (disorder)	1095	20	8	0	20	8	1067	0.00000	-0.01170	0.00000	0.00000	0.00000	1.0000000000	1.0000000000	0.14612	-0.19676	10	0	0	10	8	0	0.00000	0.00000
86	713197008	Recurrent rectal polyp	121	254637007	Non-small cell lung cancer (disorder)	1095	22	8	0	22	8	1065	0.00000	-0.01228	0.00000	0.00000	0.00000	1.0000000000	1.0000000000	0.16073	-0.21503	12	0	0	10	8	0	0.00000	0.00000
82	94260004	Secondary malignant neoplasm of colon	121	254637007	Non-small cell lung cancer (disorder)	1095	4	8	0	4	8	1083	0.00000	-0.00519	0.00000	0.00000	0.00000	1.0000000000	1.0000000000	0.02922	-0.04156	2	0	0	2	8	0	0.00000	0.00000
80	6072007	Bleeding from anus	121	254637007	Non-small cell lung cancer (disorder)	1095	4	8	0	4	8	1083	0.00000	-0.00519	0.00000	0.00000	0.00000	1.0000000000	1.0000000000	0.02922	-0.04156	2	0	0	2	8	0	0.00000	0.00000
78	239872002	Osteoarthritis of hip	121	254637007	Non-small cell lung cancer (disorder)	1095	21	8	1	20	7	1067	6.51786	0.06619	7.62143	64.87359	0.89537	0.1439420804	0.7404942507	0.15342	0.79408	13	0	0	8	8	1	-2.19722	-2.19722
76	127013003	Diabetic renal disease (disorder)	121	254637007	Non-small cell lung cancer (disorder)	1095	28	8	1	27	7	1060	4.88839	0.05404	5.60847	47.18618	0.66661	0.1877127711	0.8181443419	0.20457	0.73149	10	0	0	18	8	1	-2.19722	-2.94444
75	431855005	Chronic kidney disease stage 1 (disorder)	121	254637007	Non-small cell lung cancer (disorder)	1095	28	8	1	27	7	1060	4.88839	0.05404	5.60847	47.18618	0.66661	0.1877127711	0.8181443419	0.20457	0.73149	10	0	0	18	8	1	-2.19722	-2.94444
73	196416002	Impacted molars	121	254637007	Non-small cell lung cancer (disorder)	1095	49	8	0	49	8	1038	0.00000	-0.01857	0.00000	0.00000	0.00000	1.0000000000	1.0000000000	0.35799	-0.44147	25	0	0	24	8	0	0.00000	0.00000
72	35999006	Blighted ovum	121	254637007	Non-small cell lung cancer (disorder)	1095	53	8	0	53	8	1034	0.00000	-0.01935	0.00000	0.00000	0.00000	1.0000000000	1.0000000000	0.38721	-0.47219	53	0	0	0	8	0	0.00000	0.00000
71	201834006	Localized  primary osteoarthritis of the hand	121	254637007	Non-small cell lung cancer (disorder)	1095	28	8	0	28	8	1059	0.00000	-0.01390	0.00000	0.00000	0.00000	1.0000000000	1.0000000000	0.20457	-0.26851	19	0	0	9	8	0	0.00000	0.00000
70	87433001	Pulmonary emphysema (disorder)	121	254637007	Non-small cell lung cancer (disorder)	1095	17	8	0	17	8	1070	0.00000	-0.01077	0.00000	0.00000	0.00000	1.0000000000	1.0000000000	0.12420	-0.16890	9	0	0	8	8	0	0.00000	0.00000
69	233604007	Pneumonia	121	254637007	Non-small cell lung cancer (disorder)	1095	7	8	0	7	8	1080	0.00000	-0.00688	0.00000	0.00000	0.00000	1.0000000000	1.0000000000	0.05114	-0.07196	3	0	0	4	8	0	0.00000	0.00000
68	26929004	Alzheimer's disease (disorder)	121	254637007	Non-small cell lung cancer (disorder)	1095	23	8	0	23	8	1064	0.00000	-0.01257	0.00000	0.00000	0.00000	1.0000000000	1.0000000000	0.16804	-0.22409	15	0	0	8	8	0	0.00000	0.00000
67	403191005	Second degree burn	121	254637007	Non-small cell lung cancer (disorder)	1095	49	8	0	49	8	1038	0.00000	-0.01857	0.00000	0.00000	0.00000	1.0000000000	1.0000000000	0.35799	-0.44147	23	0	0	26	8	0	0.00000	0.00000
65	239873007	Osteoarthritis of knee	121	254637007	Non-small cell lung cancer (disorder)	1095	57	8	0	57	8	1030	0.00000	-0.02010	0.00000	0.00000	0.00000	1.0000000000	1.0000000000	0.41644	-0.50227	30	0	0	27	8	0	0.00000	0.00000
64	444448004	Injury of medial collateral ligament of knee	121	254637007	Non-small cell lung cancer (disorder)	1095	32	8	0	32	8	1055	0.00000	-0.01488	0.00000	0.00000	0.00000	1.0000000000	1.0000000000	0.23379	-0.30310	17	0	0	15	8	0	0.00000	0.00000
63	68496003	Polyp of colon	121	254637007	Non-small cell lung cancer (disorder)	1095	91	8	0	91	8	996	0.00000	-0.02583	0.00000	0.00000	0.00000	1.0000000000	1.0000000000	0.66484	-0.73538	43	0	0	48	8	0	0.00000	0.00000
59	262574004	Bullet wound	121	254637007	Non-small cell lung cancer (disorder)	1095	20	8	0	20	8	1067	0.00000	-0.01170	0.00000	0.00000	0.00000	1.0000000000	1.0000000000	0.14612	-0.19676	9	0	0	11	8	0	0.00000	0.00000
58	239720000	Tear of meniscus of knee	121	254637007	Non-small cell lung cancer (disorder)	1095	20	8	0	20	8	1067	0.00000	-0.01170	0.00000	0.00000	0.00000	1.0000000000	1.0000000000	0.14612	-0.19676	10	0	0	10	8	0	0.00000	0.00000
57	192127007	Child attention deficit disorder	121	254637007	Non-small cell lung cancer (disorder)	1095	76	8	0	76	8	1011	0.00000	-0.02343	0.00000	0.00000	0.00000	1.0000000000	1.0000000000	0.55525	-0.63715	24	0	0	52	8	0	0.00000	0.00000
56	92691004	Carcinoma in situ of prostate (disorder)	121	254637007	Non-small cell lung cancer (disorder)	1095	23	8	1	22	7	1065	5.95109	0.06222	6.91558	58.62581	0.81577	0.1566536716	0.7747075658	0.16804	0.77591	0	0	0	23	8	1	-2.19722	-3.17805
54	5602001	Opioid abuse (disorder)	121	254637007	Non-small cell lung cancer (disorder)	1095	7	8	1	6	7	1081	19.55357	0.12767	25.73810	242.65496	2.73001	0.0501687997	0.4320205543	0.05114	0.92804	0	0	0	7	8	1	-2.19722	-2.07944
52	124171000119105	Chronic intractable migraine without aura	121	254637007	Non-small cell lung cancer (disorder)	1095	51	8	0	51	8	1036	0.00000	-0.01896	0.00000	0.00000	0.00000	1.0000000000	1.0000000000	0.37260	-0.45691	21	0	0	30	8	0	0.00000	0.00000
50	446096008	Perennial allergic rhinitis	121	254637007	Non-small cell lung cancer (disorder)	1095	26	8	0	26	8	1061	0.00000	-0.01338	0.00000	0.00000	0.00000	1.0000000000	1.0000000000	0.18995	-0.25091	14	0	0	12	8	0	0.00000	0.00000
49	88805009	Chronic congestive heart failure (disorder)	121	254637007	Non-small cell lung cancer (disorder)	1095	10	8	0	10	8	1077	0.00000	-0.00824	0.00000	0.00000	0.00000	1.0000000000	1.0000000000	0.07306	-0.10173	5	0	0	5	8	0	0.00000	0.00000
47	359817006	Closed fracture of hip	121	254637007	Non-small cell lung cancer (disorder)	1095	29	8	0	29	8	1058	0.00000	-0.01415	0.00000	0.00000	0.00000	1.0000000000	1.0000000000	0.21187	-0.27724	11	0	0	18	8	0	0.00000	0.00000
45	263102004	Fracture subluxation of wrist	121	254637007	Non-small cell lung cancer (disorder)	1095	109	8	1	108	7	979	1.25573	0.00729	1.29497	10.62474	0.15784	0.5690084463	1.0000000000	0.79635	0.15493	51	0	0	58	8	1	-2.19722	-4.07754
44	58150001	Fracture of clavicle	121	254637007	Non-small cell lung cancer (disorder)	1095	112	8	4	108	4	979	4.88839	0.11260	9.06481	36.76262	2.23517	0.0052541750	0.0931740363	0.81826	1.45937	55	0	0	57	8	4	-1.09861	-2.72458
43	307731004	Injury of tendon of the rotator cuff of shoulder	121	254637007	Non-small cell lung cancer (disorder)	1095	51	8	0	51	8	1036	0.00000	-0.01896	0.00000	0.00000	0.00000	1.0000000000	1.0000000000	0.37260	-0.45691	26	0	0	25	8	0	0.00000	0.00000
42	16114001	Fracture of ankle	121	254637007	Non-small cell lung cancer (disorder)	1095	108	8	0	108	8	979	0.00000	-0.02838	0.00000	0.00000	0.00000	1.0000000000	1.0000000000	0.78904	-0.83919	48	0	0	60	8	0	0.00000	0.00000
41	283385000	Laceration of thigh	121	254637007	Non-small cell lung cancer (disorder)	1095	105	8	1	104	7	983	1.30357	0.00848	1.35027	11.08203	0.16452	0.5547693232	1.0000000000	0.76712	0.17860	50	0	0	55	8	1	-2.19722	-4.02535
39	74400008	Appendicitis	121	254637007	Non-small cell lung cancer (disorder)	1095	51	8	1	50	7	1037	2.68382	0.03193	2.96286	24.54668	0.35763	0.3180602796	1.0000000000	0.37260	0.54309	27	0	0	24	8	1	-2.19722	-3.21888
38	398254007	Preeclampsia	121	254637007	Non-small cell lung cancer (disorder)	1095	101	8	0	101	8	986	0.00000	-0.02735	0.00000	0.00000	0.00000	1.0000000000	1.0000000000	0.73790	-0.79734	101	0	0	0	8	0	0.00000	0.00000
35	19169002	Miscarriage in first trimester	121	254637007	Non-small cell lung cancer (disorder)	1095	174	8	0	174	8	913	0.00000	-0.03729	0.00000	0.00000	0.00000	0.3691677987	1.0000000000	1.27123	-1.18348	174	0	0	0	8	0	0.00000	0.00000
33	429007001	History of cardiac arrest (situation)	121	254637007	Non-small cell lung cancer (disorder)	1095	42	8	1	41	7	1046	3.25893	0.03870	3.64460	30.31510	0.43817	0.2694179494	0.9388450812	0.30685	0.61391	24	0	0	18	8	1	-2.19722	-2.94444
32	410429000	Cardiac Arrest	121	254637007	Non-small cell lung cancer (disorder)	1095	42	8	1	41	7	1046	3.25893	0.03870	3.64460	30.31510	0.43817	0.2694179494	0.9388450812	0.30685	0.61391	24	0	0	18	8	1	-2.19722	-2.94444
30	399211009	History of myocardial infarction (situation)	121	254637007	Non-small cell lung cancer (disorder)	1095	31	8	0	31	8	1056	0.00000	-0.01464	0.00000	0.00000	0.00000	1.0000000000	1.0000000000	0.22648	-0.29453	2	0	0	29	8	0	0.00000	0.00000
29	22298006	Myocardial Infarction	121	254637007	Non-small cell lung cancer (disorder)	1095	31	8	0	31	8	1056	0.00000	-0.01464	0.00000	0.00000	0.00000	1.0000000000	1.0000000000	0.22648	-0.29453	2	0	0	29	8	0	0.00000	0.00000
27	408512008	Body mass index 40+ - severely obese (finding)	121	254637007	Non-small cell lung cancer (disorder)	1095	97	8	0	97	8	990	0.00000	-0.02675	0.00000	0.00000	0.00000	1.0000000000	1.0000000000	0.70868	-0.77288	67	0	0	30	8	0	0.00000	0.00000
24	162864005	Body mass index 30+ - obesity (finding)	121	254637007	Non-small cell lung cancer (disorder)	1095	439	8	4	435	4	652	1.24715	0.01735	1.49885	6.02493	0.37288	0.7205465380	1.0000000000	3.20731	0.24903	226	0	0	213	8	4	-1.09861	-3.99360
23	36971009	Sinusitis (disorder)	121	254637007	Non-small cell lung cancer (disorder)	1095	190	8	3	187	5	900	2.16118	0.04564	2.88770	12.18808	0.68418	0.1472481858	0.7510427515	1.38813	0.74412	84	0	0	106	8	3	-1.29928	-3.59274
21	15777000	Prediabetes	121	254637007	Non-small cell lung cancer (disorder)	1095	333	8	6	327	2	760	2.46622	0.08315	6.97248	34.72700	1.39993	0.0118613104	0.1721476562	2.43288	1.02794	159	0	0	174	8	6	-0.84730	-3.40120
20	80394007	Hyperglycemia (disorder)	121	254637007	Non-small cell lung cancer (disorder)	1095	55	8	1	54	7	1033	2.48864	0.02937	2.73280	22.61036	0.33030	0.3387530268	1.0000000000	0.40183	0.51269	23	0	0	32	8	1	-2.19722	-3.49651
19	237602007	Metabolic syndrome X (disorder)	121	254637007	Non-small cell lung cancer (disorder)	1095	64	8	2	62	6	1025	4.27734	0.07005	5.51075	27.86598	1.08980	0.0749717423	0.5403135912	0.46758	1.03152	28	0	0	36	8	2	-1.60944	-2.94444
18	302870006	Hypertriglyceridemia (disorder)	121	254637007	Non-small cell lung cancer (disorder)	1095	64	8	2	62	6	1025	4.27734	0.07005	5.51075	27.86598	1.08980	0.0749717423	0.5403135912	0.46758	1.03152	28	0	0	36	8	2	-1.60944	-2.94444
17	368581000119106	Neuropathy due to type 2 diabetes mellitus (disorder)	121	254637007	Non-small cell lung cancer (disorder)	1095	28	8	1	27	7	1060	4.88839	0.05404	5.60847	47.18618	0.66661	0.1877127711	0.8181443419	0.20457	0.73149	7	0	0	21	8	1	-2.19722	-3.09104
129	47505003	Posttraumatic stress disorder	95	84757009	Epilepsy	1095	4	30	0	4	30	1061	0.00000	-0.01016	0.00000	0.00000	0.00000	1.0000000000	1.0000000000	0.10959	-0.15003	1	13	0	3	17	0	0.00000	0.00000
15	40055000	Chronic sinusitis (disorder)	121	254637007	Non-small cell lung cancer (disorder)	1095	216	8	2	214	6	873	1.26736	0.01137	1.35981	6.78437	0.27255	0.6604667638	1.0000000000	1.57808	0.21866	104	0	0	112	8	2	-1.60944	-4.04305
14	10509002	Acute bronchitis (disorder)	121	254637007	Non-small cell lung cancer (disorder)	1095	863	8	7	856	1	231	1.11023	0.01824	1.88902	15.43107	0.23125	1.0000000000	1.0000000000	6.30502	0.13111	418	0	0	445	8	7	-0.76214	-4.16777
13	370247008	Facial laceration	121	254637007	Non-small cell lung cancer (disorder)	1095	109	8	0	109	8	978	0.00000	-0.02852	0.00000	0.00000	0.00000	1.0000000000	1.0000000000	0.79635	-0.84507	55	0	0	54	8	0	0.00000	0.00000
125	1734006	Fracture of the vertebral column with spinal cord injury	95	84757009	Epilepsy	1095	5	30	0	5	30	1060	0.00000	-0.01137	0.00000	0.00000	0.00000	1.0000000000	1.0000000000	0.13699	-0.18521	3	13	0	2	17	0	0.00000	0.00000
124	1501000119109	Proliferative diabetic retinopathy due to type II diabetes mellitus (disorder)	95	84757009	Epilepsy	1095	1	30	0	1	30	1064	0.00000	-0.00507	0.00000	0.00000	0.00000	1.0000000000	1.0000000000	0.02740	-0.03899	1	13	0	0	17	0	0.00000	0.00000
10	62106007	Concussion with no loss of consciousness	121	254637007	Non-small cell lung cancer (disorder)	1095	206	8	1	205	7	882	0.66444	-0.01386	0.61463	5.02320	0.07521	1.0000000000	1.0000000000	1.50502	-0.32482	96	0	0	110	8	1	-2.19722	-4.70953
8	233678006	Childhood asthma	121	254637007	Non-small cell lung cancer (disorder)	1095	45	8	0	45	8	1042	0.00000	-0.01776	0.00000	0.00000	0.00000	1.0000000000	1.0000000000	0.32877	-0.41009	25	0	0	20	8	0	0.00000	0.00000
7	75498004	Acute bacterial sinusitis (disorder)	121	254637007	Non-small cell lung cancer (disorder)	1095	187	8	0	187	8	900	0.00000	-0.03893	0.00000	0.00000	0.00000	0.3643078077	1.0000000000	1.36621	-1.24258	89	0	0	98	8	0	0.00000	0.00000
6	39848009	Whiplash injury to neck	121	254637007	Non-small cell lung cancer (disorder)	1095	182	8	1	181	7	906	0.75206	-0.00950	0.71507	5.84737	0.08745	1.0000000000	1.0000000000	1.32968	-0.22013	92	0	0	90	8	1	-2.19722	-4.51086
5	284549007	Laceration of hand	121	254637007	Non-small cell lung cancer (disorder)	1095	104	8	2	102	6	985	2.63221	0.04536	3.21895	16.15607	0.64135	0.1716269478	0.7972585288	0.75982	0.76954	54	0	0	50	8	2	-1.60944	-3.25810
117	230265002	Familial Alzheimer's disease of early onset (disorder)	95	84757009	Epilepsy	1095	6	30	0	6	30	1059	0.00000	-0.01246	0.00000	0.00000	0.00000	1.0000000000	1.0000000000	0.16438	-0.21957	2	13	0	4	17	0	0.00000	0.00000
115	36923009	Major depression  single episode	95	84757009	Epilepsy	1095	6	30	0	6	30	1059	0.00000	-0.01246	0.00000	0.00000	0.00000	1.0000000000	1.0000000000	0.16438	-0.21957	3	13	0	3	17	0	0.00000	0.00000
1	444814009	Viral sinusitis (disorder)	121	254637007	Non-small cell lung cancer (disorder)	1095	993	8	8	985	0	102	1.10272	0.02750	0.00000	0.00000	0.00000	1.0000000000	1.0000000000	7.25479	0.12469	478	0	0	515	8	8	-0.69315	-4.18014
111	235919008	Cholelithiasis	95	84757009	Epilepsy	1095	9	30	0	9	30	1056	0.00000	-0.01528	0.00000	0.00000	0.00000	1.0000000000	1.0000000000	0.24658	-0.31797	7	13	0	2	17	0	0.00000	0.00000
109	90560007	Gout	95	84757009	Epilepsy	1095	4	30	0	4	30	1061	0.00000	-0.01016	0.00000	0.00000	0.00000	1.0000000000	1.0000000000	0.10959	-0.15003	0	13	0	4	17	0	0.00000	0.00000
108	40930008	Hypothyroidism (disorder)	95	84757009	Epilepsy	1095	13	30	0	13	30	1052	0.00000	-0.01840	0.00000	0.00000	0.00000	1.0000000000	1.0000000000	0.35616	-0.43953	11	13	0	2	17	0	0.00000	0.00000
107	40275004	Contact dermatitis	95	84757009	Epilepsy	1095	18	30	0	18	30	1047	0.00000	-0.02170	0.00000	0.00000	0.00000	1.0000000000	1.0000000000	0.49315	-0.57836	9	13	0	9	17	0	0.00000	0.00000
106	24079001	Atopic dermatitis	95	84757009	Epilepsy	1095	20	30	1	19	29	1046	1.82500	0.01889	1.89837	14.66475	0.24575	0.4290985694	1.0000000000	0.54795	0.36965	13	13	1	7	17	0	2.63906	2.63906
105	363406005	Malignant tumor of colon	95	84757009	Epilepsy	1095	6	30	1	5	29	1060	6.08333	0.06333	7.31034	64.57244	0.82762	0.1538550318	0.7717368396	0.16438	0.78043	4	13	0	2	17	1	-2.89037	-1.09861
102	90781000119102	Microalbuminuria due to type 2 diabetes mellitus (disorder)	95	84757009	Epilepsy	1095	6	30	1	5	29	1060	6.08333	0.06333	7.31034	64.57244	0.82762	0.1538550318	0.7717368396	0.16438	0.78043	3	13	0	3	17	1	-2.89037	-1.38629
101	433144002	Chronic kidney disease stage 3 (disorder)	95	84757009	Epilepsy	1095	3	30	0	3	30	1062	0.00000	-0.00880	0.00000	0.00000	0.00000	1.0000000000	1.0000000000	0.08219	-0.11396	1	13	0	2	17	0	0.00000	0.00000
100	161622006	History of lower limb amputation (situation)	95	84757009	Epilepsy	1095	1	30	0	1	30	1064	0.00000	-0.00507	0.00000	0.00000	0.00000	1.0000000000	1.0000000000	0.02740	-0.03899	0	13	0	1	17	0	0.00000	0.00000
98	1551000119108	Nonproliferative diabetic retinopathy due to type 2 diabetes mellitus (disorder)	95	84757009	Epilepsy	1095	12	30	0	12	30	1053	0.00000	-0.01767	0.00000	0.00000	0.00000	1.0000000000	1.0000000000	0.32877	-0.41009	7	13	0	5	17	0	0.00000	0.00000
97	403192003	Third degree burn	95	84757009	Epilepsy	1095	8	30	0	8	30	1057	0.00000	-0.01440	0.00000	0.00000	0.00000	1.0000000000	1.0000000000	0.21918	-0.28591	3	13	0	5	17	0	0.00000	0.00000
96	283371005	Laceration of forearm	95	84757009	Epilepsy	1095	75	30	2	73	28	992	0.97333	-0.00121	0.97065	4.15500	0.22675	1.0000000000	1.0000000000	2.05479	-0.02611	39	13	0	36	17	2	-2.25129	-2.94444
94	703151001	History of single seizure (situation)	95	84757009	Epilepsy	1095	39	30	30	9	0	1056	28.07692	0.87334	0.00000	0.00000	0.00000	0.0000000000	0.0000000000	1.06849	3.90562	14	13	13	25	17	17	0.00000	-0.17357
93	128613002	Seizure disorder	95	84757009	Epilepsy	1095	39	30	30	9	0	1056	28.07692	0.87334	0.00000	0.00000	0.00000	0.0000000000	0.0000000000	1.06849	3.90562	14	13	13	25	17	17	0.00000	-0.17357
89	47693006	Rupture of appendix	95	84757009	Epilepsy	1095	20	30	0	20	30	1045	0.00000	-0.02289	0.00000	0.00000	0.00000	1.0000000000	1.0000000000	0.54795	-0.63035	10	13	0	10	17	0	0.00000	0.00000
86	713197008	Recurrent rectal polyp	95	84757009	Epilepsy	1095	22	30	1	21	29	1044	1.65909	0.01584	1.71429	13.18047	0.22296	0.4605326380	1.0000000000	0.60274	0.31946	12	13	0	10	17	1	-2.89037	-2.39790
82	94260004	Secondary malignant neoplasm of colon	95	84757009	Epilepsy	1095	4	30	0	4	30	1061	0.00000	-0.01016	0.00000	0.00000	0.00000	1.0000000000	1.0000000000	0.10959	-0.15003	2	13	0	2	17	0	0.00000	0.00000
80	6072007	Bleeding from anus	95	84757009	Epilepsy	1095	4	30	0	4	30	1061	0.00000	-0.01016	0.00000	0.00000	0.00000	1.0000000000	1.0000000000	0.10959	-0.15003	2	13	0	2	17	0	0.00000	0.00000
78	239872002	Osteoarthritis of hip	95	84757009	Epilepsy	1095	21	30	2	19	28	1046	3.47619	0.05811	3.93233	17.70452	0.87341	0.1104559105	0.6551229609	0.57534	0.92930	13	13	0	8	17	2	-2.25129	-1.60944
76	127013003	Diabetic renal disease (disorder)	95	84757009	Epilepsy	1095	28	30	1	27	29	1038	1.30357	0.00825	1.32567	10.09131	0.17415	0.5451193548	1.0000000000	0.76712	0.17860	10	13	0	18	17	1	-2.89037	-2.94444
75	431855005	Chronic kidney disease stage 1 (disorder)	95	84757009	Epilepsy	1095	28	30	1	27	29	1038	1.30357	0.00825	1.32567	10.09131	0.17415	0.5451193548	1.0000000000	0.76712	0.17860	10	13	0	18	17	1	-2.89037	-2.94444
73	196416002	Impacted molars	95	84757009	Epilepsy	1095	49	30	0	49	30	1016	0.00000	-0.03633	0.00000	0.00000	0.00000	0.6408386869	1.0000000000	1.34247	-1.22803	25	13	0	24	17	0	0.00000	0.00000
72	35999006	Blighted ovum	95	84757009	Epilepsy	1095	53	30	1	52	29	1013	0.68868	-0.01178	0.67175	5.02784	0.08975	1.0000000000	1.0000000000	1.45205	-0.29399	53	13	1	0	17	0	2.63906	3.98898
71	201834006	Localized  primary osteoarthritis of the hand	95	84757009	Epilepsy	1095	28	30	1	27	29	1038	1.30357	0.00825	1.32567	10.09131	0.17415	0.5451193548	1.0000000000	0.76712	0.17860	19	13	1	9	17	0	2.63906	2.99573
70	87433001	Pulmonary emphysema (disorder)	95	84757009	Epilepsy	1095	17	30	0	17	30	1048	0.00000	-0.02108	0.00000	0.00000	0.00000	1.0000000000	1.0000000000	0.46575	-0.55164	9	13	0	8	17	0	0.00000	0.00000
69	233604007	Pneumonia	95	84757009	Epilepsy	1095	7	30	0	7	30	1058	0.00000	-0.01346	0.00000	0.00000	0.00000	1.0000000000	1.0000000000	0.19178	-0.25312	3	13	0	4	17	0	0.00000	0.00000
68	26929004	Alzheimer's disease (disorder)	95	84757009	Epilepsy	1095	23	30	1	22	29	1043	1.58696	0.01443	1.63480	12.54372	0.21306	0.4756156025	1.0000000000	0.63014	0.29501	15	13	1	8	17	0	2.63906	2.77259
67	403191005	Second degree burn	95	84757009	Epilepsy	1095	49	30	2	47	28	1018	1.48980	0.01779	1.54711	6.68882	0.35784	0.3923576968	1.0000000000	1.34247	0.35693	23	13	0	26	17	2	-2.25129	-2.63906
65	239873007	Osteoarthritis of knee	95	84757009	Epilepsy	1095	57	30	2	55	28	1010	1.28070	0.01104	1.31169	5.64803	0.30462	0.6666124679	1.0000000000	1.56164	0.22789	30	13	0	27	17	2	-2.25129	-2.67415
64	444448004	Injury of medial collateral ligament of knee	95	84757009	Epilepsy	1095	32	30	0	32	30	1033	0.00000	-0.02912	0.00000	0.00000	0.00000	1.0000000000	1.0000000000	0.87671	-0.90821	17	13	0	15	17	0	0.00000	0.00000
63	68496003	Polyp of colon	95	84757009	Epilepsy	1095	91	30	6	85	24	980	2.40659	0.07107	2.88235	7.24453	1.14679	0.0323767622	0.3324014252	2.49315	1.00283	43	13	3	48	17	3	-0.22314	-0.10318
59	262574004	Bullet wound	95	84757009	Epilepsy	1095	20	30	0	20	30	1045	0.00000	-0.02289	0.00000	0.00000	0.00000	1.0000000000	1.0000000000	0.54795	-0.63035	9	13	0	11	17	0	0.00000	0.00000
58	239720000	Tear of meniscus of knee	95	84757009	Epilepsy	1095	20	30	2	18	28	1047	3.65000	0.06067	4.15476	18.77582	0.91938	0.1016216494	0.6291042150	0.54795	0.95461	10	13	2	10	17	0	2.01490	1.79176
57	192127007	Child attention deficit disorder	95	84757009	Epilepsy	1095	76	30	3	73	27	992	1.44079	0.02020	1.50989	5.09514	0.44744	0.4584164482	1.0000000000	2.08219	0.37604	24	13	2	52	17	1	-0.87547	-1.40534
56	92691004	Carcinoma in situ of prostate (disorder)	95	84757009	Epilepsy	1095	23	30	0	23	30	1042	0.00000	-0.02458	0.00000	0.00000	0.00000	1.0000000000	1.0000000000	0.63014	-0.70499	0	13	0	23	17	0	0.00000	0.00000
54	5602001	Opioid abuse (disorder)	95	84757009	Epilepsy	1095	7	30	0	7	30	1058	0.00000	-0.01346	0.00000	0.00000	0.00000	1.0000000000	1.0000000000	0.19178	-0.25312	0	13	0	7	17	0	0.00000	0.00000
52	124171000119105	Chronic intractable migraine without aura	95	84757009	Epilepsy	1095	51	30	0	51	30	1014	0.00000	-0.03710	0.00000	0.00000	0.00000	0.3944703745	1.0000000000	1.39726	-1.26139	21	13	0	30	17	0	0.00000	0.00000
50	446096008	Perennial allergic rhinitis	95	84757009	Epilepsy	1095	26	30	1	25	29	1040	1.40385	0.01057	1.43448	10.95023	0.18792	0.5184587285	1.0000000000	0.71233	0.22404	14	13	1	12	17	0	2.63906	2.70805
49	88805009	Chronic congestive heart failure (disorder)	95	84757009	Epilepsy	1095	10	30	1	9	29	1056	3.65000	0.04270	4.04598	32.99610	0.49612	0.2434299153	0.9130344998	0.27397	0.65067	5	13	1	5	17	0	2.63906	1.79176
47	359817006	Closed fracture of hip	95	84757009	Epilepsy	1095	29	30	1	28	29	1037	1.25862	0.00716	1.27709	9.70937	0.16798	0.5579088763	1.0000000000	0.79452	0.15640	11	13	1	18	17	0	2.63906	2.48491
45	263102004	Fracture subluxation of wrist	95	84757009	Epilepsy	1095	109	30	1	108	29	957	0.33486	-0.03712	0.30556	2.26540	0.04121	0.3523082128	1.0000000000	2.98630	-0.99505	51	13	1	58	17	0	2.63906	3.95124
44	58150001	Fracture of clavicle	95	84757009	Epilepsy	1095	112	30	2	110	28	955	0.65179	-0.01973	0.62013	2.63856	0.14575	0.7608923839	1.0000000000	3.06849	-0.43953	55	13	0	57	17	2	-2.25129	-3.38439
43	307731004	Injury of tendon of the rotator cuff of shoulder	95	84757009	Epilepsy	1095	51	30	2	49	28	1016	1.43137	0.01600	1.48105	6.39593	0.34295	0.6466294661	1.0000000000	1.39726	0.32358	26	13	0	25	17	2	-2.25129	-2.60269
42	16114001	Fracture of ankle	95	84757009	Epilepsy	1095	108	30	3	105	27	960	1.01389	0.00077	1.01587	3.40566	0.30302	1.0000000000	1.0000000000	2.95890	0.01490	48	13	2	60	17	1	-0.87547	-0.89200
41	283385000	Laceration of thigh	95	84757009	Epilepsy	1095	105	30	1	104	29	961	0.34762	-0.03566	0.31863	2.36316	0.04296	0.3514217185	1.0000000000	2.87671	-0.95483	50	13	0	55	17	1	-2.89037	-4.02535
39	74400008	Appendicitis	95	84757009	Epilepsy	1095	51	30	2	49	28	1016	1.43137	0.01600	1.48105	6.39593	0.34295	0.6466294661	1.0000000000	1.39726	0.32358	27	13	1	24	17	1	-0.25131	0.11333
38	398254007	Preeclampsia	95	84757009	Epilepsy	1095	101	30	3	98	27	967	1.08416	0.00450	1.09637	3.67946	0.32669	0.7519120906	1.0000000000	2.76712	0.08654	101	13	3	0	17	0	1.67398	3.54578
128	86849004	Suicidal deliberate poisoning	83	110030002	Concussion injury of brain	1095	1	7	0	1	7	1087	0.00000	-0.00243	0.00000	0.00000	0.00000	1.0000000000	1.0000000000	0.00639	-0.00919	0	1	0	1	6	0	0.00000	0.00000
35	19169002	Miscarriage in first trimester	95	84757009	Epilepsy	1095	174	30	2	172	28	893	0.41954	-0.04235	0.37085	1.57120	0.08753	0.2086857892	0.8610424124	4.76712	-0.94289	174	13	2	0	17	0	2.01490	4.47734
33	429007001	History of cardiac arrest (situation)	95	84757009	Epilepsy	1095	42	30	3	39	27	1026	2.60714	0.05387	2.92308	10.04977	0.85021	0.1038598426	0.6331122908	1.15068	0.89520	24	13	0	18	17	3	-1.89712	-1.94591
32	410429000	Cardiac Arrest	95	84757009	Epilepsy	1095	42	30	3	39	27	1026	2.60714	0.05387	2.92308	10.04977	0.85021	0.1038598426	0.6331122908	1.15068	0.89520	24	13	0	18	17	3	-1.89712	-1.94591
30	399211009	History of myocardial infarction (situation)	95	84757009	Epilepsy	1095	31	30	1	30	29	1035	1.17742	0.00508	1.18966	9.02424	0.15683	0.5824532689	1.0000000000	0.84932	0.11301	2	13	0	29	17	1	-2.89037	-3.40120
29	22298006	Myocardial Infarction	95	84757009	Epilepsy	1095	31	30	1	30	29	1035	1.17742	0.00508	1.18966	9.02424	0.15683	0.5824532689	1.0000000000	0.84932	0.11301	2	13	0	29	17	1	-2.89037	-3.40120
27	408512008	Body mass index 40+ - severely obese (finding)	95	84757009	Epilepsy	1095	97	30	1	96	29	969	0.37629	-0.03264	0.34806	2.58337	0.04689	0.5095592732	1.0000000000	2.65753	-0.87087	67	13	1	30	17	0	2.63906	4.21951
24	162864005	Body mass index 30+ - obesity (finding)	95	84757009	Epilepsy	1095	439	30	6	433	24	632	0.49886	-0.06881	0.36490	0.90012	0.14792	0.0234025318	0.2783569427	12.02740	-0.89612	226	13	2	213	17	4	0.35667	0.74260
23	36971009	Sinusitis (disorder)	95	84757009	Epilepsy	1095	190	30	0	190	30	875	0.00000	-0.07690	0.00000	0.00000	0.00000	0.0055301683	0.0974775443	5.20548	-2.63354	84	13	0	106	17	0	0.00000	0.00000
21	15777000	Prediabetes	95	84757009	Epilepsy	1095	333	30	4	329	26	736	0.43844	-0.06231	0.34417	0.99405	0.11916	0.0434240843	0.3987203055	9.12329	-1.01768	159	13	3	174	17	1	-1.21640	-1.17580
20	80394007	Hyperglycemia (disorder)	95	84757009	Epilepsy	1095	55	30	0	55	30	1010	0.00000	-0.03860	0.00000	0.00000	0.00000	0.3961939142	1.0000000000	1.50685	-1.32588	23	13	0	32	17	0	0.00000	0.00000
19	237602007	Metabolic syndrome X (disorder)	95	84757009	Epilepsy	1095	64	30	1	63	29	1002	0.57031	-0.01797	0.54844	4.09180	0.07351	1.0000000000	1.0000000000	1.75342	-0.46123	28	13	0	36	17	1	-2.89037	-3.61092
18	302870006	Hypertriglyceridemia (disorder)	95	84757009	Epilepsy	1095	64	30	1	63	29	1002	0.57031	-0.01797	0.54844	4.09180	0.07351	1.0000000000	1.0000000000	1.75342	-0.46123	28	13	0	36	17	1	-2.89037	-3.61092
17	368581000119106	Neuropathy due to type 2 diabetes mellitus (disorder)	95	84757009	Epilepsy	1095	28	30	0	28	30	1037	0.00000	-0.02719	0.00000	0.00000	0.00000	1.0000000000	1.0000000000	0.76712	-0.82140	7	13	0	21	17	0	0.00000	0.00000
15	40055000	Chronic sinusitis (disorder)	95	84757009	Epilepsy	1095	216	30	5	211	25	854	0.84491	-0.01290	0.80948	2.13949	0.30627	0.8181402947	1.0000000000	5.91781	-0.20535	104	13	3	112	17	2	-0.57732	-0.46883
14	10509002	Acute bronchitis (disorder)	95	84757009	Epilepsy	1095	863	30	24	839	6	226	1.01506	0.00488	1.07747	2.66764	0.43520	1.0000000000	1.0000000000	23.64384	0.02070	418	13	10	445	17	14	0.03798	0.26655
13	370247008	Facial laceration	95	84757009	Epilepsy	1095	109	30	1	108	29	957	0.33486	-0.03712	0.30556	2.26540	0.04121	0.3523082128	1.0000000000	2.98630	-0.99505	55	13	1	54	17	0	2.63906	4.02535
125	1734006	Fracture of the vertebral column with spinal cord injury	69	233604007	Pneumonia	1095	5	7	0	5	7	1083	0.00000	-0.00543	0.00000	0.00000	0.00000	1.0000000000	1.0000000000	0.03196	-0.04539	3	3	0	2	4	0	0.00000	0.00000
10	62106007	Concussion with no loss of consciousness	95	84757009	Epilepsy	1095	206	30	4	202	26	863	0.70874	-0.02353	0.65727	1.90428	0.22686	0.6349935671	1.0000000000	5.64384	-0.41009	96	13	1	110	17	3	0.74194	0.94594
8	233678006	Childhood asthma	95	84757009	Epilepsy	1095	45	30	3	42	27	1023	2.43333	0.04980	2.70635	9.27818	0.78941	0.1215633694	0.6889733259	1.23288	0.84110	25	13	2	20	17	1	-0.87547	-0.44183
7	75498004	Acute bacterial sinusitis (disorder)	95	84757009	Epilepsy	1095	187	30	4	183	26	882	0.78075	-0.01670	0.74149	2.15017	0.25570	0.8056198776	1.0000000000	5.12329	-0.29238	89	13	3	98	17	1	-1.21640	-1.17194
6	39848009	Whiplash injury to neck	95	84757009	Epilepsy	1095	182	30	3	179	27	886	0.60165	-0.02985	0.54997	1.83248	0.16506	0.4567270205	1.0000000000	4.98630	-0.58166	92	13	2	90	17	1	-0.87547	-0.66071
5	284549007	Laceration of hand	95	84757009	Epilepsy	1095	104	30	3	101	27	964	1.05288	0.00288	1.06051	3.55740	0.31615	0.7585156680	1.0000000000	2.84932	0.05540	54	13	2	50	17	1	-0.87547	-0.59962
1	444814009	Viral sinusitis (disorder)	95	84757009	Epilepsy	1095	993	30	25	968	5	97	0.91893	-0.04245	0.50103	1.33847	0.18755	0.1902303124	0.8246131765	27.20548	-0.11746	478	13	10	515	17	15	0.07522	0.32290
109	90560007	Gout	69	233604007	Pneumonia	1095	4	7	0	4	7	1084	0.00000	-0.00486	0.00000	0.00000	0.00000	1.0000000000	1.0000000000	0.02557	-0.03643	0	3	0	4	4	0	0.00000	0.00000
97	403192003	Third degree burn	69	233604007	Pneumonia	1095	8	7	0	8	7	1080	0.00000	-0.00688	0.00000	0.00000	0.00000	1.0000000000	1.0000000000	0.05114	-0.07196	3	3	0	5	4	0	0.00000	0.00000
96	283371005	Laceration of forearm	69	233604007	Pneumonia	1095	75	7	1	74	6	1014	2.08571	0.02361	2.28378	19.22005	0.27137	0.3923025386	1.0000000000	0.47945	0.43494	39	3	1	36	4	0	1.38629	3.68888
94	703151001	History of single seizure (situation)	69	233604007	Pneumonia	1095	39	7	0	39	7	1049	0.00000	-0.01541	0.00000	0.00000	0.00000	1.0000000000	1.0000000000	0.24932	-0.32114	14	3	0	25	4	0	0.00000	0.00000
93	128613002	Seizure disorder	69	233604007	Pneumonia	1095	39	7	0	39	7	1049	0.00000	-0.01541	0.00000	0.00000	0.00000	1.0000000000	1.0000000000	0.24932	-0.32114	14	3	0	25	4	0	0.00000	0.00000
86	713197008	Recurrent rectal polyp	69	233604007	Pneumonia	1095	22	7	0	22	7	1066	0.00000	-0.01149	0.00000	0.00000	0.00000	1.0000000000	1.0000000000	0.14064	-0.18984	12	3	0	10	4	0	0.00000	0.00000
75	431855005	Chronic kidney disease stage 1 (disorder)	69	233604007	Pneumonia	1095	28	7	0	28	7	1060	0.00000	-0.01299	0.00000	0.00000	0.00000	1.0000000000	1.0000000000	0.17900	-0.23756	10	3	0	18	4	0	0.00000	0.00000
64	444448004	Injury of medial collateral ligament of knee	69	233604007	Pneumonia	1095	32	7	0	32	7	1056	0.00000	-0.01392	0.00000	0.00000	0.00000	1.0000000000	1.0000000000	0.20457	-0.26851	17	3	0	15	4	0	0.00000	0.00000
120	162573006	Suspected lung cancer (situation)	28	53741008	Coronary Heart Disease	1095	8	80	0	8	80	1007	0.00000	-0.02408	0.00000	0.00000	0.00000	1.0000000000	1.0000000000	0.58447	-0.66400	0	24	0	8	56	0	0.00000	0.00000
47	359817006	Closed fracture of hip	69	233604007	Pneumonia	1095	29	7	1	28	6	1060	5.39409	0.05813	6.30952	54.16677	0.73495	0.1717258622	0.7972585288	0.18539	0.75464	11	3	0	18	4	1	-1.60944	-2.94444
44	58150001	Fracture of clavicle	69	233604007	Pneumonia	1095	112	7	1	111	6	977	1.39668	0.01074	1.46697	12.29614	0.17501	0.5311619735	1.0000000000	0.71598	0.22097	55	3	0	57	4	1	-1.60944	-4.06044
43	307731004	Injury of tendon of the rotator cuff of shoulder	69	233604007	Pneumonia	1095	51	7	0	51	7	1037	0.00000	-0.01773	0.00000	0.00000	0.00000	1.0000000000	1.0000000000	0.32603	-0.40711	26	3	0	25	4	0	0.00000	0.00000
42	16114001	Fracture of ankle	69	233604007	Pneumonia	1095	108	7	0	108	7	980	0.00000	-0.02653	0.00000	0.00000	0.00000	1.0000000000	1.0000000000	0.69041	-0.75737	48	3	0	60	4	0	0.00000	0.00000
41	283385000	Laceration of thigh	69	233604007	Pneumonia	1095	105	7	1	104	6	984	1.48980	0.01279	1.57692	13.22495	0.18803	0.5072116212	1.0000000000	0.67123	0.25909	50	3	0	55	4	1	-1.60944	-4.02535
130	314994000	Metastasis from malignant tumor of prostate (disorder)	28	53741008	Coronary Heart Disease	1095	1	80	0	1	80	1014	0.00000	-0.00849	0.00000	0.00000	0.00000	1.0000000000	1.0000000000	0.07306	-0.10173	0	24	0	1	56	0	0.00000	0.00000
38	398254007	Preeclampsia	69	233604007	Pneumonia	1095	101	7	1	100	6	988	1.54880	0.01403	1.64667	13.81461	0.19628	0.4930606303	1.0000000000	0.64566	0.28133	101	3	1	0	4	0	1.38629	4.62497
35	19169002	Miscarriage in first trimester	69	233604007	Pneumonia	1095	174	7	2	172	5	916	1.79803	0.02782	2.13023	11.06875	0.40997	0.3083156569	0.9990383301	1.11233	0.50613	174	3	2	0	4	0	0.91629	4.47734
33	429007001	History of cardiac arrest (situation)	69	233604007	Pneumonia	1095	42	7	1	41	6	1047	3.72449	0.04364	4.25610	36.17001	0.50081	0.2400829148	0.9095097439	0.26849	0.65688	24	3	0	18	4	1	-1.60944	-2.94444
32	410429000	Cardiac Arrest	69	233604007	Pneumonia	1095	42	7	1	41	6	1047	3.72449	0.04364	4.25610	36.17001	0.50081	0.2400829148	0.9095097439	0.26849	0.65688	24	3	0	18	4	1	-1.60944	-2.94444
27	408512008	Body mass index 40+ - severely obese (finding)	69	233604007	Pneumonia	1095	97	7	3	94	4	994	4.83800	0.09598	7.93085	35.96608	1.74883	0.0181365391	0.2342772228	0.62009	1.30392	67	3	1	30	4	2	0.28768	1.44692
21	15777000	Prediabetes	69	233604007	Pneumonia	1095	333	7	4	329	3	759	1.87902	0.04661	3.07599	13.82053	0.68461	0.2090781055	0.8619508625	2.12877	0.67633	159	3	2	174	4	2	-0.18232	-0.08908
15	40055000	Chronic sinusitis (disorder)	69	233604007	Pneumonia	1095	216	7	1	215	6	873	0.72421	-0.01097	0.67674	5.65080	0.08105	1.0000000000	1.0000000000	1.38082	-0.25146	104	3	0	112	4	1	-1.60944	-4.72739
14	10509002	Acute bronchitis (disorder)	69	233604007	Pneumonia	1095	863	7	7	856	0	232	1.26883	0.04159	0.00000	0.00000	0.00000	0.3563388735	1.0000000000	5.51689	0.29582	418	3	3	445	4	4	0.00000	0.22329
125	1734006	Fracture of the vertebral column with spinal cord injury	43	307731004	Injury of tendon of the rotator cuff of shoulder	1095	5	51	0	5	51	1039	0.00000	-0.01497	0.00000	0.00000	0.00000	1.0000000000	1.0000000000	0.23288	-0.30203	3	26	0	2	25	0	0.00000	0.00000
118	48333001	Burn injury(morphologic abnormality)	43	307731004	Injury of tendon of the rotator cuff of shoulder	1095	1	51	0	1	51	1043	0.00000	-0.00668	0.00000	0.00000	0.00000	1.0000000000	1.0000000000	0.04658	-0.06568	0	26	0	1	25	0	0.00000	0.00000
96	283371005	Laceration of forearm	43	307731004	Injury of tendon of the rotator cuff of shoulder	1095	75	51	2	73	49	971	0.57255	-0.02562	0.54291	2.27725	0.12943	0.5728145825	1.0000000000	3.49315	-0.58276	39	26	1	36	25	1	0.03774	0.07796
94	703151001	History of single seizure (situation)	43	307731004	Injury of tendon of the rotator cuff of shoulder	1095	39	51	3	36	48	1008	1.65158	0.02768	1.75000	5.88543	0.52035	0.4218296554	1.0000000000	1.81644	0.50613	14	26	0	25	25	3	-2.23359	-2.23359
86	713197008	Recurrent rectal polyp	43	307731004	Injury of tendon of the rotator cuff of shoulder	1095	22	51	3	19	48	1025	2.92781	0.06101	3.37171	11.78702	0.96449	0.0784984778	0.5538932862	1.02466	0.98232	12	26	2	10	25	1	-0.61904	-0.45199
75	431855005	Chronic kidney disease stage 1 (disorder)	43	307731004	Injury of tendon of the rotator cuff of shoulder	1095	28	51	5	23	46	1021	3.83403	0.10147	4.82514	13.26422	1.75525	0.0078196161	0.1290108046	1.30411	1.38075	10	26	2	18	25	3	0.40547	-0.15415
44	58150001	Fracture of clavicle	43	307731004	Injury of tendon of the rotator cuff of shoulder	1095	112	51	6	106	45	938	1.15021	0.01121	1.17987	2.83089	0.49175	0.6384697880	1.0000000000	5.21644	0.17127	55	26	4	57	25	2	-0.58779	-0.69315
42	16114001	Fracture of ankle	43	307731004	Injury of tendon of the rotator cuff of shoulder	1095	108	51	6	102	45	942	1.19281	0.01410	1.23137	2.95682	0.51281	0.6288181523	1.0000000000	5.03014	0.21516	48	26	4	60	25	2	-0.58779	-0.86904
41	283385000	Laceration of thigh	43	307731004	Injury of tendon of the rotator cuff of shoulder	1095	105	51	8	97	43	947	1.63585	0.04577	1.81635	3.97445	0.83008	0.1407328701	0.7371027084	4.89041	0.61156	50	26	3	55	25	5	0.47692	0.38677
33	429007001	History of cardiac arrest (situation)	43	307731004	Injury of tendon of the rotator cuff of shoulder	1095	42	51	2	40	49	1004	1.02241	0.00099	1.02449	4.36224	0.24061	1.0000000000	1.0000000000	1.95616	0.02124	24	26	2	18	25	0	2.63906	2.56495
27	408512008	Body mass index 40+ - severely obese (finding)	43	307731004	Injury of tendon of the rotator cuff of shoulder	1095	97	51	8	89	43	955	1.77077	0.05311	1.99634	4.37813	0.91029	0.1223992119	0.6900579845	4.51781	0.70583	67	26	7	30	25	1	-1.70750	-1.07583
21	15777000	Prediabetes	43	307731004	Injury of tendon of the rotator cuff of shoulder	1095	333	51	23	310	28	734	1.48295	0.07056	1.94493	3.42992	1.10287	0.0279466589	0.3078193827	15.50959	0.53973	159	26	10	174	25	13	0.20830	0.16115
130	314994000	Metastasis from malignant tumor of prostate (disorder)	17	368581000119106	Neuropathy due to type 2 diabetes mellitus (disorder)	1095	1	28	0	1	28	1066	0.00000	-0.00490	0.00000	0.00000	0.00000	1.0000000000	1.0000000000	0.02557	-0.03643	0	7	0	1	21	0	0.00000	0.00000
15	40055000	Chronic sinusitis (disorder)	43	307731004	Injury of tendon of the rotator cuff of shoulder	1095	216	51	9	207	42	837	0.89461	-0.01155	0.86646	1.80848	0.41513	0.8572059930	1.0000000000	10.06027	-0.14539	104	26	4	112	25	5	0.22314	0.14310
14	10509002	Acute bronchitis (disorder)	43	307731004	Injury of tendon of the rotator cuff of shoulder	1095	863	51	41	822	10	222	1.02004	0.00854	1.10730	2.24544	0.54604	0.8622901382	1.0000000000	40.19452	0.02794	418	26	20	445	25	21	0.04879	-0.01318
125	1734006	Fracture of the vertebral column with spinal cord injury	17	368581000119106	Neuropathy due to type 2 diabetes mellitus (disorder)	1095	5	28	0	5	28	1062	0.00000	-0.01097	0.00000	0.00000	0.00000	1.0000000000	1.0000000000	0.12785	-0.17358	3	7	0	2	21	0	0.00000	0.00000
118	48333001	Burn injury(morphologic abnormality)	17	368581000119106	Neuropathy due to type 2 diabetes mellitus (disorder)	1095	1	28	0	1	28	1066	0.00000	-0.00490	0.00000	0.00000	0.00000	1.0000000000	1.0000000000	0.02557	-0.03643	0	7	0	1	21	0	0.00000	0.00000
117	230265002	Familial Alzheimer's disease of early onset (disorder)	17	368581000119106	Neuropathy due to type 2 diabetes mellitus (disorder)	1095	6	28	1	5	27	1062	6.51786	0.06635	7.86667	69.64292	0.88860	0.1442534615	0.7404942507	0.15342	0.79408	2	7	1	4	21	0	2.07944	1.09861
109	90560007	Gout	17	368581000119106	Neuropathy due to type 2 diabetes mellitus (disorder)	1095	4	28	0	4	28	1063	0.00000	-0.00981	0.00000	0.00000	0.00000	1.0000000000	1.0000000000	0.10228	-0.14049	0	7	0	4	21	0	0.00000	0.00000
102	90781000119102	Microalbuminuria due to type 2 diabetes mellitus (disorder)	17	368581000119106	Neuropathy due to type 2 diabetes mellitus (disorder)	1095	6	28	1	5	27	1062	6.51786	0.06635	7.86667	69.64292	0.88860	0.1442534615	0.7404942507	0.15342	0.79408	3	7	0	3	21	1	-3.09104	-1.38629
98	1551000119108	Nonproliferative diabetic retinopathy due to type 2 diabetes mellitus (disorder)	17	368581000119106	Neuropathy due to type 2 diabetes mellitus (disorder)	1095	12	28	7	5	21	1062	22.81250	0.37194	70.80000	241.30953	20.77266	0.0000000023	0.0000001729	0.30685	2.61391	7	7	3	5	21	4	-0.62861	0.39304
97	403192003	Third degree burn	17	368581000119106	Neuropathy due to type 2 diabetes mellitus (disorder)	1095	8	28	1	7	27	1060	4.88839	0.05404	5.60847	47.18618	0.66661	0.1877127711	0.8181443419	0.20457	0.73149	3	7	0	5	21	1	-3.09104	-1.79176
96	283371005	Laceration of forearm	17	368581000119106	Neuropathy due to type 2 diabetes mellitus (disorder)	1095	75	28	1	74	27	993	0.52143	-0.02102	0.49700	3.70872	0.06660	0.7159205202	1.0000000000	1.91781	-0.54489	39	7	1	36	21	0	2.07944	3.68888
94	703151001	History of single seizure (situation)	17	368581000119106	Neuropathy due to type 2 diabetes mellitus (disorder)	1095	39	28	0	39	28	1028	0.00000	-0.03113	0.00000	0.00000	0.00000	0.6205377963	1.0000000000	0.99726	-0.99802	14	7	0	25	21	0	0.00000	0.00000
93	128613002	Seizure disorder	17	368581000119106	Neuropathy due to type 2 diabetes mellitus (disorder)	1095	39	28	0	39	28	1028	0.00000	-0.03113	0.00000	0.00000	0.00000	0.6205377963	1.0000000000	0.99726	-0.99802	14	7	0	25	21	0	0.00000	0.00000
89	47693006	Rupture of appendix	17	368581000119106	Neuropathy due to type 2 diabetes mellitus (disorder)	1095	20	28	0	20	28	1047	0.00000	-0.02210	0.00000	0.00000	0.00000	1.0000000000	1.0000000000	0.51142	-0.59590	10	7	0	10	21	0	0.00000	0.00000
86	713197008	Recurrent rectal polyp	17	368581000119106	Neuropathy due to type 2 diabetes mellitus (disorder)	1095	22	28	0	22	28	1045	0.00000	-0.02320	0.00000	0.00000	0.00000	1.0000000000	1.0000000000	0.56256	-0.64391	12	7	0	10	21	0	0.00000	0.00000
75	431855005	Chronic kidney disease stage 1 (disorder)	17	368581000119106	Neuropathy due to type 2 diabetes mellitus (disorder)	1095	28	28	12	16	16	1051	16.76020	0.41358	49.26562	120.76726	20.09735	0.0000000000	0.0000000000	0.71598	2.92141	10	7	3	18	21	9	0.00000	0.36772
72	35999006	Blighted ovum	17	368581000119106	Neuropathy due to type 2 diabetes mellitus (disorder)	1095	53	28	2	51	26	1016	1.47574	0.01738	1.53243	6.63473	0.35395	0.6419780779	1.0000000000	1.35525	0.34908	53	7	2	0	21	0	1.50408	3.31419
69	233604007	Pneumonia	17	368581000119106	Neuropathy due to type 2 diabetes mellitus (disorder)	1095	7	28	0	7	28	1060	0.00000	-0.01299	0.00000	0.00000	0.00000	1.0000000000	1.0000000000	0.17900	-0.23756	3	7	0	4	21	0	0.00000	0.00000
67	403191005	Second degree burn	17	368581000119106	Neuropathy due to type 2 diabetes mellitus (disorder)	1095	49	28	0	49	28	1018	0.00000	-0.03506	0.00000	0.00000	0.00000	0.6324419072	1.0000000000	1.25297	-1.17183	23	7	0	26	21	0	0.00000	0.00000
64	444448004	Injury of medial collateral ligament of knee	17	368581000119106	Neuropathy due to type 2 diabetes mellitus (disorder)	1095	32	28	2	30	26	1037	2.44420	0.04059	2.65897	11.71957	0.60328	0.1957480899	0.8340316782	0.81826	0.72240	17	7	1	15	21	1	-1.01160	0.11778
63	68496003	Polyp of colon	17	368581000119106	Neuropathy due to type 2 diabetes mellitus (disorder)	1095	91	28	3	88	25	979	1.28925	0.01411	1.33500	4.50953	0.39521	0.5009751034	1.0000000000	2.32694	0.26580	43	7	0	48	21	3	-2.07944	-2.83321
50	446096008	Perennial allergic rhinitis	17	368581000119106	Neuropathy due to type 2 diabetes mellitus (disorder)	1095	26	28	0	26	28	1041	0.00000	-0.02526	0.00000	0.00000	0.00000	1.0000000000	1.0000000000	0.66484	-0.73538	14	7	0	12	21	0	0.00000	0.00000
49	88805009	Chronic congestive heart failure (disorder)	17	368581000119106	Neuropathy due to type 2 diabetes mellitus (disorder)	1095	10	28	0	10	28	1057	0.00000	-0.01555	0.00000	0.00000	0.00000	1.0000000000	1.0000000000	0.25571	-0.32850	5	7	0	5	21	0	0.00000	0.00000
47	359817006	Closed fracture of hip	17	368581000119106	Neuropathy due to type 2 diabetes mellitus (disorder)	1095	29	28	0	29	28	1038	0.00000	-0.02672	0.00000	0.00000	0.00000	1.0000000000	1.0000000000	0.74155	-0.80037	11	7	0	18	21	0	0.00000	0.00000
44	58150001	Fracture of clavicle	17	368581000119106	Neuropathy due to type 2 diabetes mellitus (disorder)	1095	112	28	3	109	25	958	1.04751	0.00260	1.05468	3.55045	0.31330	0.7594661643	1.0000000000	2.86393	0.04993	55	7	0	57	21	3	-2.07944	-2.99573
43	307731004	Injury of tendon of the rotator cuff of shoulder	17	368581000119106	Neuropathy due to type 2 diabetes mellitus (disorder)	1095	51	28	3	48	25	1019	2.30042	0.04656	2.54750	8.73347	0.74309	0.1376504409	0.7296699408	1.30411	0.79579	26	7	1	25	21	2	-0.36291	0.69315
42	16114001	Fracture of ankle	17	368581000119106	Neuropathy due to type 2 diabetes mellitus (disorder)	1095	108	28	3	105	25	962	1.08631	0.00462	1.09943	3.70311	0.32641	0.7511776610	1.0000000000	2.76164	0.08864	48	7	1	60	21	2	-0.36291	0.45783
41	283385000	Laceration of thigh	17	368581000119106	Neuropathy due to type 2 diabetes mellitus (disorder)	1095	105	28	4	101	24	966	1.48980	0.02584	1.59406	4.68539	0.54233	0.3348341227	1.0000000000	2.68493	0.44029	50	7	1	55	21	3	0.00000	0.96999
39	74400008	Appendicitis	17	368581000119106	Neuropathy due to type 2 diabetes mellitus (disorder)	1095	51	28	0	51	28	1016	0.00000	-0.03580	0.00000	0.00000	0.00000	0.6369436204	1.0000000000	1.30411	-1.20421	27	7	0	24	21	0	0.00000	0.00000
38	398254007	Preeclampsia	17	368581000119106	Neuropathy due to type 2 diabetes mellitus (disorder)	1095	101	28	3	98	25	969	1.16160	0.00834	1.18653	4.00074	0.35190	0.7380442505	1.0000000000	2.58265	0.15897	101	7	3	0	21	0	1.20397	3.54578
35	19169002	Miscarriage in first trimester	17	368581000119106	Neuropathy due to type 2 diabetes mellitus (disorder)	1095	174	28	5	169	23	898	1.12377	0.00871	1.15513	3.08082	0.43311	0.7925548263	1.0000000000	4.44932	0.13889	174	7	5	0	21	0	0.87547	3.57795
33	429007001	History of cardiac arrest (situation)	17	368581000119106	Neuropathy due to type 2 diabetes mellitus (disorder)	1095	42	28	0	42	28	1025	0.00000	-0.03235	0.00000	0.00000	0.00000	0.6219274450	1.0000000000	1.07397	-1.05240	24	7	0	18	21	0	0.00000	0.00000
32	410429000	Cardiac Arrest	17	368581000119106	Neuropathy due to type 2 diabetes mellitus (disorder)	1095	42	28	0	42	28	1025	0.00000	-0.03235	0.00000	0.00000	0.00000	0.6219274450	1.0000000000	1.07397	-1.05240	24	7	0	18	21	0	0.00000	0.00000
27	408512008	Body mass index 40+ - severely obese (finding)	17	368581000119106	Neuropathy due to type 2 diabetes mellitus (disorder)	1095	97	28	0	97	28	970	0.00000	-0.05050	0.00000	0.00000	0.00000	0.1660127857	0.7915572889	2.48037	-1.79924	67	7	0	30	21	0	0.00000	0.00000
24	162864005	Body mass index 30+ - obesity (finding)	17	368581000119106	Neuropathy due to type 2 diabetes mellitus (disorder)	1095	439	28	11	428	17	639	0.97991	-0.00266	0.96605	2.08276	0.44809	1.0000000000	1.0000000000	11.22557	-0.02687	226	7	3	213	21	8	-0.08388	1.01639
21	15777000	Prediabetes	17	368581000119106	Neuropathy due to type 2 diabetes mellitus (disorder)	1095	333	28	20	313	8	754	2.34878	0.14444	6.02236	13.81723	2.62490	0.0000070487	0.0003093690	8.51507	1.14210	159	7	5	174	21	15	0.00000	0.95673
20	80394007	Hyperglycemia (disorder)	17	368581000119106	Neuropathy due to type 2 diabetes mellitus (disorder)	1095	55	28	26	29	2	1038	18.48701	0.65144	465.31034	2053.93004	105.41436	0.0000000000	0.0000000000	1.40639	3.48802	23	7	7	32	21	19	-0.05129	0.46790
18	302870006	Hypertriglyceridemia (disorder)	17	368581000119106	Neuropathy due to type 2 diabetes mellitus (disorder)	1095	64	28	28	36	0	1031	17.10937	0.65018	0.00000	0.00000	0.00000	0.0000000000	0.0000000000	1.63653	3.45934	28	7	7	36	21	21	0.00000	0.61091
15	40055000	Chronic sinusitis (disorder)	17	368581000119106	Neuropathy due to type 2 diabetes mellitus (disorder)	1095	216	28	7	209	21	858	1.26736	0.02147	1.36842	3.26192	0.57407	0.4720789888	1.0000000000	5.52329	0.29440	104	7	2	112	21	5	-0.14458	0.81756
14	10509002	Acute bronchitis (disorder)	17	368581000119106	Neuropathy due to type 2 diabetes mellitus (disorder)	1095	863	28	28	835	0	232	1.26883	0.08399	0.00000	0.00000	0.00000	0.0017410288	0.0384548664	22.06758	0.33019	418	7	7	445	21	21	0.00000	1.00652
13	370247008	Facial laceration	17	368581000119106	Neuropathy due to type 2 diabetes mellitus (disorder)	1095	109	28	4	105	24	962	1.43512	0.02344	1.52698	4.48525	0.51985	0.5150537613	1.0000000000	2.78721	0.40079	55	7	1	54	21	3	0.00000	1.08091
10	62106007	Concussion with no loss of consciousness	17	368581000119106	Neuropathy due to type 2 diabetes mellitus (disorder)	1095	206	28	10	196	18	871	1.89840	0.07006	2.46882	5.43108	1.12226	0.0275993270	0.3058925414	5.26758	0.81152	96	7	4	110	21	6	-0.49248	0.25705
7	75498004	Acute bacterial sinusitis (disorder)	17	368581000119106	Neuropathy due to type 2 diabetes mellitus (disorder)	1095	187	28	6	181	22	886	1.25477	0.01873	1.33501	3.33903	0.53376	0.6087373008	1.0000000000	4.78174	0.27585	89	7	1	98	21	5	0.43078	1.47452
6	39848009	Whiplash injury to neck	17	368581000119106	Neuropathy due to type 2 diabetes mellitus (disorder)	1095	182	28	4	178	24	889	0.85950	-0.01016	0.83240	2.42838	0.28533	1.0000000000	1.0000000000	4.65388	-0.17731	92	7	1	90	21	3	0.00000	1.09861
116	370143000	Major depression disorder	77	422034002	Diabetic retinopathy associated with type II diabetes mellitus (disorder)	1095	8	20	0	8	20	1067	0.00000	-0.01170	0.00000	0.00000	0.00000	1.0000000000	1.0000000000	0.14612	-0.19676	3	8	0	5	12	0	0.00000	0.00000
117	230265002	Familial Alzheimer's disease of early onset (disorder)	77	422034002	Diabetic retinopathy associated with type II diabetes mellitus (disorder)	1095	6	20	0	6	20	1069	0.00000	-0.01012	0.00000	0.00000	0.00000	1.0000000000	1.0000000000	0.10959	-0.15003	2	8	0	4	12	0	0.00000	0.00000
118	48333001	Burn injury(morphologic abnormality)	77	422034002	Diabetic retinopathy associated with type II diabetes mellitus (disorder)	1095	1	20	0	1	20	1074	0.00000	-0.00412	0.00000	0.00000	0.00000	1.0000000000	1.0000000000	0.01826	-0.02611	0	8	0	1	12	0	0.00000	0.00000
119	275272006	Brain damage - traumatic	77	422034002	Diabetic retinopathy associated with type II diabetes mellitus (disorder)	1095	4	20	0	4	20	1071	0.00000	-0.00826	0.00000	0.00000	0.00000	1.0000000000	1.0000000000	0.07306	-0.10173	0	8	0	4	12	0	0.00000	0.00000
120	162573006	Suspected lung cancer (situation)	77	422034002	Diabetic retinopathy associated with type II diabetes mellitus (disorder)	1095	8	20	0	8	20	1067	0.00000	-0.01170	0.00000	0.00000	0.00000	1.0000000000	1.0000000000	0.14612	-0.19676	0	8	0	8	12	0	0.00000	0.00000
123	195967001	Asthma	77	422034002	Diabetic retinopathy associated with type II diabetes mellitus (disorder)	1095	2	20	0	2	20	1073	0.00000	-0.00583	0.00000	0.00000	0.00000	1.0000000000	1.0000000000	0.03653	-0.05176	1	8	0	1	12	0	0.00000	0.00000
124	1501000119109	Proliferative diabetic retinopathy due to type II diabetes mellitus (disorder)	77	422034002	Diabetic retinopathy associated with type II diabetes mellitus (disorder)	1095	1	20	1	0	19	1075	54.75000	0.22166	0.00000	0.00000	0.00000	0.0182648402	0.2349246247	0.01826	0.97389	1	8	1	0	12	0	2.19722	0.69315
125	1734006	Fracture of the vertebral column with spinal cord injury	77	422034002	Diabetic retinopathy associated with type II diabetes mellitus (disorder)	1095	5	20	0	5	20	1070	0.00000	-0.00924	0.00000	0.00000	0.00000	1.0000000000	1.0000000000	0.09132	-0.12608	3	8	0	2	12	0	0.00000	0.00000
126	698754002	Chronic paralysis due to lesion of spinal cord	77	422034002	Diabetic retinopathy associated with type II diabetes mellitus (disorder)	1095	2	20	0	2	20	1073	0.00000	-0.00583	0.00000	0.00000	0.00000	1.0000000000	1.0000000000	0.03653	-0.05176	2	8	0	0	12	0	0.00000	0.00000
127	431856006	Chronic kidney disease stage 2 (disorder)	77	422034002	Diabetic retinopathy associated with type II diabetes mellitus (disorder)	1095	5	20	0	5	20	1070	0.00000	-0.00924	0.00000	0.00000	0.00000	1.0000000000	1.0000000000	0.09132	-0.12608	3	8	0	2	12	0	0.00000	0.00000
119	275272006	Brain damage - traumatic	37	38822007	Cystitis	1095	4	71	0	4	71	1020	0.00000	-0.01594	0.00000	0.00000	0.00000	1.0000000000	1.0000000000	0.25936	-0.33269	0	68	0	4	3	0	0.00000	0.00000
123	195967001	Asthma	37	38822007	Cystitis	1095	2	71	0	2	71	1022	0.00000	-0.01126	0.00000	0.00000	0.00000	1.0000000000	1.0000000000	0.12968	-0.17591	1	68	0	1	3	0	0.00000	0.00000
131	93761005	Primary malignant neoplasm of colon	77	422034002	Diabetic retinopathy associated with type II diabetes mellitus (disorder)	1095	5	20	0	5	20	1070	0.00000	-0.00924	0.00000	0.00000	0.00000	1.0000000000	1.0000000000	0.09132	-0.12608	3	8	0	2	12	0	0.00000	0.00000
127	431856006	Chronic kidney disease stage 2 (disorder)	37	38822007	Cystitis	1095	5	71	1	4	70	1020	3.08451	0.03718	3.64286	33.03005	0.40177	0.2852512444	0.9659403678	0.32420	0.59488	3	68	1	2	3	0	4.23411	1.38629
128	86849004	Suicidal deliberate poisoning	37	38822007	Cystitis	1095	1	71	0	1	71	1023	0.00000	-0.00796	0.00000	0.00000	0.00000	1.0000000000	1.0000000000	0.06484	-0.09064	0	68	0	1	3	0	0.00000	0.00000
131	93761005	Primary malignant neoplasm of colon	37	38822007	Cystitis	1095	5	71	2	3	69	1021	6.16901	0.09218	9.86473	60.02108	1.62131	0.0364906481	0.3590974313	0.32420	1.17984	3	68	1	2	3	1	2.84781	0.28768
125	1734006	Fracture of the vertebral column with spinal cord injury	130	314994000	Metastasis from malignant tumor of prostate (disorder)	1095	5	1	0	5	1	1089	0.00000	-0.00205	0.00000	0.00000	0.00000	1.0000000000	1.0000000000	0.00457	-0.00657	3	0	0	2	1	0	0.00000	0.00000
118	48333001	Burn injury(morphologic abnormality)	130	314994000	Metastasis from malignant tumor of prostate (disorder)	1095	1	1	0	1	1	1093	0.00000	-0.00091	0.00000	0.00000	0.00000	1.0000000000	1.0000000000	0.00091	-0.00132	0	0	0	1	1	0	0.00000	0.00000
117	230265002	Familial Alzheimer's disease of early onset (disorder)	130	314994000	Metastasis from malignant tumor of prostate (disorder)	1095	6	1	0	6	1	1088	0.00000	-0.00224	0.00000	0.00000	0.00000	1.0000000000	1.0000000000	0.00548	-0.00788	2	0	0	4	1	0	0.00000	0.00000
109	90560007	Gout	130	314994000	Metastasis from malignant tumor of prostate (disorder)	1095	4	1	0	4	1	1090	0.00000	-0.00183	0.00000	0.00000	0.00000	1.0000000000	1.0000000000	0.00365	-0.00526	0	0	0	4	1	0	0.00000	0.00000
102	90781000119102	Microalbuminuria due to type 2 diabetes mellitus (disorder)	130	314994000	Metastasis from malignant tumor of prostate (disorder)	1095	6	1	0	6	1	1088	0.00000	-0.00224	0.00000	0.00000	0.00000	1.0000000000	1.0000000000	0.00548	-0.00788	3	0	0	3	1	0	0.00000	0.00000
97	403192003	Third degree burn	130	314994000	Metastasis from malignant tumor of prostate (disorder)	1095	8	1	0	8	1	1086	0.00000	-0.00259	0.00000	0.00000	0.00000	1.0000000000	1.0000000000	0.00731	-0.01050	3	0	0	5	1	0	0.00000	0.00000
96	283371005	Laceration of forearm	130	314994000	Metastasis from malignant tumor of prostate (disorder)	1095	75	1	1	74	0	1020	14.60000	0.11150	0.00000	0.00000	0.00000	0.0684931507	0.5135368799	0.06849	0.90442	39	0	0	36	1	1	-0.69315	-3.61092
94	703151001	History of single seizure (situation)	130	314994000	Metastasis from malignant tumor of prostate (disorder)	1095	39	1	0	39	1	1055	0.00000	-0.00581	0.00000	0.00000	0.00000	1.0000000000	1.0000000000	0.03562	-0.05049	14	0	0	25	1	0	0.00000	0.00000
93	128613002	Seizure disorder	130	314994000	Metastasis from malignant tumor of prostate (disorder)	1095	39	1	0	39	1	1055	0.00000	-0.00581	0.00000	0.00000	0.00000	1.0000000000	1.0000000000	0.03562	-0.05049	14	0	0	25	1	0	0.00000	0.00000
89	47693006	Rupture of appendix	130	314994000	Metastasis from malignant tumor of prostate (disorder)	1095	20	1	0	20	1	1074	0.00000	-0.00412	0.00000	0.00000	0.00000	1.0000000000	1.0000000000	0.01826	-0.02611	10	0	0	10	1	0	0.00000	0.00000
86	713197008	Recurrent rectal polyp	130	314994000	Metastasis from malignant tumor of prostate (disorder)	1095	22	1	0	22	1	1072	0.00000	-0.00433	0.00000	0.00000	0.00000	1.0000000000	1.0000000000	0.02009	-0.02870	12	0	0	10	1	0	0.00000	0.00000
75	431855005	Chronic kidney disease stage 1 (disorder)	130	314994000	Metastasis from malignant tumor of prostate (disorder)	1095	28	1	1	27	0	1067	39.10714	0.18664	0.00000	0.00000	0.00000	0.0255707763	0.2905941929	0.02557	0.96357	10	0	0	18	1	1	-0.69315	-2.94444
69	233604007	Pneumonia	130	314994000	Metastasis from malignant tumor of prostate (disorder)	1095	7	1	0	7	1	1087	0.00000	-0.00243	0.00000	0.00000	0.00000	1.0000000000	1.0000000000	0.00639	-0.00919	3	0	0	4	1	0	0.00000	0.00000
64	444448004	Injury of medial collateral ligament of knee	130	314994000	Metastasis from malignant tumor of prostate (disorder)	1095	32	1	0	32	1	1062	0.00000	-0.00525	0.00000	0.00000	0.00000	1.0000000000	1.0000000000	0.02922	-0.04156	17	0	0	15	1	0	0.00000	0.00000
49	88805009	Chronic congestive heart failure (disorder)	130	314994000	Metastasis from malignant tumor of prostate (disorder)	1095	10	1	0	10	1	1084	0.00000	-0.00290	0.00000	0.00000	0.00000	1.0000000000	1.0000000000	0.00913	-0.01312	5	0	0	5	1	0	0.00000	0.00000
47	359817006	Closed fracture of hip	130	314994000	Metastasis from malignant tumor of prostate (disorder)	1095	29	1	0	29	1	1065	0.00000	-0.00499	0.00000	0.00000	0.00000	1.0000000000	1.0000000000	0.02648	-0.03771	11	0	0	18	1	0	0.00000	0.00000
44	58150001	Fracture of clavicle	130	314994000	Metastasis from malignant tumor of prostate (disorder)	1095	112	1	0	112	1	982	0.00000	-0.01021	0.00000	0.00000	0.00000	1.0000000000	1.0000000000	0.10228	-0.14049	55	0	0	57	1	0	0.00000	0.00000
43	307731004	Injury of tendon of the rotator cuff of shoulder	130	314994000	Metastasis from malignant tumor of prostate (disorder)	1095	51	1	0	51	1	1043	0.00000	-0.00668	0.00000	0.00000	0.00000	1.0000000000	1.0000000000	0.04658	-0.06568	26	0	0	25	1	0	0.00000	0.00000
42	16114001	Fracture of ankle	130	314994000	Metastasis from malignant tumor of prostate (disorder)	1095	108	1	0	108	1	986	0.00000	-0.01000	0.00000	0.00000	0.00000	1.0000000000	1.0000000000	0.09863	-0.13571	48	0	0	60	1	0	0.00000	0.00000
41	283385000	Laceration of thigh	130	314994000	Metastasis from malignant tumor of prostate (disorder)	1095	105	1	1	104	0	990	10.42857	0.09284	0.00000	0.00000	0.00000	0.0958904110	0.6155535021	0.09589	0.86790	50	0	0	55	1	1	-0.69315	-4.02535
39	74400008	Appendicitis	130	314994000	Metastasis from malignant tumor of prostate (disorder)	1095	51	1	0	51	1	1043	0.00000	-0.00668	0.00000	0.00000	0.00000	1.0000000000	1.0000000000	0.04658	-0.06568	27	0	0	24	1	0	0.00000	0.00000
38	398254007	Preeclampsia	130	314994000	Metastasis from malignant tumor of prostate (disorder)	1095	101	1	0	101	1	993	0.00000	-0.00964	0.00000	0.00000	0.00000	1.0000000000	1.0000000000	0.09224	-0.12729	101	0	0	0	1	0	0.00000	0.00000
35	19169002	Miscarriage in first trimester	130	314994000	Metastasis from malignant tumor of prostate (disorder)	1095	174	1	0	174	1	920	0.00000	-0.01314	0.00000	0.00000	0.00000	1.0000000000	1.0000000000	0.15890	-0.21276	174	0	0	0	1	0	0.00000	0.00000
33	429007001	History of cardiac arrest (situation)	130	314994000	Metastasis from malignant tumor of prostate (disorder)	1095	42	1	0	42	1	1052	0.00000	-0.00604	0.00000	0.00000	0.00000	1.0000000000	1.0000000000	0.03836	-0.05430	24	0	0	18	1	0	0.00000	0.00000
32	410429000	Cardiac Arrest	130	314994000	Metastasis from malignant tumor of prostate (disorder)	1095	42	1	0	42	1	1052	0.00000	-0.00604	0.00000	0.00000	0.00000	1.0000000000	1.0000000000	0.03836	-0.05430	24	0	0	18	1	0	0.00000	0.00000
27	408512008	Body mass index 40+ - severely obese (finding)	130	314994000	Metastasis from malignant tumor of prostate (disorder)	1095	97	1	0	97	1	997	0.00000	-0.00943	0.00000	0.00000	0.00000	1.0000000000	1.0000000000	0.08858	-0.12245	67	0	0	30	1	0	0.00000	0.00000
21	15777000	Prediabetes	130	314994000	Metastasis from malignant tumor of prostate (disorder)	1095	333	1	0	333	1	761	0.00000	-0.01999	0.00000	0.00000	0.00000	1.0000000000	1.0000000000	0.30411	-0.38307	159	0	0	174	1	0	0.00000	0.00000
18	302870006	Hypertriglyceridemia (disorder)	130	314994000	Metastasis from malignant tumor of prostate (disorder)	1095	64	1	1	63	0	1031	17.10937	0.12135	0.00000	0.00000	0.00000	0.0584474886	0.4685406893	0.05845	0.91805	28	0	0	36	1	1	-0.69315	-3.61092
130	314994000	Metastasis from malignant tumor of prostate (disorder)	104	367498001	Seasonal allergic rhinitis	1095	1	20	0	1	20	1074	0.00000	-0.00412	0.00000	0.00000	0.00000	1.0000000000	1.0000000000	0.01826	-0.02611	0	9	0	1	11	0	0.00000	0.00000
129	47505003	Posttraumatic stress disorder	104	367498001	Seasonal allergic rhinitis	1095	4	20	0	4	20	1071	0.00000	-0.00826	0.00000	0.00000	0.00000	1.0000000000	1.0000000000	0.07306	-0.10173	1	9	0	3	11	0	0.00000	0.00000
15	40055000	Chronic sinusitis (disorder)	130	314994000	Metastasis from malignant tumor of prostate (disorder)	1095	216	1	0	216	1	878	0.00000	-0.01499	0.00000	0.00000	0.00000	1.0000000000	1.0000000000	0.19726	-0.25974	104	0	0	112	1	0	0.00000	0.00000
14	10509002	Acute bronchitis (disorder)	130	314994000	Metastasis from malignant tumor of prostate (disorder)	1095	863	1	1	862	0	232	1.26883	0.01568	0.00000	0.00000	0.00000	1.0000000000	1.0000000000	0.78813	0.16155	418	0	0	445	1	1	-0.69315	-6.10032
125	1734006	Fracture of the vertebral column with spinal cord injury	104	367498001	Seasonal allergic rhinitis	1095	5	20	0	5	20	1070	0.00000	-0.00924	0.00000	0.00000	0.00000	1.0000000000	1.0000000000	0.09132	-0.12608	3	9	0	2	11	0	0.00000	0.00000
124	1501000119109	Proliferative diabetic retinopathy due to type II diabetes mellitus (disorder)	104	367498001	Seasonal allergic rhinitis	1095	1	20	0	1	20	1074	0.00000	-0.00412	0.00000	0.00000	0.00000	1.0000000000	1.0000000000	0.01826	-0.02611	1	9	0	0	11	0	0.00000	0.00000
121	254637007	Non-small cell lung cancer (disorder)	104	367498001	Seasonal allergic rhinitis	1095	8	20	0	8	20	1067	0.00000	-0.01170	0.00000	0.00000	0.00000	1.0000000000	1.0000000000	0.14612	-0.19676	0	9	0	8	11	0	0.00000	0.00000
120	162573006	Suspected lung cancer (situation)	104	367498001	Seasonal allergic rhinitis	1095	8	20	0	8	20	1067	0.00000	-0.01170	0.00000	0.00000	0.00000	1.0000000000	1.0000000000	0.14612	-0.19676	0	9	0	8	11	0	0.00000	0.00000
6	39848009	Whiplash injury to neck	130	314994000	Metastasis from malignant tumor of prostate (disorder)	1095	182	1	0	182	1	912	0.00000	-0.01350	0.00000	0.00000	0.00000	1.0000000000	1.0000000000	0.16621	-0.22183	92	0	0	90	1	0	0.00000	0.00000
118	48333001	Burn injury(morphologic abnormality)	104	367498001	Seasonal allergic rhinitis	1095	1	20	0	1	20	1074	0.00000	-0.00412	0.00000	0.00000	0.00000	1.0000000000	1.0000000000	0.01826	-0.02611	0	9	0	1	11	0	0.00000	0.00000
117	230265002	Familial Alzheimer's disease of early onset (disorder)	104	367498001	Seasonal allergic rhinitis	1095	6	20	0	6	20	1069	0.00000	-0.01012	0.00000	0.00000	0.00000	1.0000000000	1.0000000000	0.10959	-0.15003	2	9	0	4	11	0	0.00000	0.00000
115	36923009	Major depression  single episode	104	367498001	Seasonal allergic rhinitis	1095	6	20	0	6	20	1069	0.00000	-0.01012	0.00000	0.00000	0.00000	1.0000000000	1.0000000000	0.10959	-0.15003	3	9	0	3	11	0	0.00000	0.00000
114	449868002	Smokes tobacco daily	104	367498001	Seasonal allergic rhinitis	1095	9	20	0	9	20	1066	0.00000	-0.01242	0.00000	0.00000	0.00000	1.0000000000	1.0000000000	0.16438	-0.21957	2	9	0	7	11	0	0.00000	0.00000
111	235919008	Cholelithiasis	104	367498001	Seasonal allergic rhinitis	1095	9	20	0	9	20	1066	0.00000	-0.01242	0.00000	0.00000	0.00000	1.0000000000	1.0000000000	0.16438	-0.21957	7	9	0	2	11	0	0.00000	0.00000
109	90560007	Gout	104	367498001	Seasonal allergic rhinitis	1095	4	20	0	4	20	1071	0.00000	-0.00826	0.00000	0.00000	0.00000	1.0000000000	1.0000000000	0.07306	-0.10173	0	9	0	4	11	0	0.00000	0.00000
108	40930008	Hypothyroidism (disorder)	104	367498001	Seasonal allergic rhinitis	1095	13	20	0	13	20	1062	0.00000	-0.01495	0.00000	0.00000	0.00000	1.0000000000	1.0000000000	0.23744	-0.30736	11	9	0	2	11	0	0.00000	0.00000
107	40275004	Contact dermatitis	104	367498001	Seasonal allergic rhinitis	1095	18	20	0	18	20	1057	0.00000	-0.01763	0.00000	0.00000	0.00000	1.0000000000	1.0000000000	0.32877	-0.41009	9	9	0	9	11	0	0.00000	0.00000
106	24079001	Atopic dermatitis	104	367498001	Seasonal allergic rhinitis	1095	20	20	5	15	15	1060	13.68750	0.23605	23.55556	73.15270	7.58501	0.0000155451	0.0006259398	0.36530	2.13575	13	9	3	7	11	2	-0.48551	0.16990
105	363406005	Malignant tumor of colon	104	367498001	Seasonal allergic rhinitis	1095	6	20	0	6	20	1069	0.00000	-0.01012	0.00000	0.00000	0.00000	1.0000000000	1.0000000000	0.10959	-0.15003	4	9	0	2	11	0	0.00000	0.00000
102	90781000119102	Microalbuminuria due to type 2 diabetes mellitus (disorder)	104	367498001	Seasonal allergic rhinitis	1095	6	20	0	6	20	1069	0.00000	-0.01012	0.00000	0.00000	0.00000	1.0000000000	1.0000000000	0.10959	-0.15003	3	9	0	3	11	0	0.00000	0.00000
101	433144002	Chronic kidney disease stage 3 (disorder)	104	367498001	Seasonal allergic rhinitis	1095	3	20	0	3	20	1072	0.00000	-0.00715	0.00000	0.00000	0.00000	1.0000000000	1.0000000000	0.05479	-0.07696	1	9	0	2	11	0	0.00000	0.00000
100	161622006	History of lower limb amputation (situation)	104	367498001	Seasonal allergic rhinitis	1095	1	20	0	1	20	1074	0.00000	-0.00412	0.00000	0.00000	0.00000	1.0000000000	1.0000000000	0.01826	-0.02611	0	9	0	1	11	0	0.00000	0.00000
98	1551000119108	Nonproliferative diabetic retinopathy due to type 2 diabetes mellitus (disorder)	104	367498001	Seasonal allergic rhinitis	1095	12	20	0	12	20	1063	0.00000	-0.01436	0.00000	0.00000	0.00000	1.0000000000	1.0000000000	0.21918	-0.28591	7	9	0	5	11	0	0.00000	0.00000
97	403192003	Third degree burn	104	367498001	Seasonal allergic rhinitis	1095	8	20	0	8	20	1067	0.00000	-0.01170	0.00000	0.00000	0.00000	1.0000000000	1.0000000000	0.14612	-0.19676	3	9	0	5	11	0	0.00000	0.00000
96	283371005	Laceration of forearm	104	367498001	Seasonal allergic rhinitis	1095	75	20	2	73	18	1002	1.46000	0.01701	1.52511	6.70021	0.34715	0.6420947120	1.0000000000	1.36986	0.34016	39	9	2	36	11	0	1.70475	3.02042
95	84757009	Epilepsy	104	367498001	Seasonal allergic rhinitis	1095	30	20	1	29	19	1046	1.82500	0.01889	1.89837	14.66475	0.24575	0.4290985694	1.0000000000	0.54795	0.36965	13	9	1	17	11	0	2.30259	2.63906
94	703151001	History of single seizure (situation)	104	367498001	Seasonal allergic rhinitis	1095	39	20	1	38	19	1037	1.40385	0.01059	1.43629	11.01035	0.18736	0.5189626562	1.0000000000	0.71233	0.22404	14	9	1	25	11	0	2.30259	2.70805
93	128613002	Seizure disorder	104	367498001	Seasonal allergic rhinitis	1095	39	20	1	38	19	1037	1.40385	0.01059	1.43629	11.01035	0.18736	0.5189626562	1.0000000000	0.71233	0.22404	14	9	1	25	11	0	2.30259	2.70805
89	47693006	Rupture of appendix	104	367498001	Seasonal allergic rhinitis	1095	20	20	0	20	20	1055	0.00000	-0.01860	0.00000	0.00000	0.00000	1.0000000000	1.0000000000	0.36530	-0.44921	10	9	0	10	11	0	0.00000	0.00000
86	713197008	Recurrent rectal polyp	104	367498001	Seasonal allergic rhinitis	1095	22	20	0	22	20	1053	0.00000	-0.01953	0.00000	0.00000	0.00000	1.0000000000	1.0000000000	0.40183	-0.48731	12	9	0	10	11	0	0.00000	0.00000
130	314994000	Metastasis from malignant tumor of prostate (disorder)	101	433144002	Chronic kidney disease stage 3 (disorder)	1095	1	3	0	1	3	1091	0.00000	-0.00158	0.00000	0.00000	0.00000	1.0000000000	1.0000000000	0.00274	-0.00395	0	1	0	1	2	0	0.00000	0.00000
82	94260004	Secondary malignant neoplasm of colon	104	367498001	Seasonal allergic rhinitis	1095	4	20	0	4	20	1071	0.00000	-0.00826	0.00000	0.00000	0.00000	1.0000000000	1.0000000000	0.07306	-0.10173	2	9	0	2	11	0	0.00000	0.00000
80	6072007	Bleeding from anus	104	367498001	Seasonal allergic rhinitis	1095	4	20	0	4	20	1071	0.00000	-0.00826	0.00000	0.00000	0.00000	1.0000000000	1.0000000000	0.07306	-0.10173	2	9	0	2	11	0	0.00000	0.00000
78	239872002	Osteoarthritis of hip	104	367498001	Seasonal allergic rhinitis	1095	21	20	0	21	20	1054	0.00000	-0.01907	0.00000	0.00000	0.00000	1.0000000000	1.0000000000	0.38356	-0.46839	13	9	0	8	11	0	0.00000	0.00000
76	127013003	Diabetic renal disease (disorder)	104	367498001	Seasonal allergic rhinitis	1095	28	20	0	28	20	1047	0.00000	-0.02210	0.00000	0.00000	0.00000	1.0000000000	1.0000000000	0.51142	-0.59590	10	9	0	18	11	0	0.00000	0.00000
75	431855005	Chronic kidney disease stage 1 (disorder)	104	367498001	Seasonal allergic rhinitis	1095	28	20	0	28	20	1047	0.00000	-0.02210	0.00000	0.00000	0.00000	1.0000000000	1.0000000000	0.51142	-0.59590	10	9	0	18	11	0	0.00000	0.00000
73	196416002	Impacted molars	104	367498001	Seasonal allergic rhinitis	1095	49	20	1	48	19	1027	1.11735	0.00346	1.12610	8.58797	0.14766	0.6030116966	1.0000000000	0.89498	0.07782	25	9	1	24	11	0	2.30259	3.25810
72	35999006	Blighted ovum	104	367498001	Seasonal allergic rhinitis	1095	53	20	0	53	20	1022	0.00000	-0.03076	0.00000	0.00000	0.00000	0.6192657233	1.0000000000	0.96804	-0.97676	53	9	0	0	11	0	0.00000	0.00000
71	201834006	Localized  primary osteoarthritis of the hand	104	367498001	Seasonal allergic rhinitis	1095	28	20	0	28	20	1047	0.00000	-0.02210	0.00000	0.00000	0.00000	1.0000000000	1.0000000000	0.51142	-0.59590	19	9	0	9	11	0	0.00000	0.00000
70	87433001	Pulmonary emphysema (disorder)	104	367498001	Seasonal allergic rhinitis	1095	17	20	1	16	19	1059	3.22059	0.03804	3.48355	27.62301	0.43931	0.2707271537	0.9415384133	0.31050	0.60988	9	9	1	8	11	0	2.30259	2.30259
69	233604007	Pneumonia	104	367498001	Seasonal allergic rhinitis	1095	7	20	0	7	20	1068	0.00000	-0.01094	0.00000	0.00000	0.00000	1.0000000000	1.0000000000	0.12785	-0.17358	3	9	0	4	11	0	0.00000	0.00000
68	26929004	Alzheimer's disease (disorder)	104	367498001	Seasonal allergic rhinitis	1095	23	20	0	23	20	1052	0.00000	-0.01998	0.00000	0.00000	0.00000	1.0000000000	1.0000000000	0.42009	-0.50598	15	9	0	8	11	0	0.00000	0.00000
67	403191005	Second degree burn	104	367498001	Seasonal allergic rhinitis	1095	49	20	0	49	20	1026	0.00000	-0.02952	0.00000	0.00000	0.00000	1.0000000000	1.0000000000	0.89498	-0.92218	23	9	0	26	11	0	0.00000	0.00000
65	239873007	Osteoarthritis of knee	104	367498001	Seasonal allergic rhinitis	1095	57	20	0	57	20	1018	0.00000	-0.03196	0.00000	0.00000	0.00000	0.6196301622	1.0000000000	1.04110	-1.02934	30	9	0	27	11	0	0.00000	0.00000
64	444448004	Injury of medial collateral ligament of knee	104	367498001	Seasonal allergic rhinitis	1095	32	20	1	31	19	1044	1.71094	0.01682	1.77250	13.66383	0.22993	0.4503494275	1.0000000000	0.58447	0.33600	17	9	0	15	11	1	-2.48491	-2.77259
63	68496003	Polyp of colon	104	367498001	Seasonal allergic rhinitis	1095	91	20	0	91	20	984	0.00000	-0.04106	0.00000	0.00000	0.00000	0.4011917579	1.0000000000	1.66210	-1.41257	43	9	0	48	11	0	0.00000	0.00000
59	262574004	Bullet wound	104	367498001	Seasonal allergic rhinitis	1095	20	20	0	20	20	1055	0.00000	-0.01860	0.00000	0.00000	0.00000	1.0000000000	1.0000000000	0.36530	-0.44921	9	9	0	11	11	0	0.00000	0.00000
58	239720000	Tear of meniscus of knee	104	367498001	Seasonal allergic rhinitis	1095	20	20	0	20	20	1055	0.00000	-0.01860	0.00000	0.00000	0.00000	1.0000000000	1.0000000000	0.36530	-0.44921	10	9	0	10	11	0	0.00000	0.00000
57	192127007	Child attention deficit disorder	104	367498001	Seasonal allergic rhinitis	1095	76	20	1	75	19	1000	0.72039	-0.01042	0.70175	5.31406	0.09267	1.0000000000	1.0000000000	1.38813	-0.25588	24	9	0	52	11	1	-2.48491	-3.97029
56	92691004	Carcinoma in situ of prostate (disorder)	104	367498001	Seasonal allergic rhinitis	1095	23	20	0	23	20	1052	0.00000	-0.01998	0.00000	0.00000	0.00000	1.0000000000	1.0000000000	0.42009	-0.50598	0	9	0	23	11	0	0.00000	0.00000
54	5602001	Opioid abuse (disorder)	104	367498001	Seasonal allergic rhinitis	1095	7	20	0	7	20	1068	0.00000	-0.01094	0.00000	0.00000	0.00000	1.0000000000	1.0000000000	0.12785	-0.17358	0	9	0	7	11	0	0.00000	0.00000
52	124171000119105	Chronic intractable migraine without aura	104	367498001	Seasonal allergic rhinitis	1095	51	20	1	50	19	1025	1.07353	0.00222	1.07895	8.22193	0.14159	0.6180548828	1.0000000000	0.93151	0.05027	21	9	1	30	11	0	2.30259	3.09104
50	446096008	Perennial allergic rhinitis	104	367498001	Seasonal allergic rhinitis	1095	26	20	0	26	20	1049	0.00000	-0.02127	0.00000	0.00000	0.00000	1.0000000000	1.0000000000	0.47489	-0.56060	14	9	0	12	11	0	0.00000	0.00000
49	88805009	Chronic congestive heart failure (disorder)	104	367498001	Seasonal allergic rhinitis	1095	10	20	0	10	20	1065	0.00000	-0.01309	0.00000	0.00000	0.00000	1.0000000000	1.0000000000	0.18265	-0.24202	5	9	0	5	11	0	0.00000	0.00000
47	359817006	Closed fracture of hip	104	367498001	Seasonal allergic rhinitis	1095	29	20	1	28	19	1047	1.88793	0.01998	1.96805	15.22059	0.25447	0.4181826721	1.0000000000	0.52968	0.38677	11	9	1	18	11	0	2.30259	2.48491
45	263102004	Fracture subluxation of wrist	104	367498001	Seasonal allergic rhinitis	1095	109	20	2	107	18	968	1.00459	0.00021	1.00519	4.39134	0.23009	1.0000000000	1.0000000000	1.99087	0.00440	51	9	1	58	11	1	-0.18232	-0.12629
44	58150001	Fracture of clavicle	104	367498001	Seasonal allergic rhinitis	1095	112	20	0	112	20	963	0.00000	-0.04604	0.00000	0.00000	0.00000	0.2527230989	0.9133257124	2.04566	-1.60676	55	9	0	57	11	0	0.00000	0.00000
43	307731004	Injury of tendon of the rotator cuff of shoulder	104	367498001	Seasonal allergic rhinitis	1095	51	20	1	50	19	1025	1.07353	0.00222	1.07895	8.22193	0.14159	0.6180548828	1.0000000000	0.93151	0.05027	26	9	0	25	11	1	-2.48491	-3.25810
42	16114001	Fracture of ankle	104	367498001	Seasonal allergic rhinitis	1095	108	20	3	105	17	970	1.52083	0.02350	1.63025	5.65489	0.46999	0.4378726763	1.0000000000	1.97260	0.42827	48	9	3	60	11	0	1.38629	2.83321
41	283385000	Laceration of thigh	104	367498001	Seasonal allergic rhinitis	1095	105	20	1	104	19	971	0.52143	-0.02126	0.49140	3.70811	0.06512	0.7126451747	1.0000000000	1.91781	-0.54489	50	9	1	55	11	0	2.30259	3.93183
39	74400008	Appendicitis	104	367498001	Seasonal allergic rhinitis	1095	51	20	1	50	19	1025	1.07353	0.00222	1.07895	8.22193	0.14159	0.6180548828	1.0000000000	0.93151	0.05027	27	9	0	24	11	1	-2.48491	-3.21888
38	398254007	Preeclampsia	104	367498001	Seasonal allergic rhinitis	1095	101	20	1	100	19	975	0.54208	-0.01991	0.51316	3.87372	0.06798	1.0000000000	1.0000000000	1.84475	-0.50830	101	9	1	0	11	0	2.30259	4.62497
35	19169002	Miscarriage in first trimester	104	367498001	Seasonal allergic rhinitis	1095	174	20	2	172	18	903	0.62931	-0.02198	0.58333	2.53691	0.13413	0.7565265678	1.0000000000	3.17808	-0.47788	174	9	2	0	11	0	1.70475	4.47734
33	429007001	History of cardiac arrest (situation)	104	367498001	Seasonal allergic rhinitis	1095	42	20	0	42	20	1033	0.00000	-0.02724	0.00000	0.00000	0.00000	1.0000000000	1.0000000000	0.76712	-0.82140	24	9	0	18	11	0	0.00000	0.00000
32	410429000	Cardiac Arrest	104	367498001	Seasonal allergic rhinitis	1095	42	20	0	42	20	1033	0.00000	-0.02724	0.00000	0.00000	0.00000	1.0000000000	1.0000000000	0.76712	-0.82140	24	9	0	18	11	0	0.00000	0.00000
30	399211009	History of myocardial infarction (situation)	104	367498001	Seasonal allergic rhinitis	1095	31	20	1	30	19	1045	1.76613	0.01784	1.83333	14.14710	0.23758	0.4398197230	1.0000000000	0.56621	0.35272	2	9	0	29	11	1	-2.48491	-3.40120
29	22298006	Myocardial Infarction	104	367498001	Seasonal allergic rhinitis	1095	31	20	1	30	19	1045	1.76613	0.01784	1.83333	14.14710	0.23758	0.4398197230	1.0000000000	0.56621	0.35272	2	9	0	29	11	1	-2.48491	-3.40120
27	408512008	Body mass index 40+ - severely obese (finding)	104	367498001	Seasonal allergic rhinitis	1095	97	20	1	96	19	979	0.56443	-0.01852	0.53673	4.05327	0.07107	1.0000000000	1.0000000000	1.77169	-0.47077	67	9	1	30	11	0	2.30259	4.21951
24	162864005	Body mass index 30+ - obesity (finding)	104	367498001	Seasonal allergic rhinitis	1095	439	20	5	434	15	641	0.62358	-0.04200	0.49232	1.36452	0.17763	0.2488306663	0.9133257124	8.01826	-0.58789	226	9	3	213	11	2	-0.48551	-0.34238
23	36971009	Sinusitis (disorder)	104	367498001	Seasonal allergic rhinitis	1095	190	20	1	189	19	886	0.28816	-0.04449	0.24673	1.85435	0.03283	0.2292431194	0.8880487574	3.47032	-1.16038	84	9	1	106	11	0	2.30259	4.44265
21	15777000	Prediabetes	104	367498001	Seasonal allergic rhinitis	1095	333	20	3	330	17	745	0.49324	-0.04569	0.39840	1.36874	0.11596	0.1487324088	0.7568539622	6.08219	-0.82420	159	9	1	174	11	2	0.43078	0.59784
20	80394007	Hyperglycemia (disorder)	104	367498001	Seasonal allergic rhinitis	1095	55	20	0	55	20	1020	0.00000	-0.03137	0.00000	0.00000	0.00000	0.6191825171	1.0000000000	1.00457	-1.00329	23	9	0	32	11	0	0.00000	0.00000
19	237602007	Metabolic syndrome X (disorder)	104	367498001	Seasonal allergic rhinitis	1095	64	20	0	64	20	1011	0.00000	-0.03398	0.00000	0.00000	0.00000	0.6248676804	1.0000000000	1.16895	-1.11700	28	9	0	36	11	0	0.00000	0.00000
18	302870006	Hypertriglyceridemia (disorder)	104	367498001	Seasonal allergic rhinitis	1095	64	20	0	64	20	1011	0.00000	-0.03398	0.00000	0.00000	0.00000	0.6248676804	1.0000000000	1.16895	-1.11700	28	9	0	36	11	0	0.00000	0.00000
17	368581000119106	Neuropathy due to type 2 diabetes mellitus (disorder)	104	367498001	Seasonal allergic rhinitis	1095	28	20	0	28	20	1047	0.00000	-0.02210	0.00000	0.00000	0.00000	1.0000000000	1.0000000000	0.51142	-0.59590	7	9	0	21	11	0	0.00000	0.00000
129	47505003	Posttraumatic stress disorder	78	239872002	Osteoarthritis of hip	1095	4	21	0	4	21	1070	0.00000	-0.00847	0.00000	0.00000	0.00000	1.0000000000	1.0000000000	0.07671	-0.10663	1	13	0	3	8	0	0.00000	0.00000
15	40055000	Chronic sinusitis (disorder)	104	367498001	Seasonal allergic rhinitis	1095	216	20	4	212	16	863	1.01389	0.00094	1.01769	3.07542	0.33676	1.0000000000	1.0000000000	3.94521	0.01590	104	9	3	112	11	1	-1.09861	-1.15317
14	10509002	Acute bronchitis (disorder)	104	367498001	Seasonal allergic rhinitis	1095	863	20	16	847	4	228	1.01506	0.00396	1.07674	3.25213	0.35650	1.0000000000	1.0000000000	15.76256	0.02029	418	9	8	445	11	8	-0.11123	-0.06145
13	370247008	Facial laceration	104	367498001	Seasonal allergic rhinitis	1095	109	20	1	108	19	967	0.50229	-0.02257	0.47125	3.55487	0.06247	0.7121796267	1.0000000000	1.99087	-0.58056	55	9	0	54	11	1	-2.48491	-4.00733
125	1734006	Fracture of the vertebral column with spinal cord injury	78	239872002	Osteoarthritis of hip	1095	5	21	0	5	21	1069	0.00000	-0.00947	0.00000	0.00000	0.00000	1.0000000000	1.0000000000	0.09589	-0.13210	3	13	0	2	8	0	0.00000	0.00000
10	62106007	Concussion with no loss of consciousness	104	367498001	Seasonal allergic rhinitis	1095	206	20	3	203	17	872	0.79733	-0.01331	0.75804	2.61125	0.22006	1.0000000000	1.0000000000	3.76256	-0.25174	96	9	1	110	11	2	0.43078	0.54936
8	233678006	Childhood asthma	104	367498001	Seasonal allergic rhinitis	1095	45	20	8	37	12	1038	9.73333	0.24661	18.70270	48.49542	7.21287	0.0000003755	0.0000207328	0.82192	2.30447	25	9	6	20	11	2	-0.95551	-0.75567
7	75498004	Acute bacterial sinusitis (disorder)	104	367498001	Seasonal allergic rhinitis	1095	187	20	5	182	15	893	1.46390	0.02872	1.63553	4.55655	0.58706	0.3646611401	1.0000000000	3.41553	0.44238	89	9	3	98	11	2	-0.48551	-0.48885
6	39848009	Whiplash injury to neck	104	367498001	Seasonal allergic rhinitis	1095	182	20	2	180	18	895	0.60165	-0.02426	0.55247	2.40190	0.12708	0.5562916701	1.0000000000	3.32420	-0.52747	92	9	1	90	11	1	-0.18232	0.02174
5	284549007	Laceration of hand	104	367498001	Seasonal allergic rhinitis	1095	104	20	1	103	19	972	0.52644	-0.02092	0.49668	3.74829	0.06581	0.7129039389	1.0000000000	1.89954	-0.53583	54	9	1	50	11	0	2.30259	4.00733
117	230265002	Familial Alzheimer's disease of early onset (disorder)	78	239872002	Osteoarthritis of hip	1095	6	21	1	5	20	1069	8.69048	0.07982	10.69000	95.72098	1.19385	0.1099298174	0.6537696051	0.11507	0.84287	2	13	1	4	8	0	2.63906	1.09861
115	36923009	Major depression  single episode	78	239872002	Osteoarthritis of hip	1095	6	21	0	6	21	1068	0.00000	-0.01038	0.00000	0.00000	0.00000	1.0000000000	1.0000000000	0.11507	-0.15713	3	13	0	3	8	0	0.00000	0.00000
1	444814009	Viral sinusitis (disorder)	104	367498001	Seasonal allergic rhinitis	1095	993	20	19	974	1	101	1.04758	0.02025	1.97023	14.87143	0.26102	1.0000000000	1.0000000000	18.13699	0.06364	478	9	8	515	11	11	0.06062	0.23936
109	90560007	Gout	78	239872002	Osteoarthritis of hip	1095	4	21	0	4	21	1070	0.00000	-0.00847	0.00000	0.00000	0.00000	1.0000000000	1.0000000000	0.07671	-0.10663	0	13	0	4	8	0	0.00000	0.00000
107	40275004	Contact dermatitis	78	239872002	Osteoarthritis of hip	1095	18	21	0	18	21	1056	0.00000	-0.01808	0.00000	0.00000	0.00000	1.0000000000	1.0000000000	0.34521	-0.42783	9	13	0	9	8	0	0.00000	0.00000
106	24079001	Atopic dermatitis	78	239872002	Osteoarthritis of hip	1095	20	21	1	19	20	1055	2.60714	0.03065	2.77632	21.76051	0.35422	0.3234313401	1.0000000000	0.38356	0.53161	13	13	0	7	8	1	-2.19722	-2.07944
102	90781000119102	Microalbuminuria due to type 2 diabetes mellitus (disorder)	78	239872002	Osteoarthritis of hip	1095	6	21	1	5	20	1069	8.69048	0.07982	10.69000	95.72098	1.19385	0.1099298174	0.6537696051	0.11507	0.84287	3	13	0	3	8	1	-2.19722	-1.38629
98	1551000119108	Nonproliferative diabetic retinopathy due to type 2 diabetes mellitus (disorder)	78	239872002	Osteoarthritis of hip	1095	12	21	0	12	21	1062	0.00000	-0.01472	0.00000	0.00000	0.00000	1.0000000000	1.0000000000	0.23014	-0.29882	7	13	0	5	8	0	0.00000	0.00000
97	403192003	Third degree burn	78	239872002	Osteoarthritis of hip	1095	8	21	0	8	21	1066	0.00000	-0.01200	0.00000	0.00000	0.00000	1.0000000000	1.0000000000	0.15342	-0.20592	3	13	0	5	8	0	0.00000	0.00000
96	283371005	Laceration of forearm	78	239872002	Osteoarthritis of hip	1095	75	21	1	74	20	1000	0.69524	-0.01156	0.67568	5.10468	0.08944	1.0000000000	1.0000000000	1.43836	-0.28591	39	13	0	36	8	1	-2.19722	-3.61092
94	703151001	History of single seizure (situation)	78	239872002	Osteoarthritis of hip	1095	39	21	2	37	19	1037	2.67399	0.04498	2.95021	13.13585	0.66260	0.1699309090	0.7972493423	0.74795	0.77930	14	13	0	25	8	2	-1.60944	-2.60269
93	128613002	Seizure disorder	78	239872002	Osteoarthritis of hip	1095	39	21	2	37	19	1037	2.67399	0.04498	2.95021	13.13585	0.66260	0.1699309090	0.7972493423	0.74795	0.77930	14	13	0	25	8	2	-1.60944	-2.60269
89	47693006	Rupture of appendix	78	239872002	Osteoarthritis of hip	1095	20	21	2	18	19	1056	5.21429	0.08038	6.17544	28.51059	1.33761	0.0540864708	0.4504469073	0.38356	1.11658	10	13	1	10	8	1	0.44183	0.00000
86	713197008	Recurrent rectal polyp	78	239872002	Osteoarthritis of hip	1095	22	21	0	22	21	1052	0.00000	-0.02002	0.00000	0.00000	0.00000	1.0000000000	1.0000000000	0.42192	-0.50784	12	13	0	10	8	0	0.00000	0.00000
82	94260004	Secondary malignant neoplasm of colon	78	239872002	Osteoarthritis of hip	1095	4	21	0	4	21	1070	0.00000	-0.00847	0.00000	0.00000	0.00000	1.0000000000	1.0000000000	0.07671	-0.10663	2	13	0	2	8	0	0.00000	0.00000
76	127013003	Diabetic renal disease (disorder)	78	239872002	Osteoarthritis of hip	1095	28	21	4	24	17	1050	7.44898	0.14608	10.29412	32.90062	3.22088	0.0015210646	0.0343236623	0.53699	1.70182	10	13	1	18	8	3	1.33977	0.45199
75	431855005	Chronic kidney disease stage 1 (disorder)	78	239872002	Osteoarthritis of hip	1095	28	21	4	24	17	1050	7.44898	0.14608	10.29412	32.90062	3.22088	0.0015210646	0.0343236623	0.53699	1.70182	10	13	1	18	8	3	1.33977	0.45199
72	35999006	Blighted ovum	78	239872002	Osteoarthritis of hip	1095	53	21	2	51	19	1023	1.96765	0.03052	2.11146	9.31186	0.47877	0.2702381418	0.9405830326	1.01644	0.57315	53	13	2	0	8	0	2.01490	3.31419
71	201834006	Localized  primary osteoarthritis of the hand	78	239872002	Osteoarthritis of hip	1095	28	21	0	28	21	1046	0.00000	-0.02265	0.00000	0.00000	0.00000	1.0000000000	1.0000000000	0.53699	-0.62010	19	13	0	9	8	0	0.00000	0.00000
69	233604007	Pneumonia	78	239872002	Osteoarthritis of hip	1095	7	21	0	7	21	1067	0.00000	-0.01122	0.00000	0.00000	0.00000	1.0000000000	1.0000000000	0.13425	-0.18173	3	13	0	4	8	0	0.00000	0.00000
67	403191005	Second degree burn	78	239872002	Osteoarthritis of hip	1095	49	21	2	47	19	1027	2.12828	0.03415	2.30011	10.16574	0.52043	0.2411060804	0.9095097439	0.93973	0.62911	23	13	1	26	8	1	0.44183	-0.11778
64	444448004	Injury of medial collateral ligament of knee	78	239872002	Osteoarthritis of hip	1095	32	21	0	32	21	1042	0.00000	-0.02426	0.00000	0.00000	0.00000	1.0000000000	1.0000000000	0.61370	-0.69037	17	13	0	15	8	0	0.00000	0.00000
63	68496003	Polyp of colon	78	239872002	Osteoarthritis of hip	1095	91	21	2	89	19	985	1.14600	0.00615	1.16499	5.08248	0.26704	0.6914482875	1.0000000000	1.74521	0.12805	43	13	0	48	8	2	-1.60944	-3.21888
59	262574004	Bullet wound	78	239872002	Osteoarthritis of hip	1095	20	21	0	20	21	1054	0.00000	-0.01907	0.00000	0.00000	0.00000	1.0000000000	1.0000000000	0.38356	-0.46839	9	13	0	11	8	0	0.00000	0.00000
58	239720000	Tear of meniscus of knee	78	239872002	Osteoarthritis of hip	1095	20	21	0	20	21	1054	0.00000	-0.01907	0.00000	0.00000	0.00000	1.0000000000	1.0000000000	0.38356	-0.46839	10	13	0	10	8	0	0.00000	0.00000
57	192127007	Child attention deficit disorder	78	239872002	Osteoarthritis of hip	1095	76	21	1	75	20	999	0.68609	-0.01199	0.66600	5.03073	0.08817	1.0000000000	1.0000000000	1.45753	-0.29721	24	13	0	52	8	1	-2.19722	-3.97029
54	5602001	Opioid abuse (disorder)	78	239872002	Osteoarthritis of hip	1095	7	21	0	7	21	1067	0.00000	-0.01122	0.00000	0.00000	0.00000	1.0000000000	1.0000000000	0.13425	-0.18173	0	13	0	7	8	0	0.00000	0.00000
52	124171000119105	Chronic intractable migraine without aura	78	239872002	Osteoarthritis of hip	1095	51	21	0	51	21	1023	0.00000	-0.03091	0.00000	0.00000	0.00000	0.6194760739	1.0000000000	0.97808	-0.98410	21	13	0	30	8	0	0.00000	0.00000
50	446096008	Perennial allergic rhinitis	78	239872002	Osteoarthritis of hip	1095	26	21	1	25	20	1049	2.00549	0.02193	2.09800	16.25083	0.27085	0.3991257401	1.0000000000	0.49863	0.41636	14	13	0	12	8	1	-2.19722	-2.56495
49	88805009	Chronic congestive heart failure (disorder)	78	239872002	Osteoarthritis of hip	1095	10	21	1	9	20	1065	5.21429	0.05657	5.91667	48.93956	0.71531	0.1767142612	0.8029498763	0.19178	0.74688	5	13	1	5	8	0	2.63906	1.79176
47	359817006	Closed fracture of hip	78	239872002	Osteoarthritis of hip	1095	29	21	0	29	21	1045	0.00000	-0.02306	0.00000	0.00000	0.00000	1.0000000000	1.0000000000	0.55616	-0.63799	11	13	0	18	8	0	0.00000	0.00000
44	58150001	Fracture of clavicle	78	239872002	Osteoarthritis of hip	1095	112	21	3	109	18	965	1.39668	0.01872	1.47554	5.08969	0.42777	0.4668452164	1.0000000000	2.14795	0.34559	55	13	3	57	8	0	1.67398	2.96183
43	307731004	Injury of tendon of the rotator cuff of shoulder	78	239872002	Osteoarthritis of hip	1095	51	21	1	50	20	1024	1.02241	0.00069	1.02400	7.78381	0.13471	1.0000000000	1.0000000000	0.97808	0.01590	26	13	1	25	8	0	2.63906	3.29584
42	16114001	Fracture of ankle	78	239872002	Osteoarthritis of hip	1095	108	21	2	106	19	968	0.96561	-0.00159	0.96127	4.18396	0.22085	1.0000000000	1.0000000000	2.07123	-0.03386	48	13	1	60	8	1	0.44183	-0.21905
41	283385000	Laceration of thigh	78	239872002	Osteoarthritis of hip	1095	105	21	3	102	18	972	1.48980	0.02230	1.58824	5.48372	0.46000	0.4447088908	1.0000000000	2.01370	0.40846	50	13	1	55	8	2	1.02962	0.58192
39	74400008	Appendicitis	78	239872002	Osteoarthritis of hip	1095	51	21	2	49	19	1025	2.04482	0.03229	2.20193	9.72093	0.49877	0.2556511436	0.9170844866	0.97808	0.60086	27	13	1	24	8	1	0.44183	0.11333
38	398254007	Preeclampsia	78	239872002	Osteoarthritis of hip	1095	101	21	2	99	19	975	1.03253	0.00145	1.03668	4.51608	0.23797	1.0000000000	1.0000000000	1.93699	0.03063	101	13	2	0	8	0	2.01490	3.94158
35	19169002	Miscarriage in first trimester	78	239872002	Osteoarthritis of hip	1095	174	21	7	167	14	907	2.09770	0.06672	2.71557	6.82900	1.07985	0.0620979256	0.4836892708	3.33699	0.88331	174	13	7	0	8	0	1.04982	3.25259
33	429007001	History of cardiac arrest (situation)	78	239872002	Osteoarthritis of hip	1095	42	21	2	40	19	1034	2.48299	0.04141	2.72105	12.08398	0.61272	0.1908989550	0.8254734124	0.80548	0.73258	24	13	1	18	8	1	0.44183	0.27444
32	410429000	Cardiac Arrest	78	239872002	Osteoarthritis of hip	1095	42	21	2	40	19	1034	2.48299	0.04141	2.72105	12.08398	0.61272	0.1908989550	0.8254734124	0.80548	0.73258	24	13	1	18	8	1	0.44183	0.27444
30	399211009	History of myocardial infarction (situation)	78	239872002	Osteoarthritis of hip	1095	31	21	2	29	19	1045	3.36406	0.05643	3.79310	17.05086	0.84381	0.1167390052	0.6772868389	0.59452	0.91184	2	13	0	29	8	2	-1.60944	-2.74084
27	408512008	Body mass index 40+ - severely obese (finding)	78	239872002	Osteoarthritis of hip	1095	97	21	6	91	15	983	3.22533	0.09701	4.32088	11.40743	1.63665	0.0075044547	0.1248277125	1.86027	1.29120	67	13	5	30	8	1	-0.91629	-0.76676
24	162864005	Body mass index 30+ - obesity (finding)	78	239872002	Osteoarthritis of hip	1095	439	21	15	424	6	650	1.78165	0.08941	3.83255	9.95581	1.47536	0.0055155429	0.0974153638	8.41918	0.76440	226	13	10	213	8	5	-0.12260	-0.61381
23	36971009	Sinusitis (disorder)	78	239872002	Osteoarthritis of hip	1095	190	21	2	188	19	886	0.54887	-0.02890	0.49608	2.14788	0.11458	0.5588112663	1.0000000000	3.64384	-0.63035	84	13	2	106	8	0	2.01490	3.76120
21	15777000	Prediabetes	78	239872002	Osteoarthritis of hip	1095	333	21	14	319	7	755	2.19219	0.11020	4.73354	11.83846	1.89268	0.0010392614	0.0256253825	6.38630	1.02204	159	13	8	174	8	6	0.11778	-0.36265
20	80394007	Hyperglycemia (disorder)	78	239872002	Osteoarthritis of hip	1095	55	21	3	52	18	1022	2.84416	0.05930	3.27564	11.47446	0.93511	0.0839850081	0.5719320410	1.05479	0.96101	23	13	1	32	8	2	1.02962	0.34484
18	302870006	Hypertriglyceridemia (disorder)	78	239872002	Osteoarthritis of hip	1095	64	21	4	60	17	1014	3.25893	0.07870	3.97647	12.18594	1.29759	0.0299470893	0.3180139089	1.22740	1.16657	28	13	1	36	8	3	1.33977	0.80235
17	368581000119106	Neuropathy due to type 2 diabetes mellitus (disorder)	78	239872002	Osteoarthritis of hip	1095	28	21	2	26	19	1048	3.72449	0.06171	4.24291	19.16986	0.93910	0.0981928342	0.6237397336	0.53699	0.96486	7	13	0	21	8	2	-1.60944	-2.44235
129	47505003	Posttraumatic stress disorder	52	124171000119105	Chronic intractable migraine without aura	1095	4	51	1	3	50	1041	5.36765	0.05845	6.94000	67.91084	0.70922	0.1739068632	0.7996618359	0.18630	0.75353	1	21	0	3	30	1	-3.43399	-1.38629
15	40055000	Chronic sinusitis (disorder)	78	239872002	Osteoarthritis of hip	1095	216	21	8	208	13	866	1.93122	0.06455	2.56213	6.26185	1.04833	0.0479210193	0.4214740129	4.14247	0.80746	104	13	6	112	8	2	-0.45676	-1.13433
14	10509002	Acute bronchitis (disorder)	78	239872002	Osteoarthritis of hip	1095	863	21	21	842	0	232	1.26883	0.07250	0.00000	0.00000	0.00000	0.0122096279	0.1758584161	16.55068	0.32598	418	13	13	445	8	8	0.00000	-0.53529
13	370247008	Facial laceration	78	239872002	Osteoarthritis of hip	1095	109	21	4	105	17	969	1.91350	0.04247	2.17143	6.57342	0.71730	0.1482872729	0.7554647022	2.09041	0.69413	55	13	2	54	8	2	0.40547	0.01770
125	1734006	Fracture of the vertebral column with spinal cord injury	52	124171000119105	Chronic intractable migraine without aura	1095	5	51	0	5	51	1039	0.00000	-0.01497	0.00000	0.00000	0.00000	1.0000000000	1.0000000000	0.23288	-0.30203	3	21	0	2	30	0	0.00000	0.00000
10	62106007	Concussion with no loss of consciousness	78	239872002	Osteoarthritis of hip	1095	206	21	3	203	18	871	0.75936	-0.01620	0.71511	2.45086	0.20865	0.7810195879	1.0000000000	3.95068	-0.30763	96	13	2	110	8	1	-0.18232	-0.81771
7	75498004	Acute bacterial sinusitis (disorder)	78	239872002	Osteoarthritis of hip	1095	187	21	5	182	16	892	1.39419	0.02501	1.53159	4.23366	0.55408	0.3834614701	1.0000000000	3.58630	0.38763	89	13	3	98	8	2	0.06454	-0.48885
6	39848009	Whiplash injury to neck	78	239872002	Osteoarthritis of hip	1095	182	21	4	178	17	896	1.14600	0.00911	1.18440	3.56171	0.39386	0.7665373969	1.0000000000	3.49041	0.15508	92	13	3	90	8	1	-0.52325	-1.05559
5	284549007	Laceration of hand	78	239872002	Osteoarthritis of hip	1095	104	21	6	98	15	976	3.00824	0.09097	3.98367	10.50100	1.51125	0.0105602655	0.1598241560	1.99452	1.22503	54	13	5	50	8	1	-0.91629	-1.46373
117	230265002	Familial Alzheimer's disease of early onset (disorder)	52	124171000119105	Chronic intractable migraine without aura	1095	6	51	1	5	50	1039	3.57843	0.04230	4.15600	36.24351	0.47656	0.2493687300	0.9133257124	0.27945	0.64447	2	21	0	4	30	1	-3.43399	-1.60944
115	36923009	Major depression  single episode	52	124171000119105	Chronic intractable migraine without aura	1095	6	51	0	6	51	1038	0.00000	-0.01641	0.00000	0.00000	0.00000	1.0000000000	1.0000000000	0.27945	-0.35553	3	21	0	3	30	0	0.00000	0.00000
1	444814009	Viral sinusitis (disorder)	78	239872002	Osteoarthritis of hip	1095	993	21	21	972	0	102	1.10272	0.04482	0.00000	0.00000	0.00000	0.2495336735	0.9133257124	19.04384	0.13434	478	13	13	515	8	8	0.00000	-0.54865
109	90560007	Gout	52	124171000119105	Chronic intractable migraine without aura	1095	4	51	0	4	51	1040	0.00000	-0.01338	0.00000	0.00000	0.00000	1.0000000000	1.0000000000	0.18630	-0.24647	0	21	0	4	30	0	0.00000	0.00000
106	24079001	Atopic dermatitis	52	124171000119105	Chronic intractable migraine without aura	1095	20	51	0	20	51	1024	0.00000	-0.03015	0.00000	0.00000	0.00000	1.0000000000	1.0000000000	0.93151	-0.94973	13	21	0	7	30	0	0.00000	0.00000
102	90781000119102	Microalbuminuria due to type 2 diabetes mellitus (disorder)	52	124171000119105	Chronic intractable migraine without aura	1095	6	51	0	6	51	1038	0.00000	-0.01641	0.00000	0.00000	0.00000	1.0000000000	1.0000000000	0.27945	-0.35553	3	21	0	3	30	0	0.00000	0.00000
98	1551000119108	Nonproliferative diabetic retinopathy due to type 2 diabetes mellitus (disorder)	52	124171000119105	Chronic intractable migraine without aura	1095	12	51	2	10	49	1034	3.57843	0.05999	4.22041	19.78495	0.90027	0.1041936355	0.6342661110	0.55890	0.94443	7	21	0	5	30	2	-2.77259	-1.25276
97	403192003	Third degree burn	52	124171000119105	Chronic intractable migraine without aura	1095	8	51	0	8	51	1036	0.00000	-0.01896	0.00000	0.00000	0.00000	1.0000000000	1.0000000000	0.37260	-0.45691	3	21	0	5	30	0	0.00000	0.00000
96	283371005	Laceration of forearm	52	124171000119105	Chronic intractable migraine without aura	1095	75	51	7	68	44	976	2.00392	0.06017	2.28342	5.26063	0.99114	0.0780950405	0.5528373106	3.49315	0.83227	39	21	3	36	30	4	-0.06062	0.33647
94	703151001	History of single seizure (situation)	52	124171000119105	Chronic intractable migraine without aura	1095	39	51	0	39	51	1005	0.00000	-0.04248	0.00000	0.00000	0.00000	0.2535604635	0.9133257124	1.81644	-1.49387	14	21	0	25	30	0	0.00000	0.00000
93	128613002	Seizure disorder	52	124171000119105	Chronic intractable migraine without aura	1095	39	51	0	39	51	1005	0.00000	-0.04248	0.00000	0.00000	0.00000	0.2535604635	0.9133257124	1.81644	-1.49387	14	21	0	25	30	0	0.00000	0.00000
89	47693006	Rupture of appendix	52	124171000119105	Chronic intractable migraine without aura	1095	20	51	3	17	48	1027	3.22059	0.06694	3.77574	13.32495	1.06989	0.0620090373	0.4836892708	0.93151	1.05027	10	21	1	10	30	2	0.31845	0.60614
86	713197008	Recurrent rectal polyp	52	124171000119105	Chronic intractable migraine without aura	1095	22	51	2	20	49	1024	1.95187	0.03012	2.08980	9.19449	0.47499	0.2733664102	0.9488376230	1.02466	0.56728	12	21	0	10	30	2	-2.77259	-1.79176
82	94260004	Secondary malignant neoplasm of colon	52	124171000119105	Chronic intractable migraine without aura	1095	4	51	1	3	50	1041	5.36765	0.05845	6.94000	67.91084	0.70922	0.1739068632	0.7996618359	0.18630	0.75353	2	21	0	2	30	1	-3.43399	-1.09861
76	127013003	Diabetic renal disease (disorder)	52	124171000119105	Chronic intractable migraine without aura	1095	28	51	2	26	49	1018	1.53361	0.01911	1.59812	6.92637	0.36873	0.3783803585	1.0000000000	1.30411	0.38075	10	21	0	18	30	2	-2.77259	-2.30259
75	431855005	Chronic kidney disease stage 1 (disorder)	52	124171000119105	Chronic intractable migraine without aura	1095	28	51	2	26	49	1018	1.53361	0.01911	1.59812	6.92637	0.36873	0.3783803585	1.0000000000	1.30411	0.38075	10	21	0	18	30	2	-2.77259	-2.30259
72	35999006	Blighted ovum	52	124171000119105	Chronic intractable migraine without aura	1095	53	51	4	49	47	995	1.62042	0.03093	1.72818	4.98996	0.59852	0.3046771262	0.9953175875	2.46849	0.52762	53	21	4	0	30	0	1.83258	2.65676
71	201834006	Localized  primary osteoarthritis of the hand	52	124171000119105	Chronic intractable migraine without aura	1095	28	51	1	27	50	1017	0.76681	-0.00835	0.75333	5.65634	0.10033	1.0000000000	1.0000000000	1.30411	-0.20421	19	21	1	9	30	0	3.09104	2.99573
69	233604007	Pneumonia	52	124171000119105	Chronic intractable migraine without aura	1095	7	51	1	6	50	1038	3.06723	0.03665	3.46000	29.28892	0.40874	0.2845222606	0.9659403678	0.32603	0.59289	3	21	0	4	30	1	-3.43399	-1.60944
67	403191005	Second degree burn	52	124171000119105	Chronic intractable migraine without aura	1095	49	51	4	45	47	999	1.75270	0.03601	1.88936	5.47324	0.65221	0.2813674417	0.9621516959	2.28219	0.60727	23	21	1	26	30	3	0.69315	0.90937
64	444448004	Injury of medial collateral ligament of knee	52	124171000119105	Chronic intractable migraine without aura	1095	32	51	1	31	50	1013	0.67096	-0.01262	0.65355	4.88481	0.08744	1.0000000000	1.0000000000	1.49041	-0.31638	17	21	1	15	30	0	3.09104	2.89037
63	68496003	Polyp of colon	52	124171000119105	Chronic intractable migraine without aura	1095	91	51	7	84	44	960	1.65158	0.04336	1.81818	4.16193	0.79429	0.1857778174	0.8181443419	4.23836	0.61089	43	21	3	48	30	4	-0.06062	0.16508
59	262574004	Bullet wound	52	124171000119105	Chronic intractable migraine without aura	1095	20	51	2	18	49	1026	2.14706	0.03458	2.32653	10.30984	0.52501	0.2379729124	0.9062586661	0.93151	0.63524	9	21	1	11	30	1	-0.34294	-0.18232
58	239720000	Tear of meniscus of knee	52	124171000119105	Chronic intractable migraine without aura	1095	20	51	2	18	49	1026	2.14706	0.03458	2.32653	10.30984	0.52501	0.2379729124	0.9062586661	0.93151	0.63524	10	21	0	10	30	2	-2.77259	-1.79176
57	192127007	Child attention deficit disorder	52	124171000119105	Chronic intractable migraine without aura	1095	76	51	2	74	49	970	0.56502	-0.02626	0.53502	2.24361	0.12759	0.5732115769	1.0000000000	3.53973	-0.59764	24	21	1	52	30	1	-0.34294	-0.75142
54	5602001	Opioid abuse (disorder)	52	124171000119105	Chronic intractable migraine without aura	1095	7	51	2	5	49	1039	6.13445	0.09103	8.48163	44.81629	1.60518	0.0384475467	0.3720976461	0.32603	1.17785	0	21	0	7	30	2	-2.77259	-1.50408
50	446096008	Perennial allergic rhinitis	52	124171000119105	Chronic intractable migraine without aura	1095	26	51	2	24	49	1020	1.65158	0.02246	1.73469	7.54988	0.39857	0.3438310011	1.0000000000	1.21096	0.44029	14	21	0	12	30	2	-2.77259	-1.94591
49	88805009	Chronic congestive heart failure (disorder)	52	124171000119105	Chronic intractable migraine without aura	1095	10	51	1	9	50	1035	2.14706	0.02434	2.30000	18.50972	0.28580	0.3805778618	1.0000000000	0.46575	0.44836	5	21	0	5	30	1	-3.43399	-1.79176
47	359817006	Closed fracture of hip	52	124171000119105	Chronic intractable migraine without aura	1095	29	51	1	28	50	1016	0.74037	-0.00946	0.72571	5.44210	0.09678	1.0000000000	1.0000000000	1.35068	-0.23308	11	21	0	18	30	1	-3.43399	-2.94444
44	58150001	Fracture of clavicle	52	124171000119105	Chronic intractable migraine without aura	1095	112	51	4	108	47	936	0.76681	-0.01740	0.73759	2.08697	0.26068	0.8119939191	1.0000000000	5.21644	-0.31416	55	21	3	57	30	1	-1.35455	-1.09861
43	307731004	Injury of tendon of the rotator cuff of shoulder	52	124171000119105	Chronic intractable migraine without aura	1095	51	51	0	51	51	993	0.00000	-0.04885	0.00000	0.00000	0.00000	0.1659451767	0.7915572889	2.37534	-1.75503	26	21	0	25	30	0	0.00000	0.00000
42	16114001	Fracture of ankle	52	124171000119105	Chronic intractable migraine without aura	1095	108	51	5	103	46	941	0.99401	-0.00044	0.99304	2.55511	0.38594	1.0000000000	1.0000000000	5.03014	-0.00723	48	21	3	60	30	2	-0.69315	-0.60077
41	283385000	Laceration of thigh	52	124171000119105	Chronic intractable migraine without aura	1095	105	51	4	101	47	943	0.81793	-0.01311	0.79461	2.25094	0.28051	0.8109996124	1.0000000000	4.89041	-0.23644	50	21	1	55	30	3	0.69315	0.96999
39	74400008	Appendicitis	52	124171000119105	Chronic intractable migraine without aura	1095	51	51	4	47	47	997	1.68397	0.03341	1.80534	5.22093	0.62427	0.2923243186	0.9783965127	2.37534	0.56689	27	21	2	24	30	2	-0.33024	0.10920
38	398254007	Preeclampsia	52	124171000119105	Chronic intractable migraine without aura	1095	101	51	2	99	49	945	0.42516	-0.04050	0.38961	1.62641	0.09333	0.2219004422	0.8794911525	4.70411	-0.92704	101	21	2	0	30	0	2.44235	3.94158
35	19169002	Miscarriage in first trimester	52	124171000119105	Chronic intractable migraine without aura	1095	174	51	12	162	39	882	1.48073	0.04618	1.67521	3.26836	0.85864	0.1662683400	0.7915572889	8.10411	0.51392	174	21	12	0	30	0	1.01160	2.74084
33	429007001	History of cardiac arrest (situation)	52	124171000119105	Chronic intractable migraine without aura	1095	42	51	1	41	50	1003	0.51120	-0.02158	0.48927	3.62954	0.06595	0.7172451522	1.0000000000	1.95616	-0.56373	24	21	0	18	30	1	-3.43399	-2.94444
32	410429000	Cardiac Arrest	52	124171000119105	Chronic intractable migraine without aura	1095	42	51	1	41	50	1003	0.51120	-0.02158	0.48927	3.62954	0.06595	0.7172451522	1.0000000000	1.95616	-0.56373	24	21	0	18	30	1	-3.43399	-2.94444
30	399211009	History of myocardial infarction (situation)	52	124171000119105	Chronic intractable migraine without aura	1095	31	51	0	31	51	1013	0.00000	-0.03773	0.00000	0.00000	0.00000	0.3948460482	1.0000000000	1.44384	-1.28915	2	21	0	29	30	0	0.00000	0.00000
27	408512008	Body mass index 40+ - severely obese (finding)	52	124171000119105	Chronic intractable migraine without aura	1095	97	51	7	90	44	954	1.54942	0.03786	1.68636	3.85315	0.73805	0.2060188328	0.8546471239	4.51781	0.53590	67	21	4	30	30	3	-0.56531	0.47849
24	162864005	Body mass index 30+ - obesity (finding)	52	124171000119105	Chronic intractable migraine without aura	1095	439	51	20	419	31	625	0.97816	-0.00395	0.96235	1.71124	0.54120	1.0000000000	1.0000000000	20.44658	-0.03036	226	21	7	213	30	13	0.19004	0.64954
23	36971009	Sinusitis (disorder)	52	124171000119105	Chronic intractable migraine without aura	1095	190	51	12	178	39	866	1.35604	0.03606	1.49697	2.91613	0.76846	0.2543006686	0.9141078089	8.84932	0.40042	84	21	2	106	30	10	1.05605	1.31020
21	15777000	Prediabetes	52	124171000119105	Chronic intractable migraine without aura	1095	333	51	21	312	30	732	1.35400	0.05172	1.64231	2.91329	0.92582	0.1177270331	0.6803211956	15.50959	0.41420	159	21	9	174	30	12	-0.04879	0.18590
20	80394007	Hyperglycemia (disorder)	52	124171000119105	Chronic intractable migraine without aura	1095	55	51	5	50	46	994	1.95187	0.04838	2.16087	5.67556	0.82271	0.1748516341	0.8000743861	2.56164	0.75242	23	21	1	32	30	4	0.95098	0.98083
18	302870006	Hypertriglyceridemia (disorder)	52	124171000119105	Chronic intractable migraine without aura	1095	64	51	5	59	46	985	1.67739	0.03730	1.81466	4.73741	0.69511	0.2148934447	0.8672161313	2.98082	0.59190	28	21	1	36	30	4	0.95098	1.06471
17	368581000119106	Neuropathy due to type 2 diabetes mellitus (disorder)	52	124171000119105	Chronic intractable migraine without aura	1095	28	51	1	27	50	1017	0.76681	-0.00835	0.75333	5.65634	0.10033	1.0000000000	1.0000000000	1.30411	-0.20421	7	21	0	21	30	1	-3.43399	-3.09104
129	47505003	Posttraumatic stress disorder	26	33737001	Fracture of rib	1095	4	54	0	4	54	1037	0.00000	-0.01379	0.00000	0.00000	0.00000	1.0000000000	1.0000000000	0.19726	-0.25974	1	32	0	3	22	0	0.00000	0.00000
15	40055000	Chronic sinusitis (disorder)	52	124171000119105	Chronic intractable migraine without aura	1095	216	51	11	205	40	839	1.09341	0.01023	1.12549	2.23166	0.56762	0.7195692575	1.0000000000	10.06027	0.11765	104	21	3	112	30	8	0.52130	0.86617
14	10509002	Acute bronchitis (disorder)	52	124171000119105	Chronic intractable migraine without aura	1095	863	51	44	819	7	225	1.09468	0.04036	1.72684	3.88598	0.76737	0.2204108973	0.8778434015	40.19452	0.12747	418	21	17	445	30	27	0.05716	0.38099
13	370247008	Facial laceration	52	124171000119105	Chronic intractable migraine without aura	1095	109	51	7	102	44	942	1.37885	0.02784	1.46925	3.34697	0.64497	0.3380279480	1.0000000000	5.07671	0.39671	55	21	3	54	30	4	-0.06062	0.28768
125	1734006	Fracture of the vertebral column with spinal cord injury	26	33737001	Fracture of rib	1095	5	54	1	4	53	1037	4.05556	0.04713	4.89151	44.52830	0.53734	0.2237944670	0.8794911525	0.24658	0.68203	3	32	1	2	22	0	3.49651	1.38629
124	1501000119109	Proliferative diabetic retinopathy due to type II diabetes mellitus (disorder)	26	33737001	Fracture of rib	1095	1	54	0	1	54	1040	0.00000	-0.00689	0.00000	0.00000	0.00000	1.0000000000	1.0000000000	0.04932	-0.06945	1	32	0	0	22	0	0.00000	0.00000
10	62106007	Concussion with no loss of consciousness	52	124171000119105	Chronic intractable migraine without aura	1095	206	51	11	195	40	849	1.14649	0.01559	1.19731	2.37564	0.60344	0.5839286057	1.0000000000	9.59452	0.17972	96	21	3	110	30	8	0.52130	0.80526
121	254637007	Non-small cell lung cancer (disorder)	26	33737001	Fracture of rib	1095	8	54	0	8	54	1033	0.00000	-0.01954	0.00000	0.00000	0.00000	1.0000000000	1.0000000000	0.39452	-0.47977	0	32	0	8	22	0	0.00000	0.00000
7	75498004	Acute bacterial sinusitis (disorder)	52	124171000119105	Chronic intractable migraine without aura	1095	187	51	5	182	46	862	0.57408	-0.04272	0.51481	1.31354	0.20177	0.1847918021	0.8181443419	8.70959	-0.69445	89	21	2	98	30	3	0.04445	0.30120
6	39848009	Whiplash injury to neck	52	124171000119105	Chronic intractable migraine without aura	1095	182	51	5	177	46	867	0.58985	-0.04047	0.53242	1.35889	0.20861	0.2462623789	0.9133257124	8.47671	-0.65942	92	21	2	90	30	3	0.04445	0.41616
5	284549007	Laceration of hand	52	124171000119105	Chronic intractable migraine without aura	1095	104	51	7	97	44	947	1.44514	0.03187	1.55319	3.54230	0.68102	0.3222177347	1.0000000000	4.84384	0.45308	54	21	4	50	30	3	-0.56531	-0.19753
117	230265002	Familial Alzheimer's disease of early onset (disorder)	26	33737001	Fracture of rib	1095	6	54	0	6	54	1035	0.00000	-0.01691	0.00000	0.00000	0.00000	1.0000000000	1.0000000000	0.29589	-0.37394	2	32	0	4	22	0	0.00000	0.00000
115	36923009	Major depression  single episode	26	33737001	Fracture of rib	1095	6	54	0	6	54	1035	0.00000	-0.01691	0.00000	0.00000	0.00000	1.0000000000	1.0000000000	0.29589	-0.37394	3	32	0	3	22	0	0.00000	0.00000
1	444814009	Viral sinusitis (disorder)	52	124171000119105	Chronic intractable migraine without aura	1095	993	51	50	943	1	101	1.08110	0.05593	5.35525	39.17951	0.73198	0.0797331444	0.5585774477	46.24932	0.11020	478	21	20	515	30	30	0.02469	0.31528
112	49436004	Atrial Fibrillation	26	33737001	Fracture of rib	1095	35	54	0	35	54	1006	0.00000	-0.04139	0.00000	0.00000	0.00000	0.4117697451	1.0000000000	1.72603	-1.44680	9	32	0	26	22	0	0.00000	0.00000
111	235919008	Cholelithiasis	26	33737001	Fracture of rib	1095	9	54	0	9	54	1032	0.00000	-0.02073	0.00000	0.00000	0.00000	1.0000000000	1.0000000000	0.44384	-0.52991	7	32	0	2	22	0	0.00000	0.00000
109	90560007	Gout	26	33737001	Fracture of rib	1095	4	54	0	4	54	1037	0.00000	-0.01379	0.00000	0.00000	0.00000	1.0000000000	1.0000000000	0.19726	-0.25974	0	32	0	4	22	0	0.00000	0.00000
108	40930008	Hypothyroidism (disorder)	26	33737001	Fracture of rib	1095	13	54	1	12	53	1029	1.55983	0.01398	1.61792	12.67634	0.20650	0.4837518096	1.0000000000	0.64110	0.28534	11	32	1	2	22	0	3.49651	2.48491
107	40275004	Contact dermatitis	26	33737001	Fracture of rib	1095	18	54	1	17	53	1024	1.12654	0.00373	1.13651	8.70212	0.14843	0.6005371763	1.0000000000	0.88767	0.08339	9	32	1	9	22	0	3.49651	2.30259
106	24079001	Atopic dermatitis	26	33737001	Fracture of rib	1095	20	54	1	19	53	1022	1.01389	0.00043	1.01490	7.72558	0.13333	1.0000000000	1.0000000000	0.98630	0.00992	13	32	1	7	22	0	3.49651	2.63906
105	363406005	Malignant tumor of colon	26	33737001	Fracture of rib	1095	6	54	0	6	54	1035	0.00000	-0.01691	0.00000	0.00000	0.00000	1.0000000000	1.0000000000	0.29589	-0.37394	4	32	0	2	22	0	0.00000	0.00000
104	367498001	Seasonal allergic rhinitis	26	33737001	Fracture of rib	1095	20	54	1	19	53	1022	1.01389	0.00043	1.01490	7.72558	0.13333	1.0000000000	1.0000000000	0.98630	0.00992	9	32	0	11	22	1	-3.13549	-2.48491
102	90781000119102	Microalbuminuria due to type 2 diabetes mellitus (disorder)	26	33737001	Fracture of rib	1095	6	54	0	6	54	1035	0.00000	-0.01691	0.00000	0.00000	0.00000	1.0000000000	1.0000000000	0.29589	-0.37394	3	32	0	3	22	0	0.00000	0.00000
101	433144002	Chronic kidney disease stage 3 (disorder)	26	33737001	Fracture of rib	1095	3	54	0	3	54	1038	0.00000	-0.01194	0.00000	0.00000	0.00000	1.0000000000	1.0000000000	0.14795	-0.19905	1	32	0	2	22	0	0.00000	0.00000
100	161622006	History of lower limb amputation (situation)	26	33737001	Fracture of rib	1095	1	54	0	1	54	1040	0.00000	-0.00689	0.00000	0.00000	0.00000	1.0000000000	1.0000000000	0.04932	-0.06945	0	32	0	1	22	0	0.00000	0.00000
98	1551000119108	Nonproliferative diabetic retinopathy due to type 2 diabetes mellitus (disorder)	26	33737001	Fracture of rib	1095	12	54	0	12	54	1029	0.00000	-0.02397	0.00000	0.00000	0.00000	1.0000000000	1.0000000000	0.59178	-0.67064	7	32	0	5	22	0	0.00000	0.00000
97	403192003	Third degree burn	26	33737001	Fracture of rib	1095	8	54	0	8	54	1033	0.00000	-0.01954	0.00000	0.00000	0.00000	1.0000000000	1.0000000000	0.39452	-0.47977	3	32	0	5	22	0	0.00000	0.00000
96	283371005	Laceration of forearm	26	33737001	Fracture of rib	1095	75	54	4	71	50	970	1.08148	0.00503	1.09296	3.11253	0.38379	0.7825489452	1.0000000000	3.69863	0.08969	39	32	3	36	22	1	-0.67876	-0.97186
95	84757009	Epilepsy	26	33737001	Fracture of rib	1095	30	54	1	29	53	1012	0.67593	-0.01239	0.65843	4.92640	0.08800	1.0000000000	1.0000000000	1.47945	-0.31002	13	32	0	17	22	1	-3.13549	-2.89037
94	703151001	History of single seizure (situation)	26	33737001	Fracture of rib	1095	39	54	1	38	53	1003	0.51994	-0.02101	0.49801	3.69723	0.06708	0.7173434670	1.0000000000	1.92329	-0.54759	14	32	0	25	22	1	-3.13549	-3.25810
93	128613002	Seizure disorder	26	33737001	Fracture of rib	1095	39	54	1	38	53	1003	0.51994	-0.02101	0.49801	3.69723	0.06708	0.7173434670	1.0000000000	1.92329	-0.54759	14	32	0	25	22	1	-3.13549	-3.25810
89	47693006	Rupture of appendix	26	33737001	Fracture of rib	1095	20	54	0	20	54	1021	0.00000	-0.03107	0.00000	0.00000	0.00000	0.6191554175	1.0000000000	0.98630	-0.99008	10	32	0	10	22	0	0.00000	0.00000
86	713197008	Recurrent rectal polyp	26	33737001	Fracture of rib	1095	22	54	0	22	54	1019	0.00000	-0.03261	0.00000	0.00000	0.00000	0.6213792952	1.0000000000	1.08493	-1.06000	12	32	0	10	22	0	0.00000	0.00000
82	94260004	Secondary malignant neoplasm of colon	26	33737001	Fracture of rib	1095	4	54	0	4	54	1037	0.00000	-0.01379	0.00000	0.00000	0.00000	1.0000000000	1.0000000000	0.19726	-0.25974	2	32	0	2	22	0	0.00000	0.00000
80	6072007	Bleeding from anus	26	33737001	Fracture of rib	1095	4	54	0	4	54	1037	0.00000	-0.01379	0.00000	0.00000	0.00000	1.0000000000	1.0000000000	0.19726	-0.25974	2	32	0	2	22	0	0.00000	0.00000
78	239872002	Osteoarthritis of hip	26	33737001	Fracture of rib	1095	21	54	5	16	49	1025	4.82804	0.12191	6.53699	18.57398	2.30065	0.0026923671	0.0547074043	1.03562	1.55950	13	32	3	8	22	2	-0.02817	0.06454
76	127013003	Diabetic renal disease (disorder)	26	33737001	Fracture of rib	1095	28	54	0	28	54	1013	0.00000	-0.03690	0.00000	0.00000	0.00000	0.3941970349	1.0000000000	1.38082	-1.25146	10	32	0	18	22	0	0.00000	0.00000
75	431855005	Chronic kidney disease stage 1 (disorder)	26	33737001	Fracture of rib	1095	28	54	0	28	54	1013	0.00000	-0.03690	0.00000	0.00000	0.00000	0.3941970349	1.0000000000	1.38082	-1.25146	10	32	0	18	22	0	0.00000	0.00000
73	196416002	Impacted molars	26	33737001	Fracture of rib	1095	49	54	3	46	51	995	1.24150	0.01190	1.27238	4.23005	0.38273	0.7298645218	1.0000000000	2.41644	0.22751	25	32	0	24	22	3	-2.12026	-2.19722
72	35999006	Blighted ovum	26	33737001	Fracture of rib	1095	53	54	1	52	53	989	0.38260	-0.03171	0.35885	2.64609	0.04867	0.5117532997	1.0000000000	2.61370	-0.85348	53	32	1	0	22	0	3.49651	3.98898
71	201834006	Localized  primary osteoarthritis of the hand	26	33737001	Fracture of rib	1095	28	54	1	27	53	1014	0.72421	-0.01018	0.70860	5.31470	0.09448	1.0000000000	1.0000000000	1.38082	-0.25146	19	32	1	9	22	0	3.49651	2.99573
70	87433001	Pulmonary emphysema (disorder)	26	33737001	Fracture of rib	1095	17	54	0	17	54	1024	0.00000	-0.02860	0.00000	0.00000	0.00000	1.0000000000	1.0000000000	0.83836	-0.87842	9	32	0	8	22	0	0.00000	0.00000
69	233604007	Pneumonia	26	33737001	Fracture of rib	1095	7	54	0	7	54	1034	0.00000	-0.01827	0.00000	0.00000	0.00000	1.0000000000	1.0000000000	0.34521	-0.42783	3	32	0	4	22	0	0.00000	0.00000
68	26929004	Alzheimer's disease (disorder)	26	33737001	Fracture of rib	1095	23	54	0	23	54	1018	0.00000	-0.03336	0.00000	0.00000	0.00000	0.6237210143	1.0000000000	1.13425	-1.09373	15	32	0	8	22	0	0.00000	0.00000
67	403191005	Second degree burn	26	33737001	Fracture of rib	1095	49	54	3	46	51	995	1.24150	0.01190	1.27238	4.23005	0.38273	0.7298645218	1.0000000000	2.41644	0.22751	23	32	3	26	22	0	2.45674	2.15948
65	239873007	Osteoarthritis of knee	26	33737001	Fracture of rib	1095	57	54	5	52	49	989	1.77875	0.04156	1.94074	5.07614	0.74199	0.1957424709	0.8340316782	2.81096	0.65481	30	32	3	27	22	2	-0.02817	-0.27625
64	444448004	Injury of medial collateral ligament of knee	26	33737001	Fracture of rib	1095	32	54	1	31	53	1010	0.63368	-0.01448	0.61473	4.58971	0.08233	1.0000000000	1.0000000000	1.57808	-0.36630	17	32	0	15	22	1	-3.13549	-2.77259
63	68496003	Polyp of colon	26	33737001	Fracture of rib	1095	91	54	3	88	51	953	0.66850	-0.02273	0.63703	2.08289	0.19483	0.6154225394	1.0000000000	4.48767	-0.45619	43	32	1	48	22	2	1.01160	0.56531
62	185086009	Chronic obstructive bronchitis (disorder)	26	33737001	Fracture of rib	1095	6	54	1	5	53	1036	3.37963	0.04023	3.90943	34.05913	0.44874	0.2622486861	0.9281913645	0.29589	0.62606	4	32	0	2	22	1	-3.13549	-1.09861
59	262574004	Bullet wound	26	33737001	Fracture of rib	1095	20	54	0	20	54	1021	0.00000	-0.03107	0.00000	0.00000	0.00000	0.6191554175	1.0000000000	0.98630	-0.99008	9	32	0	11	22	0	0.00000	0.00000
58	239720000	Tear of meniscus of knee	26	33737001	Fracture of rib	1095	20	54	2	18	52	1023	2.02778	0.03193	2.18590	9.67196	0.49402	0.2587635995	0.9237197547	0.98630	0.59488	10	32	0	10	22	2	-2.48491	-1.79176
57	192127007	Child attention deficit disorder	26	33737001	Fracture of rib	1095	76	54	1	75	53	966	0.26681	-0.04560	0.24302	1.78186	0.03314	0.1711447199	0.7972585288	3.74795	-1.24730	24	32	0	52	22	1	-3.13549	-3.97029
56	92691004	Carcinoma in situ of prostate (disorder)	26	33737001	Fracture of rib	1095	23	54	1	22	53	1019	0.88164	-0.00395	0.87393	6.60742	0.11559	1.0000000000	1.0000000000	1.13425	-0.09373	0	32	0	23	22	1	-3.13549	-3.17805
54	5602001	Opioid abuse (disorder)	26	33737001	Fracture of rib	1095	7	54	0	7	54	1034	0.00000	-0.01827	0.00000	0.00000	0.00000	1.0000000000	1.0000000000	0.34521	-0.42783	0	32	0	7	22	0	0.00000	0.00000
52	124171000119105	Chronic intractable migraine without aura	26	33737001	Fracture of rib	1095	51	54	3	48	51	993	1.19281	0.00971	1.21691	4.03980	0.36657	0.7355325992	1.0000000000	2.51507	0.18645	21	32	1	30	22	2	1.01160	0.31845
50	446096008	Perennial allergic rhinitis	26	33737001	Fracture of rib	1095	26	54	2	24	52	1017	1.55983	0.01988	1.62981	7.08250	0.37505	0.3703798539	1.0000000000	1.28219	0.39454	14	32	1	12	22	1	0.36101	0.14310
49	88805009	Chronic congestive heart failure (disorder)	26	33737001	Fracture of rib	1095	10	54	0	10	54	1031	0.00000	-0.02187	0.00000	0.00000	0.00000	1.0000000000	1.0000000000	0.49315	-0.57836	5	32	0	5	22	0	0.00000	0.00000
47	359817006	Closed fracture of hip	26	33737001	Fracture of rib	1095	29	54	1	28	53	1013	0.69923	-0.01130	0.68261	5.11339	0.09113	1.0000000000	1.0000000000	1.43014	-0.28104	11	32	1	18	22	0	3.49651	2.48491
46	62564004	Concussion with loss of consciousness	26	33737001	Fracture of rib	1095	67	54	1	66	53	975	0.30265	-0.04055	0.27873	2.04727	0.03795	0.2483391098	0.9133257124	3.30411	-1.10571	36	32	1	31	22	0	3.49651	3.61092
45	263102004	Fracture subluxation of wrist	26	33737001	Fracture of rib	1095	109	54	6	103	48	938	1.11621	0.00880	1.13835	2.72458	0.47561	0.8143432826	1.0000000000	5.37534	0.13485	51	32	5	58	22	1	-1.13401	-1.66162
44	58150001	Fracture of clavicle	26	33737001	Fracture of rib	1095	112	54	3	109	51	932	0.54315	-0.03512	0.50297	1.63877	0.15437	0.3551451519	1.0000000000	5.52329	-0.70560	55	32	1	57	22	2	1.01160	0.64096
43	307731004	Injury of tendon of the rotator cuff of shoulder	26	33737001	Fracture of rib	1095	51	54	3	48	51	993	1.19281	0.00971	1.21691	4.03980	0.36657	0.7355325992	1.0000000000	2.51507	0.18645	26	32	3	25	22	0	2.45674	2.26868
42	16114001	Fracture of ankle	26	33737001	Fracture of rib	1095	108	54	9	99	45	942	1.68981	0.05197	1.90303	4.00876	0.90340	0.0983298509	0.6237397336	5.32603	0.66063	48	32	3	60	22	6	0.91629	0.43532
41	283385000	Laceration of thigh	26	33737001	Fracture of rib	1095	105	54	8	97	46	944	1.54497	0.04042	1.69251	3.68973	0.77637	0.2297004283	0.8880487574	5.17808	0.54277	50	32	4	55	22	4	0.32542	-0.08855
39	74400008	Appendicitis	26	33737001	Fracture of rib	1095	51	54	2	49	52	992	0.79521	-0.01031	0.77865	3.29019	0.18427	1.0000000000	1.0000000000	2.51507	-0.22859	27	32	2	24	22	0	2.83321	2.67415
38	398254007	Preeclampsia	26	33737001	Fracture of rib	1095	101	54	4	97	50	944	0.80308	-0.01430	0.77856	2.20193	0.27528	0.8111095126	1.0000000000	4.98082	-0.25842	101	32	4	0	22	0	2.19722	3.26767
35	19169002	Miscarriage in first trimester	26	33737001	Fracture of rib	1095	174	54	11	163	43	878	1.28193	0.02791	1.37794	2.72809	0.69599	0.3420119377	1.0000000000	8.58082	0.32481	174	32	11	0	22	0	1.36330	2.82246
33	429007001	History of cardiac arrest (situation)	26	33737001	Fracture of rib	1095	42	54	5	37	49	1004	2.41402	0.06432	2.76889	7.35478	1.04242	0.0510264439	0.4366207221	2.07123	0.96614	24	32	3	18	22	2	-0.02817	-0.10536
32	410429000	Cardiac Arrest	26	33737001	Fracture of rib	1095	42	54	5	37	49	1004	2.41402	0.06432	2.76889	7.35478	1.04242	0.0510264439	0.4366207221	2.07123	0.96614	24	32	3	18	22	2	-0.02817	-0.10536
30	399211009	History of myocardial infarction (situation)	26	33737001	Fracture of rib	1095	31	54	4	27	50	1014	2.61649	0.06284	3.00444	8.91621	1.01239	0.0617334530	0.4836892708	1.52877	0.98349	2	32	1	29	22	3	1.37624	-1.26851
29	22298006	Myocardial Infarction	26	33737001	Fracture of rib	1095	31	54	4	27	50	1014	2.61649	0.06284	3.00444	8.91621	1.01239	0.0617334530	0.4836892708	1.52877	0.98349	2	32	1	29	22	3	1.37624	-1.26851
28	53741008	Coronary Heart Disease	26	33737001	Fracture of rib	1095	80	54	5	75	49	966	1.26736	0.01710	1.31429	3.39727	0.50845	0.5872059012	1.0000000000	3.94521	0.27893	24	32	3	56	22	2	-0.02817	-1.17007
27	408512008	Body mass index 40+ - severely obese (finding)	26	33737001	Fracture of rib	1095	97	54	5	92	49	949	1.04525	0.00321	1.05257	2.70731	0.40923	0.8081292376	1.0000000000	4.78356	0.05300	67	32	4	30	22	1	-0.93827	-0.55760
24	162864005	Body mass index 30+ - obesity (finding)	26	33737001	Fracture of rib	1095	439	54	22	417	32	624	1.01620	0.00302	1.02878	1.79530	0.58953	1.0000000000	1.0000000000	21.64932	0.02217	226	32	11	213	22	11	0.26469	0.05641
23	36971009	Sinusitis (disorder)	26	33737001	Fracture of rib	1095	190	54	10	180	44	861	1.06725	0.00702	1.08712	2.20053	0.53707	0.8535223634	1.0000000000	9.36986	0.08511	84	32	7	106	22	3	-0.40261	-1.02779
21	15777000	Prediabetes	26	33737001	Fracture of rib	1095	333	54	22	311	32	730	1.33967	0.05114	1.61375	2.82179	0.92288	0.0964120691	0.6172904028	16.42192	0.40073	159	32	13	174	22	9	0.00495	-0.42972
20	80394007	Hyperglycemia (disorder)	26	33737001	Fracture of rib	1095	55	54	0	55	54	986	0.00000	-0.05238	0.00000	0.00000	0.00000	0.1060005227	0.6403803083	2.71233	-1.89232	23	32	0	32	22	0	0.00000	0.00000
19	237602007	Metabolic syndrome X (disorder)	26	33737001	Fracture of rib	1095	64	54	1	63	53	978	0.31684	-0.03877	0.29290	2.15284	0.03985	0.3641517284	1.0000000000	3.15616	-1.05525	28	32	1	36	22	0	3.49651	3.36730
18	302870006	Hypertriglyceridemia (disorder)	26	33737001	Fracture of rib	1095	64	54	1	63	53	978	0.31684	-0.03877	0.29290	2.15284	0.03985	0.3641517284	1.0000000000	3.15616	-1.05525	28	32	1	36	22	0	3.49651	3.36730
17	368581000119106	Neuropathy due to type 2 diabetes mellitus (disorder)	26	33737001	Fracture of rib	1095	28	54	0	28	54	1013	0.00000	-0.03690	0.00000	0.00000	0.00000	0.3941970349	1.0000000000	1.38082	-1.25146	7	32	0	21	22	0	0.00000	0.00000
15	40055000	Chronic sinusitis (disorder)	26	33737001	Fracture of rib	1095	216	54	14	202	40	839	1.31430	0.03549	1.45371	2.72327	0.77601	0.2908983534	0.9768039197	10.65205	0.36438	104	32	6	112	22	8	0.52407	0.20067
14	10509002	Acute bronchitis (disorder)	26	33737001	Fracture of rib	1095	863	54	49	814	5	227	1.15135	0.06648	2.73292	6.93940	1.07630	0.0260613603	0.2940444992	42.55890	0.19896	418	32	29	445	22	20	0.00164	-0.41104
13	370247008	Facial laceration	26	33737001	Fracture of rib	1095	109	54	4	105	50	936	0.74414	-0.01938	0.71314	2.01403	0.25251	0.6462362052	1.0000000000	5.37534	-0.35057	55	32	2	54	22	2	0.34831	0.01770
10	62106007	Concussion with no loss of consciousness	26	33737001	Fracture of rib	1095	206	54	12	194	42	847	1.18123	0.01987	1.24742	2.41409	0.64457	0.4788230951	1.0000000000	10.15890	0.22032	96	32	6	110	22	6	0.30538	-0.12862
9	44465007	Sprain of ankle	26	33737001	Fracture of rib	1095	362	54	15	347	39	694	0.84024	-0.02557	0.76923	1.41468	0.41827	0.4597204078	1.0000000000	17.85205	-0.23665	185	32	7	177	22	8	0.39590	0.17067
8	233678006	Childhood asthma	26	33737001	Fracture of rib	1095	45	54	4	41	50	1000	1.80247	0.03784	1.95122	5.66152	0.67248	0.2747613571	0.9503524867	2.21918	0.63524	25	32	3	20	22	1	-0.67876	-0.81093
7	75498004	Acute bacterial sinusitis (disorder)	26	33737001	Fracture of rib	1095	187	54	11	176	43	865	1.19281	0.01993	1.25727	2.48612	0.63582	0.4635661910	1.0000000000	9.22192	0.23137	89	32	4	98	22	7	0.77584	0.43825
6	39848009	Whiplash injury to neck	26	33737001	Fracture of rib	1095	182	54	2	180	52	861	0.22283	-0.07903	0.18397	0.76220	0.04441	0.0047288262	0.0869741935	8.97534	-1.73340	92	32	1	90	22	1	0.36101	0.02174
5	284549007	Laceration of hand	26	33737001	Fracture of rib	1095	104	54	5	99	49	942	0.97489	-0.00185	0.97093	2.49347	0.37807	1.0000000000	1.0000000000	5.12877	-0.03063	54	32	3	50	22	2	-0.02817	-0.31366
1	444814009	Viral sinusitis (disorder)	26	33737001	Fracture of rib	1095	993	54	52	941	2	100	1.06188	0.04397	2.76302	11.51437	0.66302	0.2249253854	0.8806400682	48.96986	0.08493	478	32	32	515	22	20	-0.04879	-0.51786
129	47505003	Posttraumatic stress disorder	110	65275009	Acute Cholecystitis	1095	4	9	0	4	9	1082	0.00000	-0.00551	0.00000	0.00000	0.00000	1.0000000000	1.0000000000	0.03288	-0.04667	1	7	0	3	2	0	0.00000	0.00000
